"","ensembl_gene_id_orig","ensembl_gene_id","symbol","chromosome","start","end","size"
"1","ENSG00000148584","ENSG00000148584","A1CF","10",50799409,50885675,86266
"2","ENSG00000175899","ENSG00000175899","A2M","12",9067664,9116229,48565
"3","ENSG00000128274","ENSG00000128274","A4GALT","22",42692121,42721298,29177
"4","ENSG00000118017","ENSG00000118017","A4GNT","3",138123713,138132390,8677
"5","ENSG00000094914","ENSG00000094914","AAAS","12",53307456,53324864,17408
"6","ENSG00000081760","ENSG00000081760","AACS","12",125065434,125143333,77899
"7","ENSG00000114771","ENSG00000114771","AADAC","3",151814073,151828488,14415
"8","ENSG00000103591","ENSG00000103591","AAGAB","15",67200667,67255195,54528
"9","ENSG00000115977","ENSG00000115977","AAK1","2",69457997,69674349,216352
"10","ENSG00000087884","ENSG00000087884","AAMDC","11",77821109,77918432,97323
"11","ENSG00000127837","ENSG00000127837","AAMP","2",218264129,218270178,6049
"12","ENSG00000131043","ENSG00000131043","AAR2","20",36236131,36270918,34787
"13","ENSG00000149313","ENSG00000149313","AASDHPPT","11",106075501,106098699,23198
"14","ENSG00000008311","ENSG00000008311","AASS","7",122064583,122144308,79725
"15","ENSG00000276072","ENSG00000276072","AATF","HSCHR17_7_CTG4",1185240,1293236,107996
"16","ENSG00000181409","ENSG00000181409","AATK","17",81110487,81166221,55734
"17","ENSG00000183044","ENSG00000183044","ABAT","16",8674596,8784575,109979
"18","ENSG00000165029","ENSG00000165029","ABCA1","9",104781006,104928155,147149
"19","ENSG00000107331","ENSG00000107331","ABCA2","9",137007234,137028915,21681
"20","ENSG00000167972","ENSG00000167972","ABCA3","16",2275881,2340746,64865
"21","ENSG00000198691","ENSG00000198691","ABCA4","1",93992834,94121148,128314
"22","ENSG00000154265","ENSG00000154265","ABCA5","17",69244311,69327244,82933
"23","ENSG00000154262","ENSG00000154262","ABCA6","17",69078702,69141895,63193
"24","ENSG00000064687","ENSG00000064687","ABCA7","19",1039997,1065572,25575
"25","ENSG00000141338","ENSG00000141338","ABCA8","17",68867289,68955392,88103
"26","ENSG00000085563","ENSG00000085563","ABCB1","7",87503017,87713323,210306
"27","ENSG00000276582","ENSG00000276582","ABCB11","HSCHR2_1_CTG7_2",109565,123060,13495
"28","ENSG00000005471","ENSG00000005471","ABCB4","7",87401696,87480435,78739
"29","ENSG00000115657","ENSG00000115657","ABCB6","2",219209772,219218994,9222
"30","ENSG00000131269","ENSG00000131269","ABCB7","X",75051048,75156732,105684
"31","ENSG00000197150","ENSG00000197150","ABCB8","7",151028422,151047782,19360
"32","ENSG00000150967","ENSG00000150967","ABCB9","12",122920951,122981649,60698
"33","ENSG00000278183","ENSG00000278183","ABCC1","HSCHR16_1_CTG1",1607547,1800966,193419
"34","ENSG00000124574","ENSG00000124574","ABCC10","6",43427366,43450427,23061
"35","ENSG00000023839","ENSG00000023839","ABCC2","10",99782640,99852594,69954
"36","ENSG00000108846","ENSG00000108846","ABCC3","17",50634777,50692253,57476
"37","ENSG00000125257","ENSG00000125257","ABCC4","13",95019835,95301475,281640
"38","ENSG00000114770","ENSG00000114770","ABCC5","3",183919934,184017939,98005
"39","ENSG00000275331","ENSG00000275331","ABCC6","HSCHR16_1_CTG1",1806848,1881517,74669
"40","ENSG00000006071","ENSG00000006071","ABCC8","11",17392498,17476894,84396
"41","ENSG00000069431","ENSG00000069431","ABCC9","12",21797389,21942543,145154
"42","ENSG00000101986","ENSG00000101986","ABCD1","X",153724856,153744755,19899
"43","ENSG00000173208","ENSG00000173208","ABCD2","12",39550033,39619803,69770
"44","ENSG00000117528","ENSG00000117528","ABCD3","1",94418389,94518666,100277
"45","ENSG00000119688","ENSG00000119688","ABCD4","14",74285269,74303055,17786
"46","ENSG00000164163","ENSG00000164163","ABCE1","4",145098288,145129524,31236
"47","ENSG00000236342","ENSG00000236342","ABCF1","HSCHR6_MHC_MCF_CTG1",1915422,1941226,25804
"48","ENSG00000033050","ENSG00000033050","ABCF2","7",151211484,151227205,15721
"49","ENSG00000161204","ENSG00000161204","ABCF3","3",184186095,184194012,7917
"50","ENSG00000160179","ENSG00000160179","ABCG1","21",42199689,42297244,97555
"51","ENSG00000118777","ENSG00000118777","ABCG2","4",88090150,88231628,141478
"52","ENSG00000172350","ENSG00000172350","ABCG4","11",119149052,119162653,13601
"53","ENSG00000138075","ENSG00000138075","ABCG5","2",43812472,43838865,26393
"54","ENSG00000144827","ENSG00000144827","ABHD10","3",111979010,111993368,14358
"55","ENSG00000106077","ENSG00000106077","ABHD11","7",73736094,73738852,2758
"56","ENSG00000248487","ENSG00000248487","ABHD14A","3",51971426,51981196,9770
"57","ENSG00000129968","ENSG00000129968","ABHD17A","19",1876810,1885496,8686
"58","ENSG00000107362","ENSG00000107362","ABHD17B","9",71862452,71911193,48741
"59","ENSG00000164074","ENSG00000164074","ABHD18","4",127965315,128039953,74638
"60","ENSG00000140526","ENSG00000140526","ABHD2","15",89087459,89202355,114896
"61","ENSG00000158201","ENSG00000158201","ABHD3","18",21650901,21704780,53879
"62","ENSG00000100439","ENSG00000100439","ABHD4","14",22598290,22612963,14673
"63","ENSG00000011198","ENSG00000011198","ABHD5","3",43690108,43734371,44263
"64","ENSG00000163686","ENSG00000163686","ABHD6","3",58237532,58295693,58161
"65","ENSG00000127220","ENSG00000127220","ABHD8","19",17292131,17310236,18105
"66","ENSG00000136754","ENSG00000136754","ABI1","10",26746593,26861087,114494
"67","ENSG00000138443","ENSG00000138443","ABI2","2",203328280,203447728,119448
"68","ENSG00000154175","ENSG00000154175","ABI3BP","3",100749156,100993515,244359
"69","ENSG00000097007","ENSG00000097007","ABL1","9",130713043,130887675,174632
"70","ENSG00000143322","ENSG00000143322","ABL2","1",179099330,179229684,130354
"71","ENSG00000099204","ENSG00000099204","ABLIM1","10",114431112,114768061,336949
"72","ENSG00000173210","ENSG00000173210","ABLIM3","5",149141483,149260542,119059
"73","ENSG00000175164","ENSG00000175164","ABO","9",133233278,133276024,42746
"74","ENSG00000278741","ENSG00000278741","ABR","HSCHR17_2_CTG2",42766,231794,189028
"75","ENSG00000146109","ENSG00000146109","ABT1","6",26596953,26600739,3786
"76","ENSG00000166016","ENSG00000166016","ABTB2","11",34150987,34358010,207023
"77","ENSG00000060971","ENSG00000060971","ACAA1","3",38103129,38137242,34113
"78","ENSG00000167315","ENSG00000167315","ACAA2","18",49782164,49813953,31789
"79","ENSG00000278540","ENSG00000278540","ACACA","17",37084992,37406836,321844
"80","ENSG00000076555","ENSG00000076555","ACACB","12",109116587,109268226,151639
"81","ENSG00000111271","ENSG00000111271","ACAD10","12",111686053,111757107,71054
"82","ENSG00000151498","ENSG00000151498","ACAD8","11",134253548,134265855,12307
"83","ENSG00000115361","ENSG00000115361","ACADL","2",210187126,210225447,38321
"84","ENSG00000117054","ENSG00000117054","ACADM","1",75724431,75787575,63144
"85","ENSG00000122971","ENSG00000122971","ACADS","12",120725774,120740008,14234
"86","ENSG00000196177","ENSG00000196177","ACADSB","10",123008979,123058290,49311
"87","ENSG00000072778","ENSG00000072778","ACADVL","17",7217125,7225266,8141
"88","ENSG00000072818","ENSG00000072818","ACAP1","17",7336529,7351477,14948
"89","ENSG00000114331","ENSG00000114331","ACAP2","3",195274745,195443044,168299
"90","ENSG00000075239","ENSG00000075239","ACAT1","11",108116695,108147603,30908
"91","ENSG00000120437","ENSG00000120437","ACAT2","6",159762045,159779112,17067
"92","ENSG00000182827","ENSG00000182827","ACBD3","1",226144679,226186741,42062
"93","ENSG00000181513","ENSG00000181513","ACBD4","17",45132600,45144181,11581
"94","ENSG00000102977","ENSG00000102977","ACD","16",67657512,67660810,3298
"95","ENSG00000159640","ENSG00000159640","ACE","17",63477061,63498380,21319
"96","ENSG00000130234","ENSG00000130234","ACE2","X",15494566,15607236,112670
"97","ENSG00000087085","ENSG00000087085","ACHE","7",100889994,100896974,6980
"98","ENSG00000100813","ENSG00000100813","ACIN1","14",23058564,23095614,37050
"99","ENSG00000213088","ENSG00000213088","ACKR1","1",159204875,159206500,1625
"100","ENSG00000144648","ENSG00000144648","ACKR2","3",42804752,42887974,83222
"101","ENSG00000144476","ENSG00000144476","ACKR3","2",236567787,236582354,14567
"102","ENSG00000129048","ENSG00000129048","ACKR4","3",132597270,132618967,21697
"103","ENSG00000131473","ENSG00000131473","ACLY","17",41866917,41930542,63625
"104","ENSG00000122729","ENSG00000122729","ACO1","9",32384603,32454769,70166
"105","ENSG00000100412","ENSG00000100412","ACO2","22",41447830,41529273,81443
"106","ENSG00000162390","ENSG00000162390","ACOT11","1",54542257,54639192,96935
"107","ENSG00000112304","ENSG00000112304","ACOT13","6",24667035,24705065,38030
"108","ENSG00000119673","ENSG00000119673","ACOT2","14",73567620,73575658,8038
"109","ENSG00000097021","ENSG00000097021","ACOT7","1",6264269,6393767,129498
"110","ENSG00000101473","ENSG00000101473","ACOT8","20",45841721,45857405,15684
"111","ENSG00000123130","ENSG00000123130","ACOT9","X",23701055,23766475,65420
"112","ENSG00000161533","ENSG00000161533","ACOX1","17",75941507,75979177,37670
"113","ENSG00000168306","ENSG00000168306","ACOX2","3",58505136,58537283,32147
"114","ENSG00000087008","ENSG00000087008","ACOX3","4",8366282,8440723,74441
"115","ENSG00000143727","ENSG00000143727","ACP1","2",264140,278283,14143
"116","ENSG00000134575","ENSG00000134575","ACP2","11",47239302,47248906,9604
"117","ENSG00000102575","ENSG00000102575","ACP5","19",11574653,11579993,5340
"118","ENSG00000162836","ENSG00000162836","ACP6","1",147629652,147670524,40872
"119","ENSG00000100312","ENSG00000100312","ACR","22",50738196,50745339,7143
"120","ENSG00000134940","ENSG00000134940","ACRV1","11",125671522,125680874,9352
"121","ENSG00000103740","ENSG00000103740","ACSBG1","15",78167468,78245688,78220
"122","ENSG00000167107","ENSG00000167107","ACSF2","17",50426158,50474845,48687
"123","ENSG00000151726","ENSG00000151726","ACSL1","4",184755595,184826818,71223
"124","ENSG00000123983","ENSG00000123983","ACSL3","2",222860942,222944639,83697
"125","ENSG00000068366","ENSG00000068366","ACSL4","X",109624244,109733403,109159
"126","ENSG00000197142","ENSG00000197142","ACSL5","10",112374116,112428379,54263
"127","ENSG00000164398","ENSG00000164398","ACSL6","5",131949973,132012243,62270
"128","ENSG00000166743","ENSG00000166743","ACSM1","16",20623235,20698890,75655
"129","ENSG00000183747","ENSG00000183747","ACSM2A","16",20451461,20487669,36208
"130","ENSG00000066813","ENSG00000066813","ACSM2B","16",20536226,20576427,40201
"131","ENSG00000005187","ENSG00000005187","ACSM3","16",20610243,20797581,187338
"132","ENSG00000183549","ENSG00000183549","ACSM5","16",20409534,20441336,31802
"133","ENSG00000111058","ENSG00000111058","ACSS3","12",80936414,81261210,324796
"134","ENSG00000107796","ENSG00000107796","ACTA2","10",88934822,88991339,56517
"135","ENSG00000075624","ENSG00000075624","ACTB","7",5526409,5563902,37493
"136","ENSG00000159251","ENSG00000159251","ACTC1","15",34790107,34795589,5482
"137","ENSG00000184009","ENSG00000184009","ACTG1","17",81509413,81523847,14434
"138","ENSG00000163017","ENSG00000163017","ACTG2","2",73892314,73919865,27551
"139","ENSG00000136518","ENSG00000136518","ACTL6A","3",179562886,179588407,25521
"140","ENSG00000077080","ENSG00000077080","ACTL6B","7",100643097,100656448,13351
"141","ENSG00000117148","ENSG00000117148","ACTL8","1",17755333,17827063,71730
"142","ENSG00000072110","ENSG00000072110","ACTN1","14",68874128,68979440,105312
"143","ENSG00000077522","ENSG00000077522","ACTN2","1",236664141,236764631,100490
"144","ENSG00000130402","ENSG00000130402","ACTN4","19",38647649,38731589,83940
"145","ENSG00000131966","ENSG00000131966","ACTR10","14",58200080,58235636,35556
"146","ENSG00000138107","ENSG00000138107","ACTR1A","10",102461881,102502712,40831
"147","ENSG00000115073","ENSG00000115073","ACTR1B","2",97655939,97664044,8105
"148","ENSG00000138071","ENSG00000138071","ACTR2","2",65227788,65271253,43465
"149","ENSG00000115091","ENSG00000115091","ACTR3","2",113890063,113962596,72533
"150","ENSG00000133627","ENSG00000133627","ACTR3B","7",152759749,152855378,95629
"151","ENSG00000101442","ENSG00000101442","ACTR5","20",38748460,38772520,24060
"152","ENSG00000075089","ENSG00000075089","ACTR6","12",100199122,100241865,42743
"153","ENSG00000113812","ENSG00000113812","ACTR8","3",53867066,53882152,15086
"154","ENSG00000115170","ENSG00000115170","ACVR1","2",157736251,157876330,140079
"155","ENSG00000135503","ENSG00000135503","ACVR1B","12",51951699,51997078,45379
"156","ENSG00000121989","ENSG00000121989","ACVR2A","2",147844517,147930826,86309
"157","ENSG00000114739","ENSG00000114739","ACVR2B","3",38453890,38493142,39252
"158","ENSG00000139567","ENSG00000139567","ACVRL1","12",51906908,51923361,16453
"159","ENSG00000243989","ENSG00000243989","ACY1","3",51983340,51989197,5857
"160","ENSG00000119640","ENSG00000119640","ACYP1","14",75053237,75069483,16246
"161","ENSG00000170634","ENSG00000170634","ACYP2","2",53970838,54305300,334462
"162","ENSG00000196839","ENSG00000196839","ADA","20",44584896,44652252,67356
"163","ENSG00000137845","ENSG00000137845","ADAM10","15",58588809,58749791,160982
"164","ENSG00000073670","ENSG00000073670","ADAM11","17",44758988,44781846,22858
"165","ENSG00000148848","ENSG00000148848","ADAM12","10",126012381,126388477,376096
"166","ENSG00000143537","ENSG00000143537","ADAM15","1",155050566,155062775,12209
"167","ENSG00000151694","ENSG00000151694","ADAM17","2",9488486,9556732,68246
"168","ENSG00000278548","ENSG00000278548","ADAM18","HSCHR8_9_CTG1",335123,480684,145561
"169","ENSG00000135074","ENSG00000135074","ADAM19","5",157395534,157575775,180241
"170","ENSG00000276286","ENSG00000276286","ADAM2","HSCHR8_9_CTG1",494374,588925,94551
"171","ENSG00000134007","ENSG00000134007","ADAM20","14",70522358,70535015,12657
"172","ENSG00000139985","ENSG00000139985","ADAM21","14",70417107,70460427,43320
"173","ENSG00000008277","ENSG00000008277","ADAM22","7",87934143,88202889,268746
"174","ENSG00000114948","ENSG00000114948","ADAM23","2",206443532,206621127,177595
"175","ENSG00000042980","ENSG00000042980","ADAM28","8",24294069,24359014,64945
"176","ENSG00000197475","ENSG00000197475","ADAM3A","8",39455339,39522810,67471
"177","ENSG00000069206","ENSG00000069206","ADAM7","8",24440930,24526970,86040
"178","ENSG00000151651","ENSG00000151651","ADAM8","10",133262420,133276868,14448
"179","ENSG00000282230","ENSG00000282230","ADAM9","HSCHR8_9_CTG1",7546,10827,3281
"180","ENSG00000134028","ENSG00000134028","ADAMDEC1","8",24384285,24406013,21728
"181","ENSG00000154734","ENSG00000154734","ADAMTS1","21",26835755,26845409,9654
"182","ENSG00000151388","ENSG00000151388","ADAMTS12","5",33523535,33892019,368484
"183","ENSG00000281244","ENSG00000281244","ADAMTS13","HG2030_PATCH",240452,285496,45044
"184","ENSG00000087116","ENSG00000087116","ADAMTS2","5",179110853,179345461,234608
"185","ENSG00000156140","ENSG00000156140","ADAMTS3","4",72280969,72569221,288252
"186","ENSG00000154736","ENSG00000154736","ADAMTS5","21",26917922,26967088,49166
"187","ENSG00000136378","ENSG00000136378","ADAMTS7","15",78759206,78811464,52258
"188","ENSG00000134917","ENSG00000134917","ADAMTS8","11",130404923,130428609,23686
"189","ENSG00000163638","ENSG00000163638","ADAMTS9","3",64515654,64688000,172346
"190","ENSG00000197859","ENSG00000197859","ADAMTSL2","9",133532164,133575519,43355
"191","ENSG00000156218","ENSG00000156218","ADAMTSL3","15",83654088,84039842,385754
"192","ENSG00000143382","ENSG00000143382","ADAMTSL4","1",150549369,150560937,11568
"193","ENSG00000105963","ENSG00000105963","ADAP1","7",897900,955407,57507
"194","ENSG00000184060","ENSG00000184060","ADAP2","17",30906344,30959322,52978
"195","ENSG00000160710","ENSG00000160710","ADAR","1",154581695,154628013,46318
"196","ENSG00000197381","ENSG00000197381","ADARB1","21",45073853,45226560,152707
"197","ENSG00000185736","ENSG00000185736","ADARB2","10",1177313,1737525,560212
"198","ENSG00000065457","ENSG00000065457","ADAT1","16",75596868,75623300,26432
"199","ENSG00000133597","ENSG00000133597","ADCK2","7",140672945,140696261,23316
"200","ENSG00000164742","ENSG00000164742","ADCY1","7",45574140,45723116,148976
"201","ENSG00000143199","ENSG00000143199","ADCY10","1",167809386,167914215,104829
"202","ENSG00000078295","ENSG00000078295","ADCY2","5",7396138,7830081,433943
"203","ENSG00000138031","ENSG00000138031","ADCY3","2",24819169,24920237,101068
"204","ENSG00000174233","ENSG00000174233","ADCY6","12",48766194,48789089,22895
"205","ENSG00000121281","ENSG00000121281","ADCY7","16",50246137,50318135,71998
"206","ENSG00000155897","ENSG00000155897","ADCY8","8",130780301,131040909,260608
"207","ENSG00000162104","ENSG00000162104","ADCY9","16",3953387,4116442,163055
"208","ENSG00000141433","ENSG00000141433","ADCYAP1","18",904871,912172,7301
"209","ENSG00000078549","ENSG00000078549","ADCYAP1R1","7",31052308,31111474,59166
"210","ENSG00000087274","ENSG00000087274","ADD1","4",2843844,2930076,86232
"211","ENSG00000075340","ENSG00000075340","ADD2","2",70607618,70768225,160607
"212","ENSG00000148700","ENSG00000148700","ADD3","10",109996368,110135565,139197
"213","ENSG00000118492","ENSG00000118492","ADGB","6",146598967,146815462,216495
"214","ENSG00000020181","ENSG00000020181","ADGRA2","8",37784191,37844896,60705
"215","ENSG00000152990","ENSG00000152990","ADGRA3","4",22345071,22516066,170995
"216","ENSG00000181790","ENSG00000181790","ADGRB1","8",142449430,142545009,95579
"217","ENSG00000121753","ENSG00000121753","ADGRB2","1",31727117,31764893,37776
"218","ENSG00000135298","ENSG00000135298","ADGRB3","6",68635282,69390571,755289
"219","ENSG00000174837","ENSG00000174837","ADGRE1","19",6887566,6940459,52893
"220","ENSG00000127507","ENSG00000127507","ADGRE2","19",14732392,14778560,46168
"221","ENSG00000131355","ENSG00000131355","ADGRE3","19",14619117,14690027,70910
"222","ENSG00000123146","ENSG00000123146","ADGRE5","19",14380501,14408725,28224
"223","ENSG00000153292","ENSG00000153292","ADGRF1","6",46997708,47042350,44642
"224","ENSG00000069122","ENSG00000069122","ADGRF5","6",46852522,46954943,102421
"225","ENSG00000205336","ENSG00000205336","ADGRG1","16",57610652,57665580,54928
"226","ENSG00000173698","ENSG00000173698","ADGRG2","X",18989307,19122637,133330
"227","ENSG00000182885","ENSG00000182885","ADGRG3","16",57668277,57689378,21101
"228","ENSG00000112414","ENSG00000112414","ADGRG6","6",142301854,142446266,144412
"229","ENSG00000072071","ENSG00000072071","ADGRL1","19",14147743,14206187,58444
"230","ENSG00000117114","ENSG00000117114","ADGRL2","1",81306147,81993932,687785
"231","ENSG00000150471","ENSG00000150471","ADGRL3","4",61200326,62078335,878009
"232","ENSG00000162618","ENSG00000162618","ADGRL4","1",78889764,79282124,392360
"233","ENSG00000164199","ENSG00000164199","ADGRV1","5",90529344,91164437,635093
"234","ENSG00000187758","ENSG00000187758","ADH1A","4",99276369,99291003,14634
"235","ENSG00000196616","ENSG00000196616","ADH1B","4",99304971,99321401,16430
"236","ENSG00000248144","ENSG00000248144","ADH1C","4",99336497,99352746,16249
"237","ENSG00000197894","ENSG00000197894","ADH5","4",99070978,99088801,17823
"238","ENSG00000172955","ENSG00000172955","ADH6","4",99202638,99219537,16899
"239","ENSG00000196344","ENSG00000196344","ADH7","4",99412261,99435510,23249
"240","ENSG00000280830","ENSG00000280830","ADI1","HSCHR2_1_CTG1",106831,110463,3632
"241","ENSG00000181092","ENSG00000181092","ADIPOQ","3",186842704,186858463,15759
"242","ENSG00000159346","ENSG00000159346","ADIPOR1","1",202940826,202958572,17746
"243","ENSG00000006831","ENSG00000006831","ADIPOR2","12",1688574,1788674,100100
"244","ENSG00000148671","ENSG00000148671","ADIRF","10",86968432,86983934,15502
"245","ENSG00000156110","ENSG00000156110","ADK","10",74151202,74709963,558761
"246","ENSG00000148926","ENSG00000148926","ADM","11",10305073,10307397,2324
"247","ENSG00000101126","ENSG00000101126","ADNP","20",50888916,50931437,42521
"248","ENSG00000101544","ENSG00000101544","ADNP2","18",80109262,80147523,38261
"249","ENSG00000181915","ENSG00000181915","ADO","10",62804720,62808479,3759
"250","ENSG00000163485","ENSG00000163485","ADORA1","1",203090654,203167405,76751
"251","ENSG00000128271","ENSG00000128271","ADORA2A","22",24417879,24442357,24478
"252","ENSG00000170425","ENSG00000170425","ADORA2B","17",15945130,15975746,30616
"253","ENSG00000159322","ENSG00000159322","ADPGK","15",72751294,72785846,34552
"254","ENSG00000144843","ENSG00000144843","ADPRH","3",119579268,119589945,10677
"255","ENSG00000170222","ENSG00000170222","ADPRM","17",10697594,10711558,13964
"256","ENSG00000120907","ENSG00000120907","ADRA1A","8",26748150,26867278,119128
"257","ENSG00000170214","ENSG00000170214","ADRA1B","5",159865080,159973012,107932
"258","ENSG00000171873","ENSG00000171873","ADRA1D","20",4220630,4249287,28657
"259","ENSG00000150594","ENSG00000150594","ADRA2A","10",111077029,111080907,3878
"260","ENSG00000184160","ENSG00000184160","ADRA2C","4",3766348,3768526,2178
"261","ENSG00000043591","ENSG00000043591","ADRB1","10",114043866,114046904,3038
"262","ENSG00000169252","ENSG00000169252","ADRB2","5",148826611,148828623,2012
"263","ENSG00000188778","ENSG00000188778","ADRB3","8",37962990,37966599,3609
"264","ENSG00000130706","ENSG00000130706","ADRM1","20",62302093,62308862,6769
"265","ENSG00000239900","ENSG00000239900","ADSL","22",40346461,40390463,44002
"266","ENSG00000111863","ENSG00000111863","ADTRP","6",11712054,11807046,94992
"267","ENSG00000106624","ENSG00000106624","AEBP1","7",44104345,44114562,10217
"268","ENSG00000181026","ENSG00000181026","AEN","15",88621337,88632281,10944
"269","ENSG00000196526","ENSG00000196526","AFAP1","4",7758714,7939926,181212
"270","ENSG00000172493","ENSG00000172493","AFF1","4",86935002,87141039,206037
"271","ENSG00000155966","ENSG00000155966","AFF2","X",148500617,149000663,500046
"272","ENSG00000072364","ENSG00000072364","AFF4","5",132875395,132963634,88239
"273","ENSG00000141385","ENSG00000141385","AFG3L2","18",12328944,12377227,48283
"274","ENSG00000079557","ENSG00000079557","AFM","4",73481745,73504001,22256
"275","ENSG00000081051","ENSG00000081051","AFP","4",73431138,73456174,25036
"276","ENSG00000119844","ENSG00000119844","AFTPH","2",64524299,64593005,68706
"277","ENSG00000038002","ENSG00000038002","AGA","4",177430774,177442437,11663
"278","ENSG00000157985","ENSG00000157985","AGAP1","2",235494043,236131793,637750
"279","ENSG00000135439","ENSG00000135439","AGAP2","12",57723761,57742157,18396
"280","ENSG00000165923","ENSG00000165923","AGBL2","11",47659591,47715389,55798
"281","ENSG00000084693","ENSG00000084693","AGBL5","2",27042364,27070622,28258
"282","ENSG00000237405","ENSG00000237405","AGER","HSCHR6_MHC_SSTO_CTG1",3497175,3500531,3356
"283","ENSG00000173744","ENSG00000173744","AGFG1","2",227472152,227561217,89065
"284","ENSG00000106351","ENSG00000106351","AGFG2","7",100539203,100568220,29017
"285","ENSG00000164252","ENSG00000164252","AGGF1","5",77029251,77065234,35983
"286","ENSG00000262327","ENSG00000262327","AGK","HSCHR7_1_CTG6",493,21836,21343
"287","ENSG00000162688","ENSG00000162688","AGL","1",99850361,99924023,73662
"288","ENSG00000092847","ENSG00000092847","AGO1","1",35869808,35930532,60724
"289","ENSG00000123908","ENSG00000123908","AGO2","8",140520156,140635633,115477
"290","ENSG00000126070","ENSG00000126070","AGO3","1",35930718,36072500,141782
"291","ENSG00000134698","ENSG00000134698","AGO4","1",35808016,35857890,49874
"292","ENSG00000236873","ENSG00000236873","AGPAT1","HSCHR6_MHC_APD_CTG1",3500814,3510698,9884
"293","ENSG00000169692","ENSG00000169692","AGPAT2","9",136673143,136687457,14314
"294","ENSG00000160216","ENSG00000160216","AGPAT3","21",43865223,43987592,122369
"295","ENSG00000026652","ENSG00000026652","AGPAT4","6",161129967,161274061,144094
"296","ENSG00000155189","ENSG00000155189","AGPAT5","8",6708642,6761503,52861
"297","ENSG00000018510","ENSG00000018510","AGPS","2",177392746,177567024,174278
"298","ENSG00000106541","ENSG00000106541","AGR2","7",16791811,16833433,41622
"299","ENSG00000188157","ENSG00000188157","AGRN","1",1020120,1056118,35998
"300","ENSG00000159723","ENSG00000159723","AGRP","16",67482571,67483547,976
"301","ENSG00000135744","ENSG00000135744","AGT","1",230690776,230745576,54800
"302","ENSG00000135049","ENSG00000135049","AGTPBP1","9",85546539,85742029,195490
"303","ENSG00000144891","ENSG00000144891","AGTR1","3",148697784,148743008,45224
"304","ENSG00000180772","ENSG00000180772","AGTR2","X",116170744,116174974,4230
"305","ENSG00000172482","ENSG00000172482","AGXT","2",240868824,240880502,11678
"306","ENSG00000153207","ENSG00000153207","AHCTF1","1",246839098,246931948,92850
"307","ENSG00000101444","ENSG00000101444","AHCY","20",34280268,34311802,31534
"308","ENSG00000168710","ENSG00000168710","AHCYL1","1",109984765,110023742,38977
"309","ENSG00000158467","ENSG00000158467","AHCYL2","7",129225030,129430211,205181
"310","ENSG00000126705","ENSG00000126705","AHDC1","1",27534035,27604431,70396
"311","ENSG00000135541","ENSG00000135541","AHI1","6",135283407,135498434,215027
"312","ENSG00000124942","ENSG00000124942","AHNAK","11",62433542,62556235,122693
"313","ENSG00000106546","ENSG00000106546","AHR","7",16916359,17346152,429793
"314","ENSG00000100591","ENSG00000100591","AHSA1","14",77457870,77469472,11602
"315","ENSG00000145192","ENSG00000145192","AHSG","3",186613060,186621318,8258
"316","ENSG00000169877","ENSG00000169877","AHSP","16",31527900,31528803,903
"317","ENSG00000111732","ENSG00000111732","AICDA","12",8602155,8613242,11087
"318","ENSG00000186063","ENSG00000186063","AIDA","1",222668013,222713210,45197
"319","ENSG00000237727","ENSG00000237727","AIF1","HSCHR6_MHC_COX_CTG1",3092473,3094310,1837
"320","ENSG00000156709","ENSG00000156709","AIFM1","X",130124666,130165879,41213
"321","ENSG00000163568","ENSG00000163568","AIM2","1",159061599,159187843,126244
"322","ENSG00000164022","ENSG00000164022","AIMP1","4",106315544,106349456,33912
"323","ENSG00000106305","ENSG00000106305","AIMP2","7",6009255,6023834,14579
"324","ENSG00000110711","ENSG00000110711","AIP","11",67468174,67491154,22980
"325","ENSG00000160224","ENSG00000160224","AIRE","21",44285838,44298648,12810
"326","ENSG00000196581","ENSG00000196581","AJAP1","1",4654609,4792534,137925
"327","ENSG00000106992","ENSG00000106992","AK1","9",127866486,127877675,11189
"328","ENSG00000004455","ENSG00000004455","AK2","1",33007986,33080996,73010
"329","ENSG00000162433","ENSG00000162433","AK4","1",65147549,65232145,84596
"330","ENSG00000154027","ENSG00000154027","AK5","1",77282019,77559966,277947
"331","ENSG00000279247","ENSG00000279247","AK6","HSCHR5_2_CTG1_1",134177,153209,19032
"332","ENSG00000121057","ENSG00000121057","AKAP1","17",57085092,57121346,36254
"333","ENSG00000108599","ENSG00000108599","AKAP10","17",19904302,19978343,74041
"334","ENSG00000023516","ENSG00000023516","AKAP11","13",42272152,42323261,51109
"335","ENSG00000131016","ENSG00000131016","AKAP12","6",151239967,151358559,118592
"336","ENSG00000170776","ENSG00000170776","AKAP13","15",85380571,85749358,368787
"337","ENSG00000197976","ENSG00000197976","AKAP17A","X",1591604,1602520,10916
"338","ENSG00000111254","ENSG00000111254","AKAP3","12",4615508,4649051,33543
"339","ENSG00000179841","ENSG00000179841","AKAP5","14",64465499,64474503,9004
"340","ENSG00000151320","ENSG00000151320","AKAP6","14",32329298,32837684,508386
"341","ENSG00000118507","ENSG00000118507","AKAP7","6",131135467,131283535,148068
"342","ENSG00000105127","ENSG00000105127","AKAP8","19",15353385,15379815,26430
"343","ENSG00000011243","ENSG00000011243","AKAP8L","19",15380050,15419141,39091
"344","ENSG00000127914","ENSG00000127914","AKAP9","7",91940840,92110673,169833
"345","ENSG00000166452","ENSG00000166452","AKIP1","11",8911139,8920084,8945
"346","ENSG00000174574","ENSG00000174574","AKIRIN1","1",38991276,39006059,14783
"347","ENSG00000117448","ENSG00000117448","AKR1A1","1",45550543,45570049,19506
"348","ENSG00000085662","ENSG00000085662","AKR1B1","7",134442356,134459284,16928
"349","ENSG00000198074","ENSG00000198074","AKR1B10","7",134527567,134541412,13845
"350","ENSG00000187134","ENSG00000187134","AKR1C1","10",4963253,4983283,20030
"351","ENSG00000151632","ENSG00000151632","AKR1C2","10",4987775,5018031,30256
"352","ENSG00000196139","ENSG00000196139","AKR1C3","10",5035354,5107686,72332
"353","ENSG00000198610","ENSG00000198610","AKR1C4","10",5195462,5218949,23487
"354","ENSG00000053371","ENSG00000053371","AKR7A2","1",19303965,19312144,8179
"355","ENSG00000162482","ENSG00000162482","AKR7A3","1",19282573,19288770,6197
"356","ENSG00000142208","ENSG00000142208","AKT1","14",104769349,104795759,26410
"357","ENSG00000105221","ENSG00000105221","AKT2","19",40230317,40285536,55219
"358","ENSG00000275199","ENSG00000275199","AKT3","HSCHR1_3_CTG32_1",500341,867542,367201
"359","ENSG00000166971","ENSG00000166971","AKTIP","16",53491040,53504411,13371
"360","ENSG00000023330","ENSG00000023330","ALAS1","3",52198086,52214327,16241
"361","ENSG00000158578","ENSG00000158578","ALAS2","X",55009055,55030977,21922
"362","ENSG00000163631","ENSG00000163631","ALB","4",73397114,73421482,24368
"363","ENSG00000170017","ENSG00000170017","ALCAM","3",105366909,105576900,209991
"364","ENSG00000059573","ENSG00000059573","ALDH18A1","10",95605941,95656711,50770
"365","ENSG00000165092","ENSG00000165092","ALDH1A1","9",72900671,73080442,179771
"366","ENSG00000128918","ENSG00000128918","ALDH1A2","15",57953424,58497866,544442
"367","ENSG00000184254","ENSG00000184254","ALDH1A3","15",100877714,100916626,38912
"368","ENSG00000137124","ENSG00000137124","ALDH1B1","9",38392702,38398661,5959
"369","ENSG00000144908","ENSG00000144908","ALDH1L1","3",126103562,126197994,94432
"370","ENSG00000111275","ENSG00000111275","ALDH2","12",111766887,111817532,50645
"371","ENSG00000108602","ENSG00000108602","ALDH3A1","17",19737984,19748943,10959
"372","ENSG00000072210","ENSG00000072210","ALDH3A2","17",19648136,19685760,37624
"373","ENSG00000006534","ENSG00000006534","ALDH3B1","11",68008578,68029282,20704
"374","ENSG00000132746","ENSG00000132746","ALDH3B2","11",67662155,67681224,19069
"375","ENSG00000159423","ENSG00000159423","ALDH4A1","1",18871430,18902724,31294
"376","ENSG00000112294","ENSG00000112294","ALDH5A1","6",24494867,24537207,42340
"377","ENSG00000119711","ENSG00000119711","ALDH6A1","14",74056847,74084492,27645
"378","ENSG00000164904","ENSG00000164904","ALDH7A1","5",126531200,126595362,64162
"379","ENSG00000118514","ENSG00000118514","ALDH8A1","6",134917393,134950115,32722
"380","ENSG00000143149","ENSG00000143149","ALDH9A1","1",165662216,165698562,36346
"381","ENSG00000149925","ENSG00000149925","ALDOA","16",30064164,30070457,6293
"382","ENSG00000136872","ENSG00000136872","ALDOB","9",101420560,101449664,29104
"383","ENSG00000109107","ENSG00000109107","ALDOC","17",28573115,28576948,3833
"384","ENSG00000182858","ENSG00000182858","ALG12","22",49900229,49918438,18209
"385","ENSG00000101901","ENSG00000101901","ALG13","X",111665811,111760649,94838
"386","ENSG00000214160","ENSG00000214160","ALG3","3",184242301,184249548,7247
"387","ENSG00000120697","ENSG00000120697","ALG5","13",36949738,37000763,51025
"388","ENSG00000088035","ENSG00000088035","ALG6","1",63367575,63438553,70978
"389","ENSG00000159063","ENSG00000159063","ALG8","11",78095244,78139660,44416
"390","ENSG00000086848","ENSG00000086848","ALG9","11",111782195,111871581,89386
"391","ENSG00000171094","ENSG00000171094","ALK","2",29192774,29921586,728812
"392","ENSG00000100601","ENSG00000100601","ALKBH1","14",77672404,77708023,35619
"393","ENSG00000160993","ENSG00000160993","ALKBH4","7",102456238,102464863,8625
"394","ENSG00000151360","ENSG00000151360","ALLC","2",3658200,3702671,44471
"395","ENSG00000116127","ENSG00000116127","ALMS1","2",73385758,73625166,239408
"396","ENSG00000108839","ENSG00000108839","ALOX12","17",6996049,7010754,14705
"397","ENSG00000179477","ENSG00000179477","ALOX12B","17",8072636,8087716,15080
"398","ENSG00000161905","ENSG00000161905","ALOX15","17",4630919,4642294,11375
"399","ENSG00000179593","ENSG00000179593","ALOX15B","17",8039034,8049134,10100
"400","ENSG00000275565","ENSG00000275565","ALOX5","HSCHR10_1_CTG2",215007,286950,71943
"401","ENSG00000132965","ENSG00000132965","ALOX5AP","13",30713478,30764426,50948
"402","ENSG00000179148","ENSG00000179148","ALOXE3","17",8095900,8119047,23147
"403","ENSG00000163295","ENSG00000163295","ALPI","2",232456125,232460753,4628
"404","ENSG00000073331","ENSG00000073331","ALPK1","4",112285509,112442621,157112
"405","ENSG00000136383","ENSG00000136383","ALPK3","15",84817356,84873479,56123
"406","ENSG00000162551","ENSG00000162551","ALPL","1",21509397,21578410,69013
"407","ENSG00000163283","ENSG00000163283","ALPP","2",232378724,232382889,4165
"408","ENSG00000180318","ENSG00000180318","ALX1","12",85280220,85301784,21564
"409","ENSG00000156150","ENSG00000156150","ALX3","1",110059870,110070672,10802
"410","ENSG00000242110","ENSG00000242110","AMACR","5",33986165,34008104,21939
"411","ENSG00000178522","ENSG00000178522","AMBN","4",70592256,70607288,15032
"412","ENSG00000106927","ENSG00000106927","AMBP","9",114060127,114078328,18201
"413","ENSG00000110497","ENSG00000110497","AMBRA1","11",46396414,46594125,197711
"414","ENSG00000123505","ENSG00000123505","AMD1","6",110874770,110898879,24109
"415","ENSG00000162066","ENSG00000162066","AMDHD2","16",2520357,2531422,11065
"416","ENSG00000159461","ENSG00000159461","AMFR","16",56361452,56425545,64093
"417","ENSG00000104899","ENSG00000104899","AMH","19",2249309,2252073,2764
"418","ENSG00000135409","ENSG00000135409","AMHR2","12",53423855,53431672,7817
"419","ENSG00000139211","ENSG00000139211","AMIGO2","12",47075707,47079959,4252
"420","ENSG00000101935","ENSG00000101935","AMMECR1","X",110194186,110440318,246132
"421","ENSG00000126016","ENSG00000126016","AMOT","X",112774503,112840831,66328
"422","ENSG00000114019","ENSG00000114019","AMOTL2","3",134355347,134375479,20132
"423","ENSG00000116337","ENSG00000116337","AMPD2","1",109616104,109632051,15947
"424","ENSG00000133805","ENSG00000133805","AMPD3","11",10308313,10507579,199266
"425","ENSG00000078053","ENSG00000078053","AMPH","7",38383704,38631420,247716
"426","ENSG00000145020","ENSG00000145020","AMT","3",49416778,49422685,5907
"427","ENSG00000174876","ENSG00000174876","AMY1B","1",103687415,103696454,9039
"428","ENSG00000243480","ENSG00000243480","AMY2A","1",103617427,103625780,8353
"429","ENSG00000240038","ENSG00000240038","AMY2B","1",103553815,103579534,25719
"430","ENSG00000196704","ENSG00000196704","AMZ2","17",68205481,68257712,52231
"431","ENSG00000164162","ENSG00000164162","ANAPC10","4",144831908,145098541,266633
"432","ENSG00000129055","ENSG00000129055","ANAPC13","3",134477706,134486716,9010
"433","ENSG00000110200","ENSG00000110200","ANAPC15","11",72106378,72112780,6402
"434","ENSG00000176248","ENSG00000176248","ANAPC2","9",137174784,137188560,13776
"435","ENSG00000089053","ENSG00000089053","ANAPC5","12",121308245,121399896,91651
"436","ENSG00000214274","ENSG00000214274","ANG","14",20684177,20698971,14794
"437","ENSG00000013523","ENSG00000013523","ANGEL1","14",76781733,76826246,44513
"438","ENSG00000174606","ENSG00000174606","ANGEL2","1",212992182,213015867,23685
"439","ENSG00000154188","ENSG00000154188","ANGPT1","8",107249482,107498055,248573
"440","ENSG00000091879","ENSG00000091879","ANGPT2","8",6499632,6563409,63777
"441","ENSG00000101280","ENSG00000101280","ANGPT4","20",869900,916334,46434
"442","ENSG00000136859","ENSG00000136859","ANGPTL2","9",127087348,127122635,35287
"443","ENSG00000132855","ENSG00000132855","ANGPTL3","1",62597520,62606313,8793
"444","ENSG00000167772","ENSG00000167772","ANGPTL4","19",8363289,8374370,11081
"445","ENSG00000171819","ENSG00000171819","ANGPTL7","1",11189355,11195981,6626
"446","ENSG00000130173","ENSG00000130173","ANGPTL8","19",11237502,11241943,4441
"447","ENSG00000029534","ENSG00000029534","ANK1","8",41653220,41896741,243521
"448","ENSG00000145362","ENSG00000145362","ANK2","4",112818032,113384221,566189
"449","ENSG00000151150","ENSG00000151150","ANK3","10",60026298,60733490,707192
"450","ENSG00000132623","ENSG00000132623","ANKEF1","20",9986126,10058303,72177
"451","ENSG00000185722","ENSG00000185722","ANKFY1","17",4163821,4263995,100174
"452","ENSG00000154122","ENSG00000154122","ANKH","5",14704800,14871778,166978
"453","ENSG00000131503","ENSG00000131503","ANKHD1","5",140401814,140539856,138042
"454","ENSG00000254996","ENSG00000254996","ANKHD1-EIF4EBP3","5",140401908,140549569,147661
"455","ENSG00000176915","ENSG00000176915","ANKLE2","12",132725503,132761832,36329
"456","ENSG00000144504","ENSG00000144504","ANKMY1","2",240479422,240569209,89787
"457","ENSG00000106524","ENSG00000106524","ANKMY2","7",16599779,16645817,46038
"458","ENSG00000164331","ENSG00000164331","ANKRA2","5",73552190,73565667,13477
"459","ENSG00000148677","ENSG00000148677","ANKRD1","10",90912096,90921087,8991
"460","ENSG00000088448","ENSG00000088448","ANKRD10","13",110878540,110915069,36529
"461","ENSG00000167522","ENSG00000167522","ANKRD11","16",89267630,89490561,222931
"462","ENSG00000101745","ENSG00000101745","ANKRD12","18",9136228,9285985,149757
"463","ENSG00000132466","ENSG00000132466","ANKRD17","4",73073376,73258798,185422
"464","ENSG00000165887","ENSG00000165887","ANKRD2","10",97572499,97583884,11385
"465","ENSG00000107890","ENSG00000107890","ANKRD26","10",26973793,27100494,126701
"466","ENSG00000105186","ENSG00000105186","ANKRD27","19",32597006,32676597,79591
"467","ENSG00000206560","ENSG00000206560","ANKRD28","3",15667236,15859771,192535
"468","ENSG00000235711","ENSG00000235711","ANKRD34C","15",79282722,79298239,15517
"469","ENSG00000135976","ENSG00000135976","ANKRD36","2",97113153,97264521,151368
"470","ENSG00000196912","ENSG00000196912","ANKRD36B","2",97492663,97589877,97214
"471","ENSG00000154945","ENSG00000154945","ANKRD40","17",50693198,50707914,14716
"472","ENSG00000186106","ENSG00000186106","ANKRD46","8",100509752,100559784,50032
"473","ENSG00000168876","ENSG00000168876","ANKRD49","11",94493979,94499578,5599
"474","ENSG00000164512","ENSG00000164512","ANKRD55","5",56099680,56233330,133650
"475","ENSG00000135299","ENSG00000135299","ANKRD6","6",89433152,89633834,200682
"476","ENSG00000106013","ENSG00000106013","ANKRD7","7",118214669,118496171,281502
"477","ENSG00000064999","ENSG00000064999","ANKS1A","6",34889255,35091406,202151
"478","ENSG00000185046","ENSG00000185046","ANKS1B","12",98726457,99984936,1258479
"479","ENSG00000163516","ENSG00000163516","ANKZF1","2",219229783,219236679,6896
"480","ENSG00000131620","ENSG00000131620","ANO1","11",69985907,70189530,203623
"481","ENSG00000160746","ENSG00000160746","ANO10","3",43354859,43691594,336735
"482","ENSG00000047617","ENSG00000047617","ANO2","12",5531869,5946232,414363
"483","ENSG00000134343","ENSG00000134343","ANO3","11",26188842,26663289,474447
"484","ENSG00000011201","ENSG00000011201","ANOS1","X",8528874,8732137,203263
"485","ENSG00000140350","ENSG00000140350","ANP32A","15",68778535,68820897,42362
"486","ENSG00000136938","ENSG00000136938","ANP32B","9",97983341,98015943,32602
"487","ENSG00000143401","ENSG00000143401","ANP32E","1",150218417,150236156,17739
"488","ENSG00000166825","ENSG00000166825","ANPEP","15",89784895,89815401,30506
"489","ENSG00000169604","ENSG00000169604","ANTXR1","2",69013176,69249327,236151
"490","ENSG00000135046","ENSG00000135046","ANXA1","9",73151865,73170393,18528
"491","ENSG00000109511","ENSG00000109511","ANXA10","4",168092537,168187736,95199
"492","ENSG00000122359","ENSG00000122359","ANXA11","10",80150889,80205572,54683
"493","ENSG00000104537","ENSG00000104537","ANXA13","8",123680794,123737402,56608
"494","ENSG00000182718","ENSG00000182718","ANXA2","15",60347134,60402883,55749
"495","ENSG00000138772","ENSG00000138772","ANXA3","4",78551747,78610451,58704
"496","ENSG00000196975","ENSG00000196975","ANXA4","2",69644425,69827112,182687
"497","ENSG00000164111","ENSG00000164111","ANXA5","4",121667946,121696995,29049
"498","ENSG00000197043","ENSG00000197043","ANXA6","5",151100706,151157815,57109
"499","ENSG00000138279","ENSG00000138279","ANXA7","10",73375101,73414076,38975
"500","ENSG00000264230","ENSG00000264230","ANXA8L1","10",46375627,46391784,16157
"501","ENSG00000143412","ENSG00000143412","ANXA9","1",150982249,150995634,13385
"502","ENSG00000136250","ENSG00000136250","AOAH","7",36512941,36724549,211608
"503","ENSG00000002726","ENSG00000002726","AOC1","7",150824627,150861504,36877
"504","ENSG00000131480","ENSG00000131480","AOC2","17",42844580,42850707,6127
"505","ENSG00000131471","ENSG00000131471","AOC3","17",42851184,42858130,6946
"506","ENSG00000138356","ENSG00000138356","AOX1","2",200586014,200677064,91050
"507","ENSG00000138660","ENSG00000138660","AP1AR","4",112231740,112273110,41370
"508","ENSG00000100280","ENSG00000100280","AP1B1","22",29327680,29388583,60903
"509","ENSG00000166747","ENSG00000166747","AP1G1","16",71729000,71809201,80201
"510","ENSG00000129354","ENSG00000129354","AP1M2","19",10572671,10587315,14644
"511","ENSG00000106367","ENSG00000106367","AP1S1","7",101154456,101161596,7140
"512","ENSG00000182287","ENSG00000182287","AP1S2","X",15825806,15854931,29125
"513","ENSG00000281385","ENSG00000281385","AP2A2","HSCHR11_3_CTG1",3478,81830,78352
"514","ENSG00000006125","ENSG00000006125","AP2B1","17",35578046,35726413,148367
"515","ENSG00000161203","ENSG00000161203","AP2M1","3",184174689,184184214,9525
"516","ENSG00000042753","ENSG00000042753","AP2S1","19",46838136,46850846,12710
"517","ENSG00000132842","ENSG00000132842","AP3B1","5",78000522,78294762,294240
"518","ENSG00000103723","ENSG00000103723","AP3B2","15",82659281,82710112,50831
"519","ENSG00000065000","ENSG00000065000","AP3D1","19",2100988,2164468,63480
"520","ENSG00000070718","ENSG00000070718","AP3M2","8",42152946,42171673,18727
"521","ENSG00000177879","ENSG00000177879","AP3S1","5",115841592,115914081,72489
"522","ENSG00000157823","ENSG00000157823","AP3S2","15",89830599,89894638,64039
"523","ENSG00000081014","ENSG00000081014","AP4E1","15",50908672,51005895,97223
"524","ENSG00000221838","ENSG00000221838","AP4M1","7",100100858,100110345,9487
"525","ENSG00000100478","ENSG00000100478","AP4S1","14",31025106,31130996,105890
"526","ENSG00000053770","ENSG00000053770","AP5M1","14",57268924,57298742,29818
"527","ENSG00000125843","ENSG00000125843","AP5S1","20",3820524,3828838,8314
"528","ENSG00000242802","ENSG00000242802","AP5Z1","7",4775615,4794397,18782
"529","ENSG00000120868","ENSG00000120868","APAF1","12",98645149,98735433,90284
"530","ENSG00000276497","ENSG00000276497","APBA1","HSCHR9_1_CTG2",21985,70597,48612
"531","ENSG00000276495","ENSG00000276495","APBA2","HSCHR15_4_CTG8",1194322,1393362,199040
"532","ENSG00000011132","ENSG00000011132","APBA3","19",3750772,3761692,10920
"533","ENSG00000166313","ENSG00000166313","APBB1","11",6395125,6419414,24289
"534","ENSG00000077420","ENSG00000077420","APBB1IP","10",26438341,26567803,129462
"535","ENSG00000163697","ENSG00000163697","APBB2","4",40810027,41216714,406687
"536","ENSG00000113108","ENSG00000113108","APBB3","5",140558268,140564781,6513
"537","ENSG00000134982","ENSG00000134982","APC","5",112707518,112846239,138721
"538","ENSG00000115266","ENSG00000115266","APC2","19",1446302,1473244,26942
"539","ENSG00000132703","ENSG00000132703","APCS","1",159587826,159588865,1039
"540","ENSG00000164062","ENSG00000164062","APEH","3",49674014,49683971,9957
"541","ENSG00000100823","ENSG00000100823","APEX1","14",20455191,20457772,2581
"542","ENSG00000169188","ENSG00000169188","APEX2","X",55000363,55009057,8694
"543","ENSG00000117362","ENSG00000117362","APH1A","1",150265399,150269580,4181
"544","ENSG00000138613","ENSG00000138613","APH1B","15",63276018,63309126,33108
"545","ENSG00000166181","ENSG00000166181","API5","11",43311963,43344529,32566
"546","ENSG00000149089","ENSG00000149089","APIP","11",34853094,34916379,63285
"547","ENSG00000134817","ENSG00000134817","APLNR","11",57233577,57237250,3673
"548","ENSG00000105290","ENSG00000105290","APLP1","19",35867899,35879792,11893
"549","ENSG00000084234","ENSG00000084234","APLP2","11",130068147,130144811,76664
"550","ENSG00000101474","ENSG00000101474","APMAP","20",24962925,24992751,29826
"551","ENSG00000118137","ENSG00000118137","APOA1","11",116835751,116837622,1871
"552","ENSG00000110244","ENSG00000110244","APOA4","11",116820700,116823304,2604
"553","ENSG00000084674","ENSG00000084674","APOB","2",21001429,21044073,42644
"554","ENSG00000124701","ENSG00000124701","APOBEC2","6",41053202,41064891,11689
"555","ENSG00000179750","ENSG00000179750","APOBEC3B","22",38982347,38992804,10457
"556","ENSG00000244509","ENSG00000244509","APOBEC3C","22",39014257,39020352,6095
"557","ENSG00000128394","ENSG00000128394","APOBEC3F","22",39040604,39055972,15368
"558","ENSG00000239713","ENSG00000239713","APOBEC3G","22",39077067,39087743,10676
"559","ENSG00000184730","ENSG00000184730","APOBR","16",28494643,28498964,4321
"560","ENSG00000130208","ENSG00000130208","APOC1","19",44914247,44919349,5102
"561","ENSG00000110245","ENSG00000110245","APOC3","11",116829706,116833072,3366
"562","ENSG00000267467","ENSG00000267467","APOC4","19",44942237,44945496,3259
"563","ENSG00000189058","ENSG00000189058","APOD","3",195568705,195584033,15328
"564","ENSG00000130203","ENSG00000130203","APOE","19",44905791,44909393,3602
"565","ENSG00000175336","ENSG00000175336","APOF","12",56360568,56362857,2289
"566","ENSG00000091583","ENSG00000091583","APOH","17",66212033,66256525,44492
"567","ENSG00000100342","ENSG00000100342","APOL1","22",36253071,36267530,14459
"568","ENSG00000128335","ENSG00000128335","APOL2","22",36226209,36239954,13745
"569","ENSG00000128284","ENSG00000128284","APOL3","22",36140329,36166177,25848
"570","ENSG00000221963","ENSG00000221963","APOL6","22",35648446,35668404,19958
"571","ENSG00000178878","ENSG00000178878","APOLD1","12",12725917,12829975,104058
"572","ENSG00000235754","ENSG00000235754","APOM","HSCHR6_MHC_SSTO_CTG1",2951694,2957487,5793
"573","ENSG00000184831","ENSG00000184831","APOO","X",23833353,23907938,74585
"574","ENSG00000142192","ENSG00000142192","APP","21",25880535,26171128,290593
"575","ENSG00000062725","ENSG00000062725","APPBP2","17",60443158,60526242,83084
"576","ENSG00000157500","ENSG00000157500","APPL1","3",57227726,57278105,50379
"577","ENSG00000136044","ENSG00000136044","APPL2","12",105173297,105236203,62906
"578","ENSG00000198931","ENSG00000198931","APRT","16",88809339,88811937,2598
"579","ENSG00000137074","ENSG00000137074","APTX","9",32886601,33025130,138529
"580","ENSG00000240583","ENSG00000240583","AQP1","7",30911853,30925517,13664
"581","ENSG00000167580","ENSG00000167580","AQP2","12",49950737,49958878,8141
"582","ENSG00000165272","ENSG00000165272","AQP3","9",33441156,33447596,6440
"583","ENSG00000171885","ENSG00000171885","AQP4","18",26852043,26865771,13728
"584","ENSG00000086159","ENSG00000086159","AQP6","12",49967194,49977139,9945
"585","ENSG00000165269","ENSG00000165269","AQP7","9",33383179,33402682,19503
"586","ENSG00000103375","ENSG00000103375","AQP8","16",25215731,25228932,13201
"587","ENSG00000103569","ENSG00000103569","AQP9","15",58138169,58185911,47742
"588","ENSG00000021776","ENSG00000021776","AQR","15",34851782,34969742,117960
"589","ENSG00000169083","ENSG00000169083","AR","X",67544021,67730619,186598
"590","ENSG00000078061","ENSG00000078061","ARAF","X",47561205,47571908,10703
"591","ENSG00000186635","ENSG00000186635","ARAP1","11",72685069,72793599,108530
"592","ENSG00000047365","ENSG00000047365","ARAP2","4",35948221,36244514,296293
"593","ENSG00000120318","ENSG00000120318","ARAP3","5",141653401,141682230,28829
"594","ENSG00000198576","ENSG00000198576","ARC","8",142611049,142614479,3430
"595","ENSG00000095139","ENSG00000095139","ARCN1","11",118572390,118603033,30643
"596","ENSG00000109321","ENSG00000109321","AREG","4",74445136,74455005,9869
"597","ENSG00000143761","ENSG00000143761","ARF1","1",228082708,228099212,16504
"598","ENSG00000134287","ENSG00000134287","ARF3","12",48935723,48957487,21764
"599","ENSG00000168374","ENSG00000168374","ARF4","3",57571363,57598220,26857
"600","ENSG00000004059","ENSG00000004059","ARF5","7",127588386,127591700,3314
"601","ENSG00000101199","ENSG00000101199","ARFGAP1","20",63272785,63289790,17005
"602","ENSG00000149182","ENSG00000149182","ARFGAP2","11",47164299,47177125,12826
"603","ENSG00000242247","ENSG00000242247","ARFGAP3","22",42796502,42858106,61604
"604","ENSG00000066777","ENSG00000066777","ARFGEF1","8",67173511,67343781,170270
"605","ENSG00000124198","ENSG00000124198","ARFGEF2","20",48921711,49036693,114982
"606","ENSG00000164144","ENSG00000164144","ARFIP1","4",152779937,152918463,138526
"607","ENSG00000132254","ENSG00000132254","ARFIP2","11",6474683,6481479,6796
"608","ENSG00000101246","ENSG00000101246","ARFRP1","20",63698642,63708025,9383
"609","ENSG00000118520","ENSG00000118520","ARG1","6",131470832,131584332,113500
"610","ENSG00000081181","ENSG00000081181","ARG2","14",67619920,67651708,31788
"611","ENSG00000134884","ENSG00000134884","ARGLU1","13",106541673,106568137,26464
"612","ENSG00000175220","ENSG00000175220","ARHGAP1","11",46677080,46700619,23539
"613","ENSG00000071205","ENSG00000071205","ARHGAP10","4",147732063,148072776,340713
"614","ENSG00000275568","ENSG00000275568","ARHGAP11A","HSCHR15_4_CTG8",4829724,4854533,24809
"615","ENSG00000165322","ENSG00000165322","ARHGAP12","10",31805398,31928876,123478
"616","ENSG00000075884","ENSG00000075884","ARHGAP15","2",143091362,143768352,676990
"617","ENSG00000140750","ENSG00000140750","ARHGAP17","16",24919389,25015666,96277
"618","ENSG00000213390","ENSG00000213390","ARHGAP19","10",97222173,97292673,70500
"619","ENSG00000128805","ENSG00000128805","ARHGAP22","10",48446036,48656265,210229
"620","ENSG00000138639","ENSG00000138639","ARHGAP24","4",85475150,86002668,527518
"621","ENSG00000163219","ENSG00000163219","ARHGAP25","2",68679601,68826833,147232
"622","ENSG00000145819","ENSG00000145819","ARHGAP26","5",142770377,143229011,458634
"623","ENSG00000088756","ENSG00000088756","ARHGAP28","18",6729716,6915716,186000
"624","ENSG00000137962","ENSG00000137962","ARHGAP29","1",94148988,94275068,126080
"625","ENSG00000134909","ENSG00000134909","ARHGAP32","11",128965060,129279324,314264
"626","ENSG00000004777","ENSG00000004777","ARHGAP33","19",35774532,35788822,14290
"627","ENSG00000160007","ENSG00000160007","ARHGAP35","19",46860997,47005077,144080
"628","ENSG00000089820","ENSG00000089820","ARHGAP4","X",153907367,153934999,27632
"629","ENSG00000006740","ENSG00000006740","ARHGAP44","17",12789498,12991643,202145
"630","ENSG00000180448","ENSG00000180448","ARHGAP45","19",1065923,1086628,20705
"631","ENSG00000100852","ENSG00000100852","ARHGAP5","14",32076114,32159728,83614
"632","ENSG00000047648","ENSG00000047648","ARHGAP6","X",11117651,11665920,548269
"633","ENSG00000241484","ENSG00000241484","ARHGAP8","22",44752558,44862788,110230
"634","ENSG00000141522","ENSG00000141522","ARHGDIA","17",81867721,81871378,3657
"635","ENSG00000111348","ENSG00000111348","ARHGDIB","12",14942031,14961728,19697
"636","ENSG00000242173","ENSG00000242173","ARHGDIG","16",280450,283010,2560
"637","ENSG00000076928","ENSG00000076928","ARHGEF1","19",41883173,41930150,46977
"638","ENSG00000274726","ENSG00000274726","ARHGEF10","HSCHR8_8_CTG1",7352,142017,134665
"639","ENSG00000074964","ENSG00000074964","ARHGEF10L","1",17539698,17697874,158176
"640","ENSG00000132694","ENSG00000132694","ARHGEF11","1",156934840,157046903,112063
"641","ENSG00000196914","ENSG00000196914","ARHGEF12","11",120336413,120489937,153524
"642","ENSG00000198844","ENSG00000198844","ARHGEF15","17",8310241,8322514,12273
"643","ENSG00000130762","ENSG00000130762","ARHGEF16","1",3454665,3481113,26448
"644","ENSG00000110237","ENSG00000110237","ARHGEF17","11",73308276,73369388,61112
"645","ENSG00000104880","ENSG00000104880","ARHGEF18","19",7348937,7472485,123548
"646","ENSG00000116584","ENSG00000116584","ARHGEF2","1",155946851,156007070,60219
"647","ENSG00000277101","ENSG00000277101","ARHGEF26","HSCHR3_2_CTG2_1",24216,164217,140001
"648","ENSG00000214944","ENSG00000214944","ARHGEF28","5",73626158,73941993,315835
"649","ENSG00000163947","ENSG00000163947","ARHGEF3","3",56727418,57079329,351911
"650","ENSG00000236699","ENSG00000236699","ARHGEF38","4",105552620,105708093,155473
"651","ENSG00000136002","ENSG00000136002","ARHGEF4","2",130836914,131047263,210349
"652","ENSG00000165801","ENSG00000165801","ARHGEF40","14",21070273,21090248,19975
"653","ENSG00000050327","ENSG00000050327","ARHGEF5","7",144355288,144380632,25344
"654","ENSG00000129675","ENSG00000129675","ARHGEF6","X",136665547,136780932,115385
"655","ENSG00000102606","ENSG00000102606","ARHGEF7","13",111114559,111305737,191178
"656","ENSG00000131089","ENSG00000131089","ARHGEF9","X",63634967,63809274,174307
"657","ENSG00000117713","ENSG00000117713","ARID1A","1",26693236,26782104,88868
"658","ENSG00000116017","ENSG00000116017","ARID3A","19",925781,975939,50158
"659","ENSG00000179361","ENSG00000179361","ARID3B","15",74541206,74598131,56925
"660","ENSG00000032219","ENSG00000032219","ARID4A","14",58298504,58373887,75383
"661","ENSG00000054267","ENSG00000054267","ARID4B","1",235131634,235328219,196585
"662","ENSG00000196843","ENSG00000196843","ARID5A","2",96536743,96552634,15891
"663","ENSG00000150347","ENSG00000150347","ARID5B","10",61901684,62096944,195260
"664","ENSG00000166233","ENSG00000166233","ARIH1","15",72474330,72602987,128657
"665","ENSG00000177479","ENSG00000177479","ARIH2","3",48918821,48986382,67561
"666","ENSG00000120805","ENSG00000120805","ARL1","12",101393116,101407772,14656
"667","ENSG00000179674","ENSG00000179674","ARL14","3",160677160,160678448,1288
"668","ENSG00000185305","ENSG00000185305","ARL15","5",53883942,54310582,426640
"669","ENSG00000185829","ENSG00000185829","ARL17A","17",46499780,46579695,79915
"670","ENSG00000276276","ENSG00000276276","ARL17B","HSCHR17_2_CTG5",977173,1099388,122215
"671","ENSG00000213465","ENSG00000213465","ARL2","11",65014160,65022184,8024
"672","ENSG00000102931","ENSG00000102931","ARL2BP","16",57245259,57253635,8376
"673","ENSG00000138175","ENSG00000138175","ARL3","10",102673731,102714397,40666
"674","ENSG00000188042","ENSG00000188042","ARL4C","2",234493041,234497081,4040
"675","ENSG00000175906","ENSG00000175906","ARL4D","17",43398993,43401137,2144
"676","ENSG00000162980","ENSG00000162980","ARL5A","2",151788984,151828492,39508
"677","ENSG00000170540","ENSG00000170540","ARL6IP1","16",18791669,18801572,9903
"678","ENSG00000182196","ENSG00000182196","ARL6IP4","12",122980060,122982913,2853
"679","ENSG00000144746","ENSG00000144746","ARL6IP5","3",69084937,69106092,21155
"680","ENSG00000134108","ENSG00000134108","ARL8B","3",5122249,5180911,58662
"681","ENSG00000104442","ENSG00000104442","ARMC1","8",65602458,65634217,31759
"682","ENSG00000105676","ENSG00000105676","ARMC6","19",19033575,19060311,26736
"683","ENSG00000125449","ENSG00000125449","ARMC7","17",75109952,75130272,20320
"684","ENSG00000114098","ENSG00000114098","ARMC8","3",138187248,138298384,111136
"685","ENSG00000135931","ENSG00000135931","ARMC9","2",231198546,231376848,178302
"686","ENSG00000126947","ENSG00000126947","ARMCX1","X",101550547,101554700,4153
"687","ENSG00000184867","ENSG00000184867","ARMCX2","X",101655281,101659850,4569
"688","ENSG00000102401","ENSG00000102401","ARMCX3","X",101622797,101627843,5046
"689","ENSG00000196440","ENSG00000196440","ARMCX4","X",101418287,101533459,115172
"690","ENSG00000125962","ENSG00000125962","ARMCX5","X",102599168,102604159,4991
"691","ENSG00000198960","ENSG00000198960","ARMCX6","X",101615118,101618001,2883
"692","ENSG00000146476","ENSG00000146476","ARMT1","6",151452258,151470101,17843
"693","ENSG00000143437","ENSG00000143437","ARNT","1",150809713,150876708,66995
"694","ENSG00000172379","ENSG00000172379","ARNT2","15",80404350,80597933,193583
"695","ENSG00000241685","ENSG00000241685","ARPC1A","7",99325898,99366262,40364
"696","ENSG00000130429","ENSG00000130429","ARPC1B","7",99374249,99394816,20567
"697","ENSG00000163466","ENSG00000163466","ARPC2","2",218217141,218254356,37215
"698","ENSG00000241553","ENSG00000241553","ARPC4","3",9792495,9807101,14606
"699","ENSG00000162704","ENSG00000162704","ARPC5","1",183620846,183635783,14937
"700","ENSG00000136950","ENSG00000136950","ARPC5L","9",124862130,124877733,15603
"701","ENSG00000242498","ENSG00000242498","ARPIN","15",89895006,89912952,17946
"702","ENSG00000128989","ENSG00000128989","ARPP19","15",52547045,52569883,22838
"703","ENSG00000172995","ENSG00000172995","ARPP21","3",35638945,35794496,155551
"704","ENSG00000120500","ENSG00000120500","ARR3","X",70268305,70281840,13535
"705","ENSG00000137486","ENSG00000137486","ARRB1","11",75260122,75351705,91583
"706","ENSG00000141480","ENSG00000141480","ARRB2","17",4710596,4721499,10903
"707","ENSG00000100299","ENSG00000100299","ARSA","22",50622754,50628173,5419
"708","ENSG00000113273","ENSG00000113273","ARSB","5",78777209,78986087,208878
"709","ENSG00000006756","ENSG00000006756","ARSD","X",2903972,2929349,25377
"710","ENSG00000062096","ENSG00000062096","ARSF","X",3041471,3112727,71256
"711","ENSG00000180801","ENSG00000180801","ARSJ","4",113900284,113979727,79443
"712","ENSG00000156219","ENSG00000156219","ART3","4",76011184,76114048,102864
"713","ENSG00000111339","ENSG00000111339","ART4","12",14825569,14843526,17957
"714","ENSG00000117407","ENSG00000117407","ARTN","1",43933320,43937240,3920
"715","ENSG00000099889","ENSG00000099889","ARVCF","22",19969896,20016823,46927
"716","ENSG00000104763","ENSG00000104763","ASAH1","8",18055992,18084998,29006
"717","ENSG00000153317","ENSG00000153317","ASAP1","8",130052104,130443674,391570
"718","ENSG00000151693","ENSG00000151693","ASAP2","2",9206765,9405683,198918
"719","ENSG00000088280","ENSG00000088280","ASAP3","1",23428563,23484637,56074
"720","ENSG00000065802","ENSG00000065802","ASB1","2",238426742,238452250,25508
"721","ENSG00000196372","ENSG00000196372","ASB13","10",5638867,5666595,27728
"722","ENSG00000005981","ENSG00000005981","ASB4","7",95478444,95540233,61789
"723","ENSG00000148331","ENSG00000148331","ASB6","9",129634604,129642169,7565
"724","ENSG00000183475","ENSG00000183475","ASB7","15",100602589,100651701,49112
"725","ENSG00000177981","ENSG00000177981","ASB8","12",48147789,48181213,33424
"726","ENSG00000102048","ENSG00000102048","ASB9","X",15235288,15270467,35179
"727","ENSG00000138303","ENSG00000138303","ASCC1","10",72096032,72217134,121102
"728","ENSG00000100325","ENSG00000100325","ASCC2","22",29788609,29838304,49695
"729","ENSG00000112249","ENSG00000112249","ASCC3","6",100508194,100881372,373178
"730","ENSG00000139352","ENSG00000139352","ASCL1","12",102957674,102960513,2839
"731","ENSG00000111875","ENSG00000111875","ASF1A","6",118894152,118909171,15019
"732","ENSG00000105011","ENSG00000105011","ASF1B","19",14119512,14136613,17101
"733","ENSG00000141505","ENSG00000141505","ASGR1","17",7173431,7179564,6133
"734","ENSG00000161944","ENSG00000161944","ASGR2","17",7101322,7115700,14378
"735","ENSG00000116539","ENSG00000116539","ASH1L","1",155335268,155563162,227894
"736","ENSG00000129691","ENSG00000129691","ASH2L","8",38105493,38144076,38583
"737","ENSG00000110881","ENSG00000110881","ASIC1","12",50057548,50083611,26063
"738","ENSG00000108684","ENSG00000108684","ASIC2","17",33013087,34174964,1161877
"739","ENSG00000213199","ENSG00000213199","ASIC3","7",151048292,151052756,4464
"740","ENSG00000126522","ENSG00000126522","ASL","7",66075800,66094697,18897
"741","ENSG00000196433","ENSG00000196433","ASMT","X",1615059,1643081,28022
"742","ENSG00000169093","ENSG00000169093","ASMTL","X",1403139,1453762,50623
"743","ENSG00000070669","ENSG00000070669","ASNS","7",97851677,97872542,20865
"744","ENSG00000138381","ENSG00000138381","ASNSD1","2",189661385,189670831,9446
"745","ENSG00000108381","ENSG00000108381","ASPA","17",3472374,3503405,31031
"746","ENSG00000198363","ENSG00000198363","ASPH","8",61500556,61714640,214084
"747","ENSG00000174939","ENSG00000174939","ASPHD1","16",29900375,29919864,19489
"748","ENSG00000066279","ENSG00000066279","ASPM","1",197084121,197146694,62573
"749","ENSG00000106819","ENSG00000106819","ASPN","9",92456205,92482506,26301
"750","ENSG00000169696","ENSG00000169696","ASPSCR1","17",81976807,82017406,40599
"751","ENSG00000162174","ENSG00000162174","ASRGL1","11",62337448,62393412,55964
"752","ENSG00000130707","ENSG00000130707","ASS1","9",130444961,130501274,56313
"753","ENSG00000034533","ENSG00000034533","ASTE1","3",131013875,131027649,13774
"754","ENSG00000152092","ENSG00000152092","ASTN1","1",176857302,177164973,307671
"755","ENSG00000148219","ENSG00000148219","ASTN2","9",116423112,117415070,991958
"756","ENSG00000171456","ENSG00000171456","ASXL1","20",32358330,32439319,80989
"757","ENSG00000143970","ENSG00000143970","ASXL2","2",25733753,25878487,144734
"758","ENSG00000141431","ENSG00000141431","ASXL3","18",33578219,33751195,172976
"759","ENSG00000156802","ENSG00000156802","ATAD2","8",123319850,123416350,96500
"760","ENSG00000119778","ENSG00000119778","ATAD2B","2",23748664,23927123,178459
"761","ENSG00000197785","ENSG00000197785","ATAD3A","1",1512162,1534685,22523
"762","ENSG00000176208","ENSG00000176208","ATAD5","17",30831966,30895869,63903
"763","ENSG00000235658","ENSG00000235658","ATAT1","HSCHR6_MHC_MANN_CTG1",1937071,1957052,19981
"764","ENSG00000123268","ENSG00000123268","ATF1","12",50763710,50821162,57452
"765","ENSG00000115966","ENSG00000115966","ATF2","2",175072250,175168382,96132
"766","ENSG00000162772","ENSG00000162772","ATF3","1",212565334,212620777,55443
"767","ENSG00000128272","ENSG00000128272","ATF4","22",39519695,39522683,2988
"768","ENSG00000169136","ENSG00000169136","ATF5","19",49928702,49933935,5233
"769","ENSG00000118217","ENSG00000118217","ATF6","1",161766298,161977574,211276
"770","ENSG00000234539","ENSG00000234539","ATF6B","HSCHR6_MHC_COX_CTG1",3553597,3566584,12987
"771","ENSG00000170653","ENSG00000170653","ATF7","12",53507856,53626410,118554
"772","ENSG00000171681","ENSG00000171681","ATF7IP","12",14365676,14502931,137255
"773","ENSG00000166669","ENSG00000166669","ATF7IP2","16",10326434,10483638,157204
"774","ENSG00000123395","ENSG00000123395","ATG101","12",52069246,52077495,8249
"775","ENSG00000145782","ENSG00000145782","ATG12","5",115828200,115841837,13637
"776","ENSG00000175224","ENSG00000175224","ATG13","11",46617527,46674818,57291
"777","ENSG00000126775","ENSG00000126775","ATG14","14",55366391,55411830,45439
"778","ENSG00000281089","ENSG00000281089","ATG16L1","HG2232_PATCH",155389,241012,85623
"779","ENSG00000110046","ENSG00000110046","ATG2A","11",64894546,64917209,22663
"780","ENSG00000066739","ENSG00000066739","ATG2B","14",96279195,96363341,84146
"781","ENSG00000144848","ENSG00000144848","ATG3","3",112532510,112562046,29536
"782","ENSG00000101844","ENSG00000101844","ATG4A","X",108091668,108154671,63003
"783","ENSG00000168397","ENSG00000168397","ATG4B","2",241637213,241673857,36644
"784","ENSG00000057663","ENSG00000057663","ATG5","6",106045423,106325791,280368
"785","ENSG00000197548","ENSG00000197548","ATG7","3",11272309,11557665,285356
"786","ENSG00000198925","ENSG00000198925","ATG9A","2",219219380,219229717,10337
"787","ENSG00000138363","ENSG00000138363","ATIC","2",215311956,215349773,37817
"788","ENSG00000149311","ENSG00000149311","ATM","11",108222804,108369102,146298
"789","ENSG00000166454","ENSG00000166454","ATMIN","16",81035842,81047350,11508
"790","ENSG00000111676","ENSG00000111676","ATN1","12",6924463,6942321,17858
"791","ENSG00000172238","ENSG00000172238","ATOH1","4",93828753,93830964,2211
"792","ENSG00000177556","ENSG00000177556","ATOX1","5",151742316,151772532,30216
"793","ENSG00000206190","ENSG00000206190","ATP10A","15",25677273,25865184,187911
"794","ENSG00000118322","ENSG00000118322","ATP10B","5",160563120,160852214,289094
"795","ENSG00000068650","ENSG00000068650","ATP11A","13",112690038,112887168,197130
"796","ENSG00000058063","ENSG00000058063","ATP11B","3",182793503,182921629,128126
"797","ENSG00000075673","ENSG00000075673","ATP12A","13",24680408,24712472,32064
"798","ENSG00000105726","ENSG00000105726","ATP13A1","19",19645198,19663676,18478
"799","ENSG00000159363","ENSG00000159363","ATP13A2","1",16985958,17011928,25970
"800","ENSG00000163399","ENSG00000163399","ATP1A1","1",116372668,116410261,37593
"801","ENSG00000018625","ENSG00000018625","ATP1A2","1",160115759,160143591,27832
"802","ENSG00000105409","ENSG00000105409","ATP1A3","19",41966582,41997497,30915
"803","ENSG00000143153","ENSG00000143153","ATP1B1","1",169105697,169310992,205295
"804","ENSG00000129244","ENSG00000129244","ATP1B2","17",7646627,7657770,11143
"805","ENSG00000069849","ENSG00000069849","ATP1B3","3",141876124,141926549,50425
"806","ENSG00000196296","ENSG00000196296","ATP2A1","16",28878405,28904466,26061
"807","ENSG00000174437","ENSG00000174437","ATP2A2","12",110280756,110351093,70337
"808","ENSG00000074370","ENSG00000074370","ATP2A3","17",3923870,3964464,40594
"809","ENSG00000070961","ENSG00000070961","ATP2B1","12",89588049,89709366,121317
"810","ENSG00000157087","ENSG00000157087","ATP2B2","3",10324023,10708007,383984
"811","ENSG00000067842","ENSG00000067842","ATP2B3","X",153517642,153582939,65297
"812","ENSG00000058668","ENSG00000058668","ATP2B4","1",203626832,203744081,117249
"813","ENSG00000017260","ENSG00000017260","ATP2C1","3",130850595,131016712,166117
"814","ENSG00000186009","ENSG00000186009","ATP4B","13",113648804,113658198,9394
"815","ENSG00000071553","ENSG00000071553","ATP6AP1","X",154428633,154436516,7883
"816","ENSG00000182220","ENSG00000182220","ATP6AP2","X",40579372,40606848,27476
"817","ENSG00000033627","ENSG00000033627","ATP6V0A1","17",42458844,42522582,63738
"818","ENSG00000185344","ENSG00000185344","ATP6V0A2","12",123712353,123761755,49402
"819","ENSG00000105929","ENSG00000105929","ATP6V0A4","7",138706294,138799560,93266
"820","ENSG00000117410","ENSG00000117410","ATP6V0B","1",43974487,43978295,3808
"821","ENSG00000185883","ENSG00000185883","ATP6V0C","16",2513952,2520218,6266
"822","ENSG00000159720","ENSG00000159720","ATP6V0D1","16",67438014,67481181,43167
"823","ENSG00000113732","ENSG00000113732","ATP6V0E1","5",172983771,173035445,51674
"824","ENSG00000171130","ENSG00000171130","ATP6V0E2","7",149872968,149891204,18236
"825","ENSG00000114573","ENSG00000114573","ATP6V1A","3",113746770,113812056,65286
"826","ENSG00000116039","ENSG00000116039","ATP6V1B1","2",70935900,70965431,29531
"827","ENSG00000147416","ENSG00000147416","ATP6V1B2","8",20197381,20226819,29438
"828","ENSG00000155097","ENSG00000155097","ATP6V1C1","8",103021063,103073051,51988
"829","ENSG00000100554","ENSG00000100554","ATP6V1D","14",67294371,67360265,65894
"830","ENSG00000131100","ENSG00000131100","ATP6V1E1","22",17592136,17628749,36613
"831","ENSG00000128524","ENSG00000128524","ATP6V1F","7",128862856,128865847,2991
"832","ENSG00000136888","ENSG00000136888","ATP6V1G1","9",114587706,114598915,11209
"833","ENSG00000234920","ENSG00000234920","ATP6V1G2","HSCHR6_MHC_SSTO_CTG1",2843746,2846132,2386
"834","ENSG00000047249","ENSG00000047249","ATP6V1H","8",53715543,53843558,128015
"835","ENSG00000165240","ENSG00000165240","ATP7A","X",77910690,78050395,139705
"836","ENSG00000123191","ENSG00000123191","ATP7B","13",51930436,52012125,81689
"837","ENSG00000124406","ENSG00000124406","ATP8A1","4",42408373,42657121,248748
"838","ENSG00000132932","ENSG00000132932","ATP8A2","13",25371974,26025851,653877
"839","ENSG00000081923","ENSG00000081923","ATP8B1","18",57646426,57803315,156889
"840","ENSG00000143515","ENSG00000143515","ATP8B2","1",154325525,154351304,25779
"841","ENSG00000130270","ENSG00000130270","ATP8B3","19",1782075,1812276,30201
"842","ENSG00000104043","ENSG00000104043","ATP8B4","15",49858238,50182817,324579
"843","ENSG00000054793","ENSG00000054793","ATP9A","20",51596514,51768390,171876
"844","ENSG00000166377","ENSG00000166377","ATP9B","18",79069285,79378287,309002
"845","ENSG00000171953","ENSG00000171953","ATPAF2","17",17977409,18039209,61800
"846","ENSG00000175054","ENSG00000175054","ATR","3",142449007,142578733,129726
"847","ENSG00000138085","ENSG00000138085","ATRAID","2",27212041,27217178,5137
"848","ENSG00000088812","ENSG00000088812","ATRN","20",3471018,3651118,180100
"849","ENSG00000107518","ENSG00000107518","ATRNL1","10",115093365,115948999,855634
"850","ENSG00000085224","ENSG00000085224","ATRX","X",77504880,77786233,281353
"851","ENSG00000124788","ENSG00000124788","ATXN1","6",16299112,16761491,462379
"852","ENSG00000130638","ENSG00000130638","ATXN10","22",45671798,45845307,173509
"853","ENSG00000204842","ENSG00000204842","ATXN2","12",111443485,111599676,156191
"854","ENSG00000168488","ENSG00000168488","ATXN2L","16",28822999,28837237,14238
"855","ENSG00000066427","ENSG00000066427","ATXN3","14",92044496,92106621,62125
"856","ENSG00000163635","ENSG00000163635","ATXN7","3",63863155,64003462,140307
"857","ENSG00000148090","ENSG00000148090","AUH","9",91213815,91361918,148103
"858","ENSG00000127423","ENSG00000127423","AUNIP","1",25831913,25859458,27545
"859","ENSG00000115307","ENSG00000115307","AUP1","2",74526645,74529760,3115
"860","ENSG00000087586","ENSG00000087586","AURKA","20",56369389,56392337,22948
"861","ENSG00000175756","ENSG00000175756","AURKAIP1","1",1373730,1375207,1477
"862","ENSG00000178999","ENSG00000178999","AURKB","17",8204733,8210600,5867
"863","ENSG00000105146","ENSG00000105146","AURKC","19",57231009,57235548,4539
"864","ENSG00000158321","ENSG00000158321","AUTS2","7",69598296,70793506,1195210
"865","ENSG00000169857","ENSG00000169857","AVEN","15",33858782,34075155,216373
"866","ENSG00000135407","ENSG00000135407","AVIL","12",57797376,57818734,21358
"867","ENSG00000105778","ENSG00000105778","AVL9","7",32495426,32588726,93300
"868","ENSG00000101200","ENSG00000101200","AVP","20",3082556,3084724,2168
"869","ENSG00000119986","ENSG00000119986","AVPI1","10",97677424,97687241,9817
"870","ENSG00000166148","ENSG00000166148","AVPR1A","12",63142759,63151201,8442
"871","ENSG00000198049","ENSG00000198049","AVPR1B","1",206106936,206117699,10763
"872","ENSG00000126895","ENSG00000126895","AVPR2","X",153902531,153907166,4635
"873","ENSG00000103126","ENSG00000103126","AXIN1","16",287440,352723,65283
"874","ENSG00000167601","ENSG00000167601","AXL","19",41219223,41261766,42543
"875","ENSG00000160862","ENSG00000160862","AZGP1","7",99966720,99976042,9322
"876","ENSG00000163512","ENSG00000163512","AZI2","3",28315003,28349050,34047
"877","ENSG00000155096","ENSG00000155096","AZIN1","8",102826111,102893864,67753
"878","ENSG00000278624","ENSG00000278624","AZU1","HSCHR19_5_CTG2",3940,10861,6921
"879","ENSG00000273686","ENSG00000273686","B2M","HSCHR15_3_CTG8",34826,42225,7399
"880","ENSG00000169255","ENSG00000169255","B3GALNT1","3",161083883,161105411,21528
"881","ENSG00000162630","ENSG00000162630","B3GALT2","1",193178730,193186613,7883
"882","ENSG00000236802","ENSG00000236802","B3GALT4","HSCHR6_MHC_MCF_CTG1",4713098,4714791,1693
"883","ENSG00000183778","ENSG00000183778","B3GALT5","21",39556442,39673137,116695
"884","ENSG00000109956","ENSG00000109956","B3GAT1","11",134378504,134412242,33738
"885","ENSG00000149541","ENSG00000149541","B3GAT3","11",62615296,62622154,6858
"886","ENSG00000170340","ENSG00000170340","B3GNT2","2",62196115,62224731,28616
"887","ENSG00000179913","ENSG00000179913","B3GNT3","19",17794828,17813576,18748
"888","ENSG00000176383","ENSG00000176383","B3GNT4","12",122203681,122208952,5271
"889","ENSG00000277033","ENSG00000277033","B3GNTL1","HSCHR17_1_CTG9",51111,159270,108159
"890","ENSG00000086062","ENSG00000086062","B4GALT1","9",33104082,33167356,63274
"891","ENSG00000117411","ENSG00000117411","B4GALT2","1",43978943,43991170,12227
"892","ENSG00000158850","ENSG00000158850","B4GALT3","1",161171310,161177968,6658
"893","ENSG00000121578","ENSG00000121578","B4GALT4","3",119211732,119240946,29214
"894","ENSG00000158470","ENSG00000158470","B4GALT5","20",49632945,49713878,80933
"895","ENSG00000118276","ENSG00000118276","B4GALT6","18",31622246,31685836,63590
"896","ENSG00000027847","ENSG00000027847","B4GALT7","5",177600132,177610330,10198
"897","ENSG00000174684","ENSG00000174684","B4GAT1","11",66345374,66347629,2255
"898","ENSG00000108641","ENSG00000108641","B9D1","17",19334308,19378193,43885
"899","ENSG00000123810","ENSG00000123810","B9D2","19",41354417,41364165,9748
"900","ENSG00000164929","ENSG00000164929","BAALC","8",103140713,103230305,89592
"901","ENSG00000276559","ENSG00000276559","BAAT","HSCHR9_1_CTG5",422296,432266,9970
"902","ENSG00000105393","ENSG00000105393","BABAM1","19",17267376,17281249,13873
"903","ENSG00000186318","ENSG00000186318","BACE1","11",117285232,117316259,31027
"904","ENSG00000182240","ENSG00000182240","BACE2","21",41167801,41282530,114729
"905","ENSG00000156273","ENSG00000156273","BACH1","21",29194071,29630751,436680
"906","ENSG00000112182","ENSG00000112182","BACH2","6",89926528,90296843,370315
"907","ENSG00000002330","ENSG00000002330","BAD","11",64269830,64284704,14874
"908","ENSG00000107262","ENSG00000107262","BAG1","9",33247820,33264720,16900
"909","ENSG00000112208","ENSG00000112208","BAG2","6",57172326,57189833,17507
"910","ENSG00000151929","ENSG00000151929","BAG3","10",119651380,119677819,26439
"911","ENSG00000156735","ENSG00000156735","BAG4","8",38176533,38213301,36768
"912","ENSG00000166170","ENSG00000166170","BAG5","14",103556545,103562657,6112
"913","ENSG00000234651","ENSG00000234651","BAG6","HSCHR6_MHC_MCF_CTG1",2980907,2994577,13670
"914","ENSG00000266074","ENSG00000266074","BAHCC1","17",81395457,81466331,70874
"915","ENSG00000140320","ENSG00000140320","BAHD1","15",40439721,40468236,28515
"916","ENSG00000175866","ENSG00000175866","BAIAP2","17",81035122,81117434,82312
"917","ENSG00000128298","ENSG00000128298","BAIAP2L2","22",38084652,38111015,26363
"918","ENSG00000007516","ENSG00000007516","BAIAP3","16",1333638,1349439,15801
"919","ENSG00000030110","ENSG00000030110","BAK1","6",33572547,33580293,7746
"920","ENSG00000095739","ENSG00000095739","BAMBI","10",28677510,28682932,5422
"921","ENSG00000175334","ENSG00000175334","BANF1","11",66002228,66004149,1921
"922","ENSG00000153064","ENSG00000153064","BANK1","4",101411286,102074812,663526
"923","ENSG00000172530","ENSG00000172530","BANP","16",87949244,88077318,128074
"924","ENSG00000163930","ENSG00000163930","BAP1","3",52401008,52410008,9000
"925","ENSG00000138376","ENSG00000138376","BARD1","2",214725646,214809683,84037
"926","ENSG00000131668","ENSG00000131668","BARX1","9",93951627,93955355,3728
"927","ENSG00000043039","ENSG00000043039","BARX2","11",129375848,129452279,76431
"928","ENSG00000176788","ENSG00000176788","BASP1","5",17065598,17276843,211245
"929","ENSG00000156127","ENSG00000156127","BATF","14",75522455,75546993,24538
"930","ENSG00000123685","ENSG00000123685","BATF3","1",212686417,212699840,13423
"931","ENSG00000087088","ENSG00000087088","BAX","19",48954815,48961798,6983
"932","ENSG00000198604","ENSG00000198604","BAZ1A","14",34752731,34875647,122916
"933","ENSG00000009954","ENSG00000009954","BAZ1B","7",73440406,73522293,81887
"934","ENSG00000076108","ENSG00000076108","BAZ2A","12",56595596,56636816,41220
"935","ENSG00000123636","ENSG00000123636","BAZ2B","2",159318979,159616569,297590
"936","ENSG00000105327","ENSG00000105327","BBC3","19",47220822,47232766,11944
"937","ENSG00000119636","ENSG00000119636","BBOF1","14",74019349,74082863,63514
"938","ENSG00000129151","ENSG00000129151","BBOX1","11",27040725,27127809,87084
"939","ENSG00000174483","ENSG00000174483","BBS1","11",66510606,66533613,23007
"940","ENSG00000179941","ENSG00000179941","BBS10","12",76344474,76348415,3941
"941","ENSG00000140463","ENSG00000140463","BBS4","15",72686179,72738475,52296
"942","ENSG00000138686","ENSG00000138686","BBS7","4",121824329,121870487,46158
"943","ENSG00000122507","ENSG00000122507","BBS9","7",33109557,33877180,767623
"944","ENSG00000114439","ENSG00000114439","BBX","3",107522936,107811339,288403
"945","ENSG00000187244","ENSG00000187244","BCAM","19",44809071,44821421,12350
"946","ENSG00000132692","ENSG00000132692","BCAN","1",156641390,156659532,18142
"947","ENSG00000075790","ENSG00000075790","BCAP29","7",107580246,107629170,48924
"948","ENSG00000185825","ENSG00000185825","BCAP31","X",153700492,153724565,24073
"949","ENSG00000137936","ENSG00000137936","BCAR3","1",93561741,93847150,285409
"950","ENSG00000064787","ENSG00000064787","BCAS1","20",53936777,54070594,133817
"951","ENSG00000116752","ENSG00000116752","BCAS2","1",114567557,114581629,14072
"952","ENSG00000141376","ENSG00000141376","BCAS3","17",60677453,61392838,715385
"953","ENSG00000124243","ENSG00000124243","BCAS4","20",50794894,50877177,82283
"954","ENSG00000060982","ENSG00000060982","BCAT1","12",24810024,24949101,139077
"955","ENSG00000105552","ENSG00000105552","BCAT2","19",48795062,48811029,15967
"956","ENSG00000114200","ENSG00000114200","BCHE","3",165772904,165837462,64558
"957","ENSG00000248098","ENSG00000248098","BCKDHA","19",41397808,41425002,27194
"958","ENSG00000083123","ENSG00000083123","BCKDHB","6",80106647,80346270,239623
"959","ENSG00000103507","ENSG00000103507","BCKDK","16",31106107,31112791,6684
"960","ENSG00000142867","ENSG00000142867","BCL10","1",85265776,85276632,10856
"961","ENSG00000119866","ENSG00000119866","BCL11A","2",60450520,60554467,103947
"962","ENSG00000127152","ENSG00000127152","BCL11B","14",99169287,99272197,102910
"963","ENSG00000171791","ENSG00000171791","BCL2","18",63123346,63320128,196782
"964","ENSG00000140379","ENSG00000140379","BCL2A1","15",79960892,79971196,10304
"965","ENSG00000171552","ENSG00000171552","BCL2L1","20",31664452,31723989,59537
"966","ENSG00000137875","ENSG00000137875","BCL2L10","15",52109263,52112775,3512
"967","ENSG00000153094","ENSG00000153094","BCL2L11","2",111119378,111168444,49066
"968","ENSG00000099968","ENSG00000099968","BCL2L13","22",17628855,17730855,102000
"969","ENSG00000281449","ENSG00000281449","BCL2L14","HG1362_PATCH",18842,180082,161240
"970","ENSG00000129473","ENSG00000129473","BCL2L2","14",23298790,23311751,12961
"971","ENSG00000069399","ENSG00000069399","BCL3","19",44747705,44760044,12339
"972","ENSG00000113916","ENSG00000113916","BCL6","3",187721377,187745725,24348
"973","ENSG00000110987","ENSG00000110987","BCL7A","12",122019422,122062044,42622
"974","ENSG00000106635","ENSG00000106635","BCL7B","7",73536356,73557690,21334
"975","ENSG00000099385","ENSG00000099385","BCL7C","16",30833626,30894302,60676
"976","ENSG00000116128","ENSG00000116128","BCL9","1",147541501,147626216,84715
"977","ENSG00000029363","ENSG00000029363","BCLAF1","6",136256627,136289851,33224
"978","ENSG00000135697","ENSG00000135697","BCO1","16",81238689,81291142,52453
"979","ENSG00000085185","ENSG00000085185","BCORL1","X",129981107,130058071,76964
"980","ENSG00000186716","ENSG00000186716","BCR","22",23179704,23318037,138333
"981","ENSG00000074582","ENSG00000074582","BCS1L","2",218658764,218663443,4679
"982","ENSG00000164039","ENSG00000164039","BDH2","4",103077592,103099870,22278
"983","ENSG00000100739","ENSG00000100739","BDKRB1","14",96256210,96268967,12757
"984","ENSG00000168398","ENSG00000168398","BDKRB2","14",96204679,96244166,39487
"985","ENSG00000176697","ENSG00000176697","BDNF","11",27654893,27722058,67165
"986","ENSG00000166546","ENSG00000166546","BEAN1","16",66427295,66493529,66234
"987","ENSG00000126581","ENSG00000126581","BECN1","17",42810134,42833350,23216
"988","ENSG00000183092","ENSG00000183092","BEGAIN","14",100537147,100587417,50270
"989","ENSG00000162373","ENSG00000162373","BEND5","1",48727519,48776969,49450
"990","ENSG00000167995","ENSG00000167995","BEST1","11",61950063,61965515,15452
"991","ENSG00000039987","ENSG00000039987","BEST2","19",12751702,12758458,6756
"992","ENSG00000105829","ENSG00000105829","BET1","7",93962762,94004382,41620
"993","ENSG00000177951","ENSG00000177951","BET1L","11",167784,207399,39615
"994","ENSG00000133169","ENSG00000133169","BEX1","X",103062651,103064171,1520
"995","ENSG00000166681","ENSG00000166681","BEX3","X",103376395,103378164,1769
"996","ENSG00000102409","ENSG00000102409","BEX4","X",103215108,103217246,2138
"997","ENSG00000275618","ENSG00000275618","BFAR","HSCHR16_1_CTG1",205671,242094,36423
"998","ENSG00000125864","ENSG00000125864","BFSP1","20",17493905,17569220,75315
"999","ENSG00000242252","ENSG00000242252","BGLAP","1",156242184,156243317,1133
"1000","ENSG00000182492","ENSG00000182492","BGN","X",153494980,153509546,14566
"1001","ENSG00000134107","ENSG00000134107","BHLHE40","3",4979437,4985323,5886
"1002","ENSG00000123095","ENSG00000123095","BHLHE41","12",26120030,26125037,5007
"1003","ENSG00000145692","ENSG00000145692","BHMT","5",79111809,79132288,20479
"1004","ENSG00000132840","ENSG00000132840","BHMT2","5",79069767,79090069,20302
"1005","ENSG00000122870","ENSG00000122870","BICC1","10",58512872,58831435,318563
"1006","ENSG00000151746","ENSG00000151746","BICD1","12",32106835,32383633,276798
"1007","ENSG00000185963","ENSG00000185963","BICD2","9",92711363,92764833,53470
"1008","ENSG00000015475","ENSG00000015475","BID","22",17734138,17774770,40632
"1009","ENSG00000100290","ENSG00000100290","BIK","22",43110750,43129712,18962
"1010","ENSG00000136717","ENSG00000136717","BIN1","2",127048027,127107288,59261
"1011","ENSG00000110934","ENSG00000110934","BIN2","12",51281038,51324668,43630
"1012","ENSG00000147439","ENSG00000147439","BIN3","8",22620418,22669148,48730
"1013","ENSG00000110330","ENSG00000110330","BIRC2","11",102347211,102378670,31459
"1014","ENSG00000023445","ENSG00000023445","BIRC3","11",102317484,102339403,21919
"1015","ENSG00000089685","ENSG00000089685","BIRC5","17",78214186,78225636,11450
"1016","ENSG00000101197","ENSG00000101197","BIRC7","20",63235883,63240495,4612
"1017","ENSG00000166619","ENSG00000166619","BLCAP","20",37492472,37527931,35459
"1018","ENSG00000136573","ENSG00000136573","BLK","8",11486894,11564599,77705
"1019","ENSG00000197299","ENSG00000197299","BLM","15",90717346,90816166,98820
"1020","ENSG00000108578","ENSG00000108578","BLMH","17",30248203,30292056,43853
"1021","ENSG00000095585","ENSG00000095585","BLNK","10",96189171,96271587,82416
"1022","ENSG00000135441","ENSG00000135441","BLOC1S1","12",55716038,55720087,4049
"1023","ENSG00000106605","ENSG00000106605","BLVRA","7",43758680,43807342,48662
"1024","ENSG00000090013","ENSG00000090013","BLVRB","19",40447765,40465764,17999
"1025","ENSG00000117475","ENSG00000117475","BLZF1","1",169367970,169396540,28570
"1026","ENSG00000168283","ENSG00000168283","BMI1","10",22321099,22331484,10385
"1027","ENSG00000168487","ENSG00000168487","BMP1","8",22165140,22212326,47186
"1028","ENSG00000163217","ENSG00000163217","BMP10","2",68860909,68871397,10488
"1029","ENSG00000125845","ENSG00000125845","BMP2","20",6767686,6780246,12560
"1030","ENSG00000138756","ENSG00000138756","BMP2K","4",78776342,78916365,140023
"1031","ENSG00000152785","ENSG00000152785","BMP3","4",81030708,81057627,26919
"1032","ENSG00000125378","ENSG00000125378","BMP4","14",53949736,53958761,9025
"1033","ENSG00000112175","ENSG00000112175","BMP5","6",55753653,55875590,121937
"1034","ENSG00000153162","ENSG00000153162","BMP6","6",7726099,7881728,155629
"1035","ENSG00000101144","ENSG00000101144","BMP7","20",57168753,57266641,97888
"1036","ENSG00000183682","ENSG00000183682","BMP8A","1",39491636,39529869,38233
"1037","ENSG00000107779","ENSG00000107779","BMPR1A","10",86755786,86932825,177039
"1038","ENSG00000138696","ENSG00000138696","BMPR1B","4",94757955,95158448,400493
"1039","ENSG00000204217","ENSG00000204217","BMPR2","2",202376327,202567751,191424
"1040","ENSG00000165733","ENSG00000165733","BMS1","10",42782795,42834937,52142
"1041","ENSG00000102010","ENSG00000102010","BMX","X",15464246,15556529,92283
"1042","ENSG00000169594","ENSG00000169594","BNC1","15",83255884,83284664,28780
"1043","ENSG00000173068","ENSG00000173068","BNC2","9",16409503,16870843,461340
"1044","ENSG00000113734","ENSG00000113734","BNIP1","5",173144442,173164387,19945
"1045","ENSG00000140299","ENSG00000140299","BNIP2","15",59659146,59689339,30193
"1046","ENSG00000176171","ENSG00000176171","BNIP3","10",131967684,131981967,14283
"1047","ENSG00000104765","ENSG00000104765","BNIP3L","8",26383054,26505636,122582
"1048","ENSG00000178096","ENSG00000178096","BOLA1","1",149887890,149900798,12908
"1049","ENSG00000261236","ENSG00000261236","BOP1","8",144262045,144291438,29393
"1050","ENSG00000136122","ENSG00000136122","BORA","13",72727749,72756198,28449
"1051","ENSG00000196544","ENSG00000196544","BORCS6","17",8188345,8190180,1835
"1052","ENSG00000172331","ENSG00000172331","BPGM","7",134646811,134679816,33005
"1053","ENSG00000137274","ENSG00000137274","BPHL","6",3118374,3153578,35204
"1054","ENSG00000101425","ENSG00000101425","BPI","20",38304150,38337505,33355
"1055","ENSG00000198183","ENSG00000198183","BPIFA1","20",33235995,33243311,7316
"1056","ENSG00000162813","ENSG00000162813","BPNT1","1",220057482,220090462,32980
"1057","ENSG00000171634","ENSG00000171634","BPTF","17",67825503,67984378,158875
"1058","ENSG00000157764","ENSG00000157764","BRAF","7",140719327,140924929,205602
"1059","ENSG00000089234","ENSG00000089234","BRAP","12",111642146,111685956,43810
"1060","ENSG00000012048","ENSG00000012048","BRCA1","17",43044295,43170245,125950
"1061","ENSG00000139618","ENSG00000139618","BRCA2","13",32315086,32400268,85182
"1062","ENSG00000185515","ENSG00000185515","BRCC3","X",155071420,155123077,51657
"1063","ENSG00000100425","ENSG00000100425","BRD1","22",49773283,49827873,54590
"1064","ENSG00000236227","ENSG00000236227","BRD2","HSCHR6_MHC_MCF_CTG1",4267717,4278255,10538
"1065","ENSG00000169925","ENSG00000169925","BRD3","9",134030305,134068535,38230
"1066","ENSG00000141867","ENSG00000141867","BRD4","19",15235519,15332545,97026
"1067","ENSG00000166164","ENSG00000166164","BRD7","16",50313487,50368988,55501
"1068","ENSG00000112983","ENSG00000112983","BRD8","5",138139770,138178953,39183
"1069","ENSG00000028310","ENSG00000028310","BRD9","5",850291,892801,42510
"1070","ENSG00000137948","ENSG00000137948","BRDT","1",91949343,92014426,65083
"1071","ENSG00000185024","ENSG00000185024","BRF1","14",105209286,105315589,106303
"1072","ENSG00000104221","ENSG00000104221","BRF2","8",37843268,37849861,6593
"1073","ENSG00000182685","ENSG00000182685","BRICD5","16",2209253,2210905,1652
"1074","ENSG00000078725","ENSG00000078725","BRINP1","9",119153458,119369435,215977
"1075","ENSG00000198797","ENSG00000198797","BRINP2","1",177170958,177282422,111464
"1076","ENSG00000136492","ENSG00000136492","BRIP1","17",61679139,61863559,184420
"1077","ENSG00000113460","ENSG00000113460","BRIX1","5",34915677,34925996,10319
"1078","ENSG00000174744","ENSG00000174744","BRMS1","11",66337333,66345125,7792
"1079","ENSG00000156983","ENSG00000156983","BRPF1","3",9731729,9748019,16290
"1080","ENSG00000102239","ENSG00000102239","BRS3","X",136487947,136493780,5833
"1081","ENSG00000174672","ENSG00000174672","BRSK2","11",1389899,1462689,72790
"1082","ENSG00000185658","ENSG00000185658","BRWD1","21",39184176,39321559,137383
"1083","ENSG00000168000","ENSG00000168000","BSCL2","11",62689289,62709845,20556
"1084","ENSG00000160058","ENSG00000160058","BSDC1","1",32364633,32394731,30098
"1085","ENSG00000172270","ENSG00000172270","BSG","19",571277,583494,12217
"1086","ENSG00000119411","ENSG00000119411","BSPRY","9",113349541,113371233,21692
"1087","ENSG00000109743","ENSG00000109743","BST1","4",15703065,15738313,35248
"1088","ENSG00000130303","ENSG00000130303","BST2","19",17402939,17405630,2691
"1089","ENSG00000095564","ENSG00000095564","BTAF1","10",91923770,92031437,107667
"1090","ENSG00000064726","ENSG00000064726","BTBD1","15",83016423,83067252,50829
"1091","ENSG00000233436","ENSG00000233436","BTBD18","11",57743514,57752675,9161
"1092","ENSG00000133243","ENSG00000133243","BTBD2","19",1985438,2034881,49443
"1093","ENSG00000132640","ENSG00000132640","BTBD3","20",11890723,11926609,35886
"1094","ENSG00000277222","ENSG00000277222","BTBD7","HSCHR14_7_CTG1",352112,447654,95542
"1095","ENSG00000169814","ENSG00000169814","BTD","3",15601341,15722311,120970
"1096","ENSG00000145741","ENSG00000145741","BTF3","5",73498408,73505667,7259
"1097","ENSG00000133639","ENSG00000133639","BTG1","12",92140278,92145846,5568
"1098","ENSG00000159388","ENSG00000159388","BTG2","1",203305491,203309602,4111
"1099","ENSG00000154640","ENSG00000154640","BTG3","21",17593653,17612945,19292
"1100","ENSG00000137707","ENSG00000137707","BTG4","11",111467526,111514367,46841
"1101","ENSG00000010671","ENSG00000010671","BTK","X",101349338,101390796,41458
"1102","ENSG00000124557","ENSG00000124557","BTN1A1","6",26500303,26510425,10122
"1103","ENSG00000112763","ENSG00000112763","BTN2A1","6",26457904,26476621,18717
"1104","ENSG00000124508","ENSG00000124508","BTN2A2","6",26383096,26394874,11778
"1105","ENSG00000026950","ENSG00000026950","BTN3A1","6",26402237,26415208,12971
"1106","ENSG00000186470","ENSG00000186470","BTN3A2","6",26365159,26378320,13161
"1107","ENSG00000111801","ENSG00000111801","BTN3A3","6",26440472,26453415,12943
"1108","ENSG00000275798","ENSG00000275798","BTNL2","HSCHR6_8_CTG1",46833,59248,12415
"1109","ENSG00000168903","ENSG00000168903","BTNL3","5",180988846,181006727,17881
"1110","ENSG00000166167","ENSG00000166167","BTRC","10",101354033,101557321,203288
"1111","ENSG00000169679","ENSG00000169679","BUB1","2",110637528,110678063,40535
"1112","ENSG00000156970","ENSG00000156970","BUB1B","15",40161023,40221123,60100
"1113","ENSG00000154473","ENSG00000154473","BUB3","10",123154402,123170467,16065
"1114","ENSG00000106245","ENSG00000106245","BUD31","7",99408641,99419616,10975
"1115","ENSG00000112578","ENSG00000112578","BYSL","6",41921499,41933046,11547
"1116","ENSG00000082153","ENSG00000082153","BZW1","2",200810594,200827338,16744
"1117","ENSG00000136261","ENSG00000136261","BZW2","7",16646131,16706523,60392
"1118","ENSG00000197223","ENSG00000197223","C1D","2",68041130,68110948,69818
"1119","ENSG00000106392","ENSG00000106392","C1GALT1","7",7156934,7248616,91682
"1120","ENSG00000171155","ENSG00000171155","C1GALT1C1","X",120625674,120630054,4380
"1121","ENSG00000173372","ENSG00000173372","C1QA","1",22635077,22639678,4601
"1122","ENSG00000173369","ENSG00000173369","C1QB","1",22652762,22661637,8875
"1123","ENSG00000131094","ENSG00000131094","C1QL1","17",44959693,44968303,8610
"1124","ENSG00000173918","ENSG00000173918","C1QTNF1","17",79022814,79049788,26974
"1125","ENSG00000082196","ENSG00000082196","C1QTNF3","5",34017858,34043213,25355
"1126","ENSG00000159403","ENSG00000159403","C1R","12",7080214,7092540,12326
"1127","ENSG00000139178","ENSG00000139178","C1RL","12",7089587,7109238,19651
"1128","ENSG00000182326","ENSG00000182326","C1S","12",6988259,7071032,82773
"1129","ENSG00000235696","ENSG00000235696","C2","HSCHR6_MHC_SSTO_CTG1",3221179,3246863,25684
"1130","ENSG00000157617","ENSG00000157617","C2CD2","21",41885112,41954018,68906
"1131","ENSG00000172375","ENSG00000172375","C2CD2L","11",119102198,119118544,16346
"1132","ENSG00000168014","ENSG00000168014","C2CD3","11",74012718,74171210,158492
"1133","ENSG00000111731","ENSG00000111731","C2CD5","12",22448583,22544546,95963
"1134","ENSG00000125730","ENSG00000125730","C3","19",6677704,6730562,52858
"1135","ENSG00000171860","ENSG00000171860","C3AR1","12",8056844,8066359,9515
"1136","ENSG00000244731","ENSG00000244731","C4A","6",31982057,32002681,20624
"1137","ENSG00000123838","ENSG00000123838","C4BPA","1",207104233,207144972,40739
"1138","ENSG00000123843","ENSG00000123843","C4BPB","1",207088860,207099993,11133
"1139","ENSG00000106804","ENSG00000106804","C5","9",120932987,121075195,142208
"1140","ENSG00000197405","ENSG00000197405","C5AR1","19",47290023,47322066,32043
"1141","ENSG00000039537","ENSG00000039537","C6","5",41142116,41261438,119322
"1142","ENSG00000112936","ENSG00000112936","C7","5",40909492,41020216,110724
"1143","ENSG00000157131","ENSG00000157131","C8A","1",56854768,56918223,63455
"1144","ENSG00000021852","ENSG00000021852","C8B","1",56929207,56974383,45176
"1145","ENSG00000176919","ENSG00000176919","C8G","9",136945185,136946975,1790
"1146","ENSG00000113600","ENSG00000113600","C9","5",39284140,39371324,87184
"1147","ENSG00000133742","ENSG00000133742","CA1","8",85327608,85379014,51406
"1148","ENSG00000063180","ENSG00000063180","CA11","19",48637946,48646187,8241
"1149","ENSG00000074410","ENSG00000074410","CA12","15",63321378,63381846,60468
"1150","ENSG00000118298","ENSG00000118298","CA14","1",150257251,150265078,7827
"1151","ENSG00000104267","ENSG00000104267","CA2","8",85463968,85481493,17525
"1152","ENSG00000164879","ENSG00000164879","CA3","8",85373436,85449040,75604
"1153","ENSG00000167434","ENSG00000167434","CA4","17",60149942,60170899,20957
"1154","ENSG00000174990","ENSG00000174990","CA5A","16",87881546,87936580,55034
"1155","ENSG00000169239","ENSG00000169239","CA5B","X",15688830,15788411,99581
"1156","ENSG00000131686","ENSG00000131686","CA6","1",8945867,8975092,29225
"1157","ENSG00000168748","ENSG00000168748","CA7","16",66844414,66854153,9739
"1158","ENSG00000178538","ENSG00000178538","CA8","8",60185412,60281400,95988
"1159","ENSG00000107159","ENSG00000107159","CA9","9",35673928,35681159,7231
"1160","ENSG00000120159","ENSG00000120159","CAAP1","9",26840685,26892803,52118
"1161","ENSG00000135932","ENSG00000135932","CAB39","2",230712842,230821075,108233
"1162","ENSG00000102547","ENSG00000102547","CAB39L","13",49308650,49444064,135414
"1163","ENSG00000099991","ENSG00000099991","CABIN1","22",24011192,24178628,167436
"1164","ENSG00000157782","ENSG00000157782","CABP1","12",120640626,120667324,26698
"1165","ENSG00000154040","ENSG00000154040","CABYR","18",24138987,24161600,22613
"1166","ENSG00000280479","ENSG00000280479","CACFD1","HG2030_PATCH",286059,296942,10883
"1167","ENSG00000148408","ENSG00000148408","CACNA1B","9",137877782,138124624,246842
"1168","ENSG00000151067","ENSG00000151067","CACNA1C","12",1970772,2697950,727178
"1169","ENSG00000157388","ENSG00000157388","CACNA1D","3",53328963,53813733,484770
"1170","ENSG00000102001","ENSG00000102001","CACNA1F","X",49205063,49233371,28308
"1171","ENSG00000006283","ENSG00000006283","CACNA1G","17",50560715,50627474,66759
"1172","ENSG00000196557","ENSG00000196557","CACNA1H","16",1153103,1224169,71066
"1173","ENSG00000100346","ENSG00000100346","CACNA1I","22",39570753,39689735,118982
"1174","ENSG00000081248","ENSG00000081248","CACNA1S","1",201039512,201112451,72939
"1175","ENSG00000007402","ENSG00000007402","CACNA2D2","3",50362613,50504244,141631
"1176","ENSG00000157445","ENSG00000157445","CACNA2D3","3",54122552,55074557,952005
"1177","ENSG00000067191","ENSG00000067191","CACNB1","17",39173453,39197702,24249
"1178","ENSG00000165995","ENSG00000165995","CACNB2","10",18140424,18543557,403133
"1179","ENSG00000167535","ENSG00000167535","CACNB3","12",48813794,48828941,15147
"1180","ENSG00000182389","ENSG00000182389","CACNB4","2",151832771,152099167,266396
"1181","ENSG00000108878","ENSG00000108878","CACNG1","17",67044554,67056797,12243
"1182","ENSG00000166862","ENSG00000166862","CACNG2","22",36560857,36703752,142895
"1183","ENSG00000006116","ENSG00000006116","CACNG3","16",24256335,24362412,106077
"1184","ENSG00000075461","ENSG00000075461","CACNG4","17",66964707,67033398,68691
"1185","ENSG00000105298","ENSG00000105298","CACTIN","19",3610645,3626815,16170
"1186","ENSG00000116161","ENSG00000116161","CACYBP","1",174999163,175012027,12864
"1187","ENSG00000084774","ENSG00000084774","CAD","2",27217369,27243943,26574
"1188","ENSG00000182985","ENSG00000182985","CADM1","11",115169218,115504957,335739
"1189","ENSG00000162706","ENSG00000162706","CADM3","1",159171609,159203313,31704
"1190","ENSG00000105767","ENSG00000105767","CADM4","19",43622368,43639850,17482
"1191","ENSG00000163618","ENSG00000163618","CADPS","3",62398346,62875416,477070
"1192","ENSG00000081803","ENSG00000081803","CADPS2","7",122318411,122886759,568348
"1193","ENSG00000104327","ENSG00000104327","CALB1","8",90058608,90095475,36867
"1194","ENSG00000172137","ENSG00000172137","CALB2","16",71358713,71390436,31723
"1195","ENSG00000110680","ENSG00000110680","CALCA","11",14966622,14972354,5732
"1196","ENSG00000175868","ENSG00000175868","CALCB","11",14904997,15082342,177345
"1197","ENSG00000012822","ENSG00000012822","CALCOCO1","12",53708517,53727745,19228
"1198","ENSG00000136436","ENSG00000136436","CALCOCO2","17",48831018,48866522,35504
"1199","ENSG00000004948","ENSG00000004948","CALCR","7",93424486,93574730,150244
"1200","ENSG00000064989","ENSG00000064989","CALCRL","2",187341964,187448460,106496
"1201","ENSG00000122786","ENSG00000122786","CALD1","7",134744252,134970729,226477
"1202","ENSG00000138172","ENSG00000138172","CALHM2","10",103446786,103452402,5616
"1203","ENSG00000143933","ENSG00000143933","CALM2","2",47160084,47176921,16837
"1204","ENSG00000160014","ENSG00000160014","CALM3","19",46601074,46610782,9708
"1205","ENSG00000178363","ENSG00000178363","CALML3","10",5524961,5526771,1810
"1206","ENSG00000129007","ENSG00000129007","CALML4","15",68190705,68206079,15374
"1207","ENSG00000178372","ENSG00000178372","CALML5","10",5498697,5499570,873
"1208","ENSG00000179218","ENSG00000179218","CALR","19",12938578,12944489,5911
"1209","ENSG00000128595","ENSG00000128595","CALU","7",128739292,128773400,34108
"1210","ENSG00000130643","ENSG00000130643","CALY","10",133324072,133336935,12863
"1211","ENSG00000134072","ENSG00000134072","CAMK1","3",9757347,9769992,12645
"1212","ENSG00000183049","ENSG00000183049","CAMK1D","10",12349547,12835545,485998
"1213","ENSG00000008118","ENSG00000008118","CAMK1G","1",209583714,209613939,30225
"1214","ENSG00000070808","ENSG00000070808","CAMK2A","5",150219491,150290093,70602
"1215","ENSG00000058404","ENSG00000058404","CAMK2B","7",44210019,44334577,124558
"1216","ENSG00000148660","ENSG00000148660","CAMK2G","10",73812501,73874591,62090
"1217","ENSG00000162545","ENSG00000162545","CAMK2N1","1",20482391,20486210,3819
"1218","ENSG00000152495","ENSG00000152495","CAMK4","5",111223653,111494886,271233
"1219","ENSG00000110931","ENSG00000110931","CAMKK2","12",121237675,121298308,60633
"1220","ENSG00000143919","ENSG00000143919","CAMKMT","2",44361947,44772592,410645
"1221","ENSG00000164076","ENSG00000164076","CAMKV","3",49857988,49869935,11947
"1222","ENSG00000164615","ENSG00000164615","CAMLG","5",134738495,134752157,13662
"1223","ENSG00000164047","ENSG00000164047","CAMP","3",48223347,48225491,2144
"1224","ENSG00000130559","ENSG00000130559","CAMSAP1","9",135808487,135907546,99059
"1225","ENSG00000118200","ENSG00000118200","CAMSAP2","1",200738893,200860704,121811
"1226","ENSG00000171735","ENSG00000171735","CAMTA1","1",6785454,7769706,984252
"1227","ENSG00000108509","ENSG00000108509","CAMTA2","17",4967992,4987675,19683
"1228","ENSG00000111530","ENSG00000111530","CAND1","12",67269358,67319953,50595
"1229","ENSG00000144712","ENSG00000144712","CAND2","3",12796472,12834804,38332
"1230","ENSG00000171302","ENSG00000171302","CANT1","17",78991716,79009867,18151
"1231","ENSG00000127022","ENSG00000127022","CANX","5",179678628,179731641,53013
"1232","ENSG00000131236","ENSG00000131236","CAP1","1",40040233,40072649,32416
"1233","ENSG00000112186","ENSG00000112186","CAP2","6",17393595,17557780,164185
"1234","ENSG00000042493","ENSG00000042493","CAPG","2",85394753,85418432,23679
"1235","ENSG00000014216","ENSG00000014216","CAPN1","11",65180566,65212006,31440
"1236","ENSG00000142330","ENSG00000142330","CAPN10","2",240586734,240617705,30971
"1237","ENSG00000103326","ENSG00000103326","CAPN15","16",527712,554636,26924
"1238","ENSG00000162909","ENSG00000162909","CAPN2","1",223701593,223776018,74425
"1239","ENSG00000092529","ENSG00000092529","CAPN3","15",42359498,42412949,53451
"1240","ENSG00000149260","ENSG00000149260","CAPN5","11",77066961,77126155,59194
"1241","ENSG00000077274","ENSG00000077274","CAPN6","X",111245099,111270483,25384
"1242","ENSG00000131375","ENSG00000131375","CAPN7","3",15206152,15252916,46764
"1243","ENSG00000135773","ENSG00000135773","CAPN9","1",230747384,230802003,54619
"1244","ENSG00000126247","ENSG00000126247","CAPNS1","19",36139953,36150353,10400
"1245","ENSG00000135387","ENSG00000135387","CAPRIN1","11",34051731,34102610,50879
"1246","ENSG00000110888","ENSG00000110888","CAPRIN2","12",30709552,30823302,113750
"1247","ENSG00000116489","ENSG00000116489","CAPZA1","1",112619805,112671616,51811
"1248","ENSG00000198898","ENSG00000198898","CAPZA2","7",116811070,116922049,110979
"1249","ENSG00000077549","ENSG00000077549","CAPZB","1",19338775,19485539,146764
"1250","ENSG00000100065","ENSG00000100065","CARD10","22",37490362,37519542,29180
"1251","ENSG00000105483","ENSG00000105483","CARD8","19",48180770,48255946,75176
"1252","ENSG00000187796","ENSG00000187796","CARD9","9",136363956,136373681,9725
"1253","ENSG00000138380","ENSG00000138380","CARF","2",202912214,202988263,76049
"1254","ENSG00000153048","ENSG00000153048","CARHSP1","16",8852942,8869012,16070
"1255","ENSG00000142453","ENSG00000142453","CARM1","19",10871553,10923075,51522
"1256","ENSG00000134905","ENSG00000134905","CARS2","13",110641412,110713603,72191
"1257","ENSG00000164326","ENSG00000164326","CARTPT","5",71719275,71721048,1773
"1258","ENSG00000108349","ENSG00000108349","CASC3","17",40140318,40172171,31853
"1259","ENSG00000127995","ENSG00000127995","CASD1","7",94509219,94557019,47800
"1260","ENSG00000147044","ENSG00000147044","CASK","X",41514934,41923554,408620
"1261","ENSG00000137752","ENSG00000137752","CASP1","11",105025397,105035250,9853
"1262","ENSG00000003400","ENSG00000003400","CASP10","2",201182872,201229428,46556
"1263","ENSG00000106144","ENSG00000106144","CASP2","7",143288215,143307696,19481
"1264","ENSG00000164305","ENSG00000164305","CASP3","4",184627696,184650062,22366
"1265","ENSG00000196954","ENSG00000196954","CASP4","11",104942866,104969366,26500
"1266","ENSG00000137757","ENSG00000137757","CASP5","11",104994235,105023168,28933
"1267","ENSG00000138794","ENSG00000138794","CASP6","4",109688622,109703583,14961
"1268","ENSG00000165806","ENSG00000165806","CASP7","10",113679162,113730907,51745
"1269","ENSG00000064012","ENSG00000064012","CASP8","2",201233443,201361836,128393
"1270","ENSG00000118412","ENSG00000118412","CASP8AP2","6",89829894,89874436,44542
"1271","ENSG00000132906","ENSG00000132906","CASP9","1",15490832,15526534,35702
"1272","ENSG00000143318","ENSG00000143318","CASQ1","1",160190575,160201886,11311
"1273","ENSG00000118729","ENSG00000118729","CASQ2","1",115698038,115793195,95157
"1274","ENSG00000036828","ENSG00000036828","CASR","3",122183668,122291629,107961
"1275","ENSG00000087589","ENSG00000087589","CASS4","20",56412112,56460387,48275
"1276","ENSG00000153113","ENSG00000153113","CAST","5",96525267,96779595,254328
"1277","ENSG00000130940","ENSG00000130940","CASZ1","1",10636604,10796650,160046
"1278","ENSG00000121691","ENSG00000121691","CAT","11",34438934,34472060,33126
"1279","ENSG00000274338","ENSG00000274338","CATSPERB","HSCHR14_1_CTG1",44832,248502,203670
"1280","ENSG00000099338","ENSG00000099338","CATSPERG","19",38335775,38370943,35168
"1281","ENSG00000105974","ENSG00000105974","CAV1","7",116524994,116561179,36185
"1282","ENSG00000105971","ENSG00000105971","CAV2","7",116287380,116508541,221161
"1283","ENSG00000182533","ENSG00000182533","CAV3","3",8733802,8841808,108006
"1284","ENSG00000078699","ENSG00000078699","CBFA2T2","20",33490075,33650036,159961
"1285","ENSG00000129993","ENSG00000129993","CBFA2T3","16",88874858,88977207,102349
"1286","ENSG00000067955","ENSG00000067955","CBFB","16",67028984,67101058,72074
"1287","ENSG00000110395","ENSG00000110395","CBL","11",119206298,119313926,107628
"1288","ENSG00000114423","ENSG00000114423","CBLB","3",105655461,105869552,214091
"1289","ENSG00000142273","ENSG00000142273","CBLC","19",44777869,44800652,22783
"1290","ENSG00000105879","ENSG00000105879","CBLL1","7",107743073,107761667,18594
"1291","ENSG00000102924","ENSG00000102924","CBLN1","16",49277917,49281838,3921
"1292","ENSG00000159228","ENSG00000159228","CBR1","21",36069941,36073166,3225
"1293","ENSG00000159231","ENSG00000159231","CBR3","21",36135079,36146562,11483
"1294","ENSG00000145439","ENSG00000145439","CBR4","4",168863770,169010275,146505
"1295","ENSG00000160200","ENSG00000160200","CBS","21",43053191,43076943,23752
"1296","ENSG00000108468","ENSG00000108468","CBX1","17",48070052,48101478,31426
"1297","ENSG00000173894","ENSG00000173894","CBX2","17",79778148,79787983,9835
"1298","ENSG00000122565","ENSG00000122565","CBX3","7",26201162,26213607,12445
"1299","ENSG00000141582","ENSG00000141582","CBX4","17",79833156,79839440,6284
"1300","ENSG00000094916","ENSG00000094916","CBX5","12",54230942,54280133,49191
"1301","ENSG00000100307","ENSG00000100307","CBX7","22",39120167,39152680,32513
"1302","ENSG00000141570","ENSG00000141570","CBX8","17",79792132,79801683,9551
"1303","ENSG00000100211","ENSG00000100211","CBY1","22",38656636,38673854,17218
"1304","ENSG00000132024","ENSG00000132024","CC2D1A","19",13906201,13930879,24678
"1305","ENSG00000158941","ENSG00000158941","CCAR2","8",22604757,22620964,16207
"1306","ENSG00000150636","ENSG00000150636","CCDC102B","18",68715209,69055189,339980
"1307","ENSG00000173581","ENSG00000173581","CCDC106","19",55641062,55653161,12099
"1308","ENSG00000176714","ENSG00000176714","CCDC121","2",27625638,27629012,3374
"1309","ENSG00000100147","ENSG00000100147","CCDC134","22",41800679,41832164,31485
"1310","ENSG00000149548","ENSG00000149548","CCDC15","11",124954121,125041489,87368
"1311","ENSG00000120262","ENSG00000120262","CCDC170","6",151494017,151621193,127176
"1312","ENSG00000267909","ENSG00000267909","CCDC177","14",69569799,69574871,5072
"1313","ENSG00000117477","ENSG00000117477","CCDC181","1",169394870,169460669,65799
"1314","ENSG00000165813","ENSG00000165813","CCDC186","10",114120862,114174232,53370
"1315","ENSG00000101997","ENSG00000101997","CCDC22","X",49235470,49250520,15050
"1316","ENSG00000147419","ENSG00000147419","CCDC25","8",27733316,27772653,39337
"1317","ENSG00000024862","ENSG00000024862","CCDC28A","6",138773769,138793319,19550
"1318","ENSG00000160050","ENSG00000160050","CCDC28B","1",32200595,32205453,4858
"1319","ENSG00000140481","ENSG00000140481","CCDC33","15",74202705,74336472,133767
"1320","ENSG00000108588","ENSG00000108588","CCDC47","17",63745255,63776351,31096
"1321","ENSG00000164051","ENSG00000164051","CCDC51","3",48432164,48440456,8292
"1322","ENSG00000176155","ENSG00000176155","CCDC57","17",82101460,82212878,111418
"1323","ENSG00000133773","ENSG00000133773","CCDC59","12",82223681,82358805,135124
"1324","ENSG00000108091","ENSG00000108091","CCDC6","10",59788747,59906556,117809
"1325","ENSG00000166510","ENSG00000166510","CCDC68","18",54901509,54959461,57952
"1326","ENSG00000198624","ENSG00000198624","CCDC69","5",151181052,151224093,43041
"1327","ENSG00000216937","ENSG00000216937","CCDC7","10",32446140,32882874,436734
"1328","ENSG00000177352","ENSG00000177352","CCDC71","3",49162535,49166331,3796
"1329","ENSG00000149201","ENSG00000149201","CCDC81","11",86374736,86423109,48373
"1330","ENSG00000149231","ENSG00000149231","CCDC82","11",96349241,96389956,40715
"1331","ENSG00000175602","ENSG00000175602","CCDC85B","11",65890673,65891635,962
"1332","ENSG00000205476","ENSG00000205476","CCDC85C","14",99500190,99604207,104017
"1333","ENSG00000110104","ENSG00000110104","CCDC86","11",60842113,60851081,8968
"1334","ENSG00000182791","ENSG00000182791","CCDC87","11",66590176,66593063,2887
"1335","ENSG00000115355","ENSG00000115355","CCDC88A","2",55287842,55419895,132053
"1336","ENSG00000015133","ENSG00000015133","CCDC88C","14",91271323,91417844,146521
"1337","ENSG00000105321","ENSG00000105321","CCDC9","19",47255980,47273701,17721
"1338","ENSG00000137500","ENSG00000137500","CCDC90B","11",83259081,83286390,27309
"1339","ENSG00000123106","ENSG00000123106","CCDC91","12",28133249,28581511,448262
"1340","ENSG00000275035","ENSG00000275035","CCDC92","HSCHR12_6_CTG2_1",92215,119498,27283
"1341","ENSG00000125633","ENSG00000125633","CCDC93","2",117915478,118014133,98655
"1342","ENSG00000234114","ENSG00000234114","CCHCR1","HSCHR6_MHC_COX_CTG1",2624870,2640641,15771
"1343","ENSG00000185972","ENSG00000185972","CCIN","9",36169388,36171334,1946
"1344","ENSG00000187094","ENSG00000187094","CCK","3",42257825,42266185,8360
"1345","ENSG00000110148","ENSG00000110148","CCKBR","11",6259806,6272127,12321
"1346","ENSG00000108702","ENSG00000108702","CCL1","17",34360328,34363233,2905
"1347","ENSG00000172156","ENSG00000172156","CCL11","17",34285742,34288334,2592
"1348","ENSG00000181374","ENSG00000181374","CCL13","17",34356480,34358610,2130
"1349","ENSG00000277236","ENSG00000277236","CCL14","HSCHR17_7_CTG4",217855,221568,3713
"1350","ENSG00000275718","ENSG00000275718","CCL15","17",35996440,36001553,5113
"1351","ENSG00000275152","ENSG00000275152","CCL16","17",35976493,35981497,5004
"1352","ENSG00000102970","ENSG00000102970","CCL17","16",57404767,57416063,11296
"1353","ENSG00000278167","ENSG00000278167","CCL18","HSCHR17_7_CTG4",299168,306920,7752
"1354","ENSG00000172724","ENSG00000172724","CCL19","9",34689570,34691276,1706
"1355","ENSG00000108691","ENSG00000108691","CCL2","17",34255274,34257208,1934
"1356","ENSG00000115009","ENSG00000115009","CCL20","2",227805739,227817564,11825
"1357","ENSG00000137077","ENSG00000137077","CCL21","9",34709005,34710136,1131
"1358","ENSG00000102962","ENSG00000102962","CCL22","16",57358783,57366189,7406
"1359","ENSG00000276114","ENSG00000276114","CCL23","HSCHR17_7_CTG4",247624,252533,4909
"1360","ENSG00000106178","ENSG00000106178","CCL24","7",75810825,75823356,12531
"1361","ENSG00000131142","ENSG00000131142","CCL25","19",8052318,8062660,10342
"1362","ENSG00000213927","ENSG00000213927","CCL27","9",34661880,34664048,2168
"1363","ENSG00000278567","ENSG00000278567","CCL3","HSCHR17_10_CTG4",42353,44266,1913
"1364","ENSG00000277768","ENSG00000277768","CCL3L3","HSCHR17_10_CTG4",250577,252466,1889
"1365","ENSG00000277943","ENSG00000277943","CCL4","HSCHR17_10_CTG4",57924,59718,1794
"1366","ENSG00000274233","ENSG00000274233","CCL5","HSCHR17_7_CTG4",106023,115325,9302
"1367","ENSG00000108688","ENSG00000108688","CCL7","17",34270221,34272242,2021
"1368","ENSG00000108700","ENSG00000108700","CCL8","17",34319435,34321402,1967
"1369","ENSG00000133101","ENSG00000133101","CCNA1","13",36431520,36442870,11350
"1370","ENSG00000145386","ENSG00000145386","CCNA2","4",121816444,121823883,7439
"1371","ENSG00000134057","ENSG00000134057","CCNB1","5",69167135,69178245,11110
"1372","ENSG00000100814","ENSG00000100814","CCNB1IP1","14",20311368,20333312,21944
"1373","ENSG00000157456","ENSG00000157456","CCNB2","15",59105126,59125045,19919
"1374","ENSG00000112237","ENSG00000112237","CCNC","6",99542387,99568825,26438
"1375","ENSG00000118971","ENSG00000118971","CCND2","12",4269771,4305353,35582
"1376","ENSG00000112576","ENSG00000112576","CCND3","6",41934934,42050357,115423
"1377","ENSG00000105173","ENSG00000105173","CCNE1","19",29811991,29824312,12321
"1378","ENSG00000175305","ENSG00000175305","CCNE2","8",94879770,94896678,16908
"1379","ENSG00000162063","ENSG00000162063","CCNF","16",2429394,2458854,29460
"1380","ENSG00000113328","ENSG00000113328","CCNG1","5",163437569,163446151,8582
"1381","ENSG00000138764","ENSG00000138764","CCNG2","4",77157207,77433388,276181
"1382","ENSG00000134480","ENSG00000134480","CCNH","5",87318416,87413029,94613
"1383","ENSG00000118816","ENSG00000118816","CCNI","4",77047155,77076309,29154
"1384","ENSG00000107443","ENSG00000107443","CCNJ","10",96043394,96060870,17476
"1385","ENSG00000135083","ENSG00000135083","CCNJL","5",160249083,160345396,96313
"1386","ENSG00000090061","ENSG00000090061","CCNK","14",99481169,99535044,53875
"1387","ENSG00000163660","ENSG00000163660","CCNL1","3",157146508,157160760,14252
"1388","ENSG00000221978","ENSG00000221978","CCNL2","1",1385711,1399335,13624
"1389","ENSG00000152669","ENSG00000152669","CCNO","5",55231152,55233608,2456
"1390","ENSG00000129315","ENSG00000129315","CCNT1","12",48688458,48716998,28540
"1391","ENSG00000082258","ENSG00000082258","CCNT2","2",134918235,134959342,41107
"1392","ENSG00000103540","ENSG00000103540","CCP110","16",19523811,19553408,29597
"1393","ENSG00000260916","ENSG00000260916","CCPG1","15",55340032,55408510,68478
"1394","ENSG00000163823","ENSG00000163823","CCR1","3",46201711,46208313,6602
"1395","ENSG00000121807","ENSG00000121807","CCR2","3",46353864,46360940,7076
"1396","ENSG00000183813","ENSG00000183813","CCR4","3",32951644,32956349,4705
"1397","ENSG00000160791","ENSG00000160791","CCR5","3",46370946,46376206,5260
"1398","ENSG00000112486","ENSG00000112486","CCR6","6",167111807,167139141,27334
"1399","ENSG00000126353","ENSG00000126353","CCR7","17",40553769,40565472,11703
"1400","ENSG00000173585","ENSG00000173585","CCR9","3",45884425,45903174,18749
"1401","ENSG00000121797","ENSG00000121797","CCRL2","3",46407166,46412997,5831
"1402","ENSG00000173992","ENSG00000173992","CCS","11",66593153,66606019,12866
"1403","ENSG00000107771","ENSG00000107771","CCSER2","10",84328586,84518521,189935
"1404","ENSG00000166226","ENSG00000166226","CCT2","12",69585426,69601570,16144
"1405","ENSG00000163468","ENSG00000163468","CCT3","1",156308968,156367873,58905
"1406","ENSG00000115484","ENSG00000115484","CCT4","2",61868085,61888671,20586
"1407","ENSG00000150753","ENSG00000150753","CCT5","5",10249929,10266389,16460
"1408","ENSG00000146731","ENSG00000146731","CCT6A","7",56051685,56063989,12304
"1409","ENSG00000132141","ENSG00000132141","CCT6B","17",34927859,34981078,53219
"1410","ENSG00000135624","ENSG00000135624","CCT7","2",73233420,73253021,19601
"1411","ENSG00000156261","ENSG00000156261","CCT8","21",29055805,29073797,17992
"1412","ENSG00000122674","ENSG00000122674","CCZ1","7",5898725,5926550,27825
"1413","ENSG00000134256","ENSG00000134256","CD101","1",117001750,117036552,34802
"1414","ENSG00000170458","ENSG00000170458","CD14","5",140631728,140633700,1972
"1415","ENSG00000177697","ENSG00000177697","CD151","11",832887,839831,6944
"1416","ENSG00000117281","ENSG00000117281","CD160","1",145719471,145739288,19817
"1417","ENSG00000177575","ENSG00000177575","CD163","12",7470811,7503893,33082
"1418","ENSG00000135535","ENSG00000135535","CD164","6",109366514,109382467,15953
"1419","ENSG00000204936","ENSG00000204936","CD177","19",43353686,43363172,9486
"1420","ENSG00000134061","ENSG00000134061","CD180","5",67179613,67196799,17186
"1421","ENSG00000177455","ENSG00000177455","CD19","16",28931965,28939342,7377
"1422","ENSG00000158477","ENSG00000158477","CD1A","1",158254424,158258269,3845
"1423","ENSG00000158485","ENSG00000158485","CD1B","1",158327951,158331531,3580
"1424","ENSG00000158481","ENSG00000158481","CD1C","1",158289923,158294774,4851
"1425","ENSG00000158473","ENSG00000158473","CD1D","1",158178030,158186427,8397
"1426","ENSG00000158488","ENSG00000158488","CD1E","1",158353696,158357553,3857
"1427","ENSG00000116824","ENSG00000116824","CD2","1",116754430,116769229,14799
"1428","ENSG00000091972","ENSG00000091972","CD200","3",112332235,112363181,30946
"1429","ENSG00000116031","ENSG00000116031","CD207","2",70830211,70835816,5605
"1430","ENSG00000090659","ENSG00000090659","CD209","19",7739993,7747564,7571
"1431","ENSG00000012124","ENSG00000012124","CD22","19",35319261,35347361,28100
"1432","ENSG00000272398","ENSG00000272398","CD24","6",106969831,106975627,5796
"1433","ENSG00000122223","ENSG00000122223","CD244","1",160830160,160862887,32727
"1434","ENSG00000198821","ENSG00000198821","CD247","1",167425027,167518640,93613
"1435","ENSG00000174807","ENSG00000174807","CD248","11",66314494,66317044,2550
"1436","ENSG00000139193","ENSG00000139193","CD27","12",6444955,6451718,6763
"1437","ENSG00000178562","ENSG00000178562","CD28","2",203706475,203738912,32437
"1438","ENSG00000198087","ENSG00000198087","CD2AP","6",47477789,47627263,149474
"1439","ENSG00000169217","ENSG00000169217","CD2BP2","16",30350773,30355308,4535
"1440","ENSG00000167851","ENSG00000167851","CD300A","17",74466399,74484794,18395
"1441","ENSG00000167850","ENSG00000167850","CD300C","17",74541073,74546115,5042
"1442","ENSG00000241399","ENSG00000241399","CD302","2",159768628,159798255,29627
"1443","ENSG00000167775","ENSG00000167775","CD320","19",8302127,8308358,6231
"1444","ENSG00000105383","ENSG00000105383","CD33","19",51225064,51243860,18796
"1445","ENSG00000174059","ENSG00000174059","CD34","1",207880972,207911402,30430
"1446","ENSG00000135218","ENSG00000135218","CD36","7",80369575,80679277,309702
"1447","ENSG00000104894","ENSG00000104894","CD37","19",49335171,49343335,8164
"1448","ENSG00000004468","ENSG00000004468","CD38","4",15778275,15853232,74957
"1449","ENSG00000167286","ENSG00000167286","CD3D","11",118339075,118342705,3630
"1450","ENSG00000198851","ENSG00000198851","CD3E","11",118304730,118316175,11445
"1451","ENSG00000160654","ENSG00000160654","CD3G","11",118344344,118355161,10817
"1452","ENSG00000010610","ENSG00000010610","CD4","12",6786858,6820799,33941
"1453","ENSG00000101017","ENSG00000101017","CD40","20",46118271,46129863,11592
"1454","ENSG00000102245","ENSG00000102245","CD40LG","X",136648158,136660390,12232
"1455","ENSG00000026508","ENSG00000026508","CD44","11",35138882,35232402,93520
"1456","ENSG00000117335","ENSG00000117335","CD46","1",207752037,207795513,43476
"1457","ENSG00000196776","ENSG00000196776","CD47","3",108043091,108091862,48771
"1458","ENSG00000117091","ENSG00000117091","CD48","1",160678746,160711831,33085
"1459","ENSG00000110448","ENSG00000110448","CD5","11",61102489,61127852,25363
"1460","ENSG00000169442","ENSG00000169442","CD52","1",26317958,26320523,2565
"1461","ENSG00000143119","ENSG00000143119","CD53","1",110871188,110899922,28734
"1462","ENSG00000196352","ENSG00000196352","CD55","1",207321519,207386804,65285
"1463","ENSG00000116815","ENSG00000116815","CD58","1",116514534,116571039,56505
"1464","ENSG00000085063","ENSG00000085063","CD59","11",33703010,33736479,33469
"1465","ENSG00000073754","ENSG00000073754","CD5L","1",157830911,157898256,67345
"1466","ENSG00000013725","ENSG00000013725","CD6","11",60971680,61020377,48697
"1467","ENSG00000135404","ENSG00000135404","CD63","12",55725323,55729707,4384
"1468","ENSG00000129226","ENSG00000129226","CD68","17",7579491,7582111,2620
"1469","ENSG00000110848","ENSG00000110848","CD69","12",9752486,9760901,8415
"1470","ENSG00000173762","ENSG00000173762","CD7","17",82314868,82317608,2740
"1471","ENSG00000125726","ENSG00000125726","CD70","19",6583183,6604103,20920
"1472","ENSG00000137101","ENSG00000137101","CD72","9",35609982,35646810,36828
"1473","ENSG00000019582","ENSG00000019582","CD74","5",150401637,150412969,11332
"1474","ENSG00000105369","ENSG00000105369","CD79A","19",41877279,41881372,4093
"1475","ENSG00000007312","ENSG00000007312","CD79B","17",63928738,63932336,3598
"1476","ENSG00000121594","ENSG00000121594","CD80","3",119524293,119559614,35321
"1477","ENSG00000110651","ENSG00000110651","CD81","11",2376177,2397802,21625
"1478","ENSG00000085117","ENSG00000085117","CD82","11",44564427,44620358,55931
"1479","ENSG00000112149","ENSG00000112149","CD83","6",14117256,14136918,19662
"1480","ENSG00000066294","ENSG00000066294","CD84","1",160541095,160579516,38421
"1481","ENSG00000114013","ENSG00000114013","CD86","3",122055362,122121139,65777
"1482","ENSG00000153563","ENSG00000153563","CD8A","2",86784610,86808396,23786
"1483","ENSG00000172116","ENSG00000172116","CD8B","2",86815339,86861924,46585
"1484","ENSG00000010278","ENSG00000010278","CD9","12",6199715,6238271,38556
"1485","ENSG00000125810","ENSG00000125810","CD93","20",23079360,23086324,6964
"1486","ENSG00000153283","ENSG00000153283","CD96","3",111292719,111665750,373031
"1487","ENSG00000002586","ENSG00000002586","CD99","X",2691187,2741309,50122
"1488","ENSG00000158825","ENSG00000158825","CDA","1",20589086,20618903,29817
"1489","ENSG00000102543","ENSG00000102543","CDADC1","13",49247925,49293485,45560
"1490","ENSG00000151465","ENSG00000151465","CDC123","10",12195965,12250589,54624
"1491","ENSG00000079335","ENSG00000079335","CDC14A","1",100345001,100520277,175276
"1492","ENSG00000081377","ENSG00000081377","CDC14B","9",96490241,96619843,129602
"1493","ENSG00000130177","ENSG00000130177","CDC16","13",114234887,114272723,37836
"1494","ENSG00000117399","ENSG00000117399","CDC20","1",43358981,43363203,4222
"1495","ENSG00000094880","ENSG00000094880","CDC23","5",138187650,138213343,25693
"1496","ENSG00000164045","ENSG00000164045","CDC25A","3",48157146,48188417,31271
"1497","ENSG00000101224","ENSG00000101224","CDC25B","20",3786772,3806121,19349
"1498","ENSG00000158402","ENSG00000158402","CDC25C","5",138285269,138338355,53086
"1499","ENSG00000004897","ENSG00000004897","CDC27","17",47117703,47189422,71719
"1500","ENSG00000099804","ENSG00000099804","CDC34","19",531760,542092,10332
"1501","ENSG00000105401","ENSG00000105401","CDC37","19",10391133,10420121,28988
"1502","ENSG00000106993","ENSG00000106993","CDC37L1","9",4679559,4708399,28840
"1503","ENSG00000168438","ENSG00000168438","CDC40","6",110180141,110254275,74134
"1504","ENSG00000070831","ENSG00000070831","CDC42","1",22052627,22101360,48733
"1505","ENSG00000143776","ENSG00000143776","CDC42BPA","1",226989865,227318492,328627
"1506","ENSG00000198752","ENSG00000198752","CDC42BPB","14",102932380,103057549,125169
"1507","ENSG00000128283","ENSG00000128283","CDC42EP1","22",37560480,37569405,8925
"1508","ENSG00000149798","ENSG00000149798","CDC42EP2","11",65314866,65322417,7551
"1509","ENSG00000163171","ENSG00000163171","CDC42EP3","2",37641882,37738468,96586
"1510","ENSG00000179604","ENSG00000179604","CDC42EP4","17",73283624,73312005,28381
"1511","ENSG00000197622","ENSG00000197622","CDC42SE1","1",151050971,151070325,19354
"1512","ENSG00000093009","ENSG00000093009","CDC45","22",19479457,19520612,41155
"1513","ENSG00000096401","ENSG00000096401","CDC5L","6",44387706,44450425,62719
"1514","ENSG00000094804","ENSG00000094804","CDC6","17",40287879,40304657,16778
"1515","ENSG00000097046","ENSG00000097046","CDC7","1",91500851,91525764,24913
"1516","ENSG00000134371","ENSG00000134371","CDC73","1",193121983,193254815,132832
"1517","ENSG00000111665","ENSG00000111665","CDCA3","12",6844793,6851292,6499
"1518","ENSG00000170779","ENSG00000170779","CDCA4","14",105009573,105021083,11510
"1519","ENSG00000134690","ENSG00000134690","CDCA8","1",37692481,37709719,17238
"1520","ENSG00000163814","ENSG00000163814","CDCP1","3",45082277,45146422,64145
"1521","ENSG00000039068","ENSG00000039068","CDH1","16",68737292,68835537,98245
"1522","ENSG00000040731","ENSG00000040731","CDH10","5",24487100,24644978,157878
"1523","ENSG00000140937","ENSG00000140937","CDH11","16",64943753,65126112,182359
"1524","ENSG00000154162","ENSG00000154162","CDH12","5",21750673,22853344,1102671
"1525","ENSG00000140945","ENSG00000140945","CDH13","16",82626965,83800640,1173675
"1526","ENSG00000129910","ENSG00000129910","CDH15","16",89171748,89195492,23744
"1527","ENSG00000166589","ENSG00000166589","CDH16","16",66908122,66918917,10795
"1528","ENSG00000079112","ENSG00000079112","CDH17","8",94127162,94217303,90141
"1529","ENSG00000145526","ENSG00000145526","CDH18","5",19471296,20575873,1104577
"1530","ENSG00000071991","ENSG00000071991","CDH19","18",66501083,66604138,103055
"1531","ENSG00000170558","ENSG00000170558","CDH2","18",27932879,28177946,245067
"1532","ENSG00000062038","ENSG00000062038","CDH3","16",68636189,68727468,91279
"1533","ENSG00000280641","ENSG00000280641","CDH4","HSCHR20_1_CTG2",8605,54269,45664
"1534","ENSG00000179776","ENSG00000179776","CDH5","16",66366690,66404784,38094
"1535","ENSG00000113361","ENSG00000113361","CDH6","5",31193686,31329146,135460
"1536","ENSG00000081138","ENSG00000081138","CDH7","18",65750252,65890337,140085
"1537","ENSG00000150394","ENSG00000150394","CDH8","16",61647242,62037035,389793
"1538","ENSG00000113100","ENSG00000113100","CDH9","5",26880597,27121150,240553
"1539","ENSG00000074276","ENSG00000074276","CDHR2","5",176542511,176595974,53463
"1540","ENSG00000273572","ENSG00000273572","CDHR5","HSCHR11_1_CTG8",146464,155977,9513
"1541","ENSG00000274336","ENSG00000274336","CDIP1","HSCHR16_3_CTG1",212998,226625,13627
"1542","ENSG00000103502","ENSG00000103502","CDIPT","16",29858357,29863414,5057
"1543","ENSG00000170312","ENSG00000170312","CDK1","10",60778331,60794852,16521
"1544","ENSG00000185324","ENSG00000185324","CDK10","16",89680737,89696354,15617
"1545","ENSG00000008128","ENSG00000008128","CDK11A","1",1702379,1724357,21978
"1546","ENSG00000248333","ENSG00000248333","CDK11B","1",1635225,1659012,23787
"1547","ENSG00000167258","ENSG00000167258","CDK12","17",39461486,39567559,106073
"1548","ENSG00000065883","ENSG00000065883","CDK13","7",39950121,40099580,149459
"1549","ENSG00000058091","ENSG00000058091","CDK14","7",90466424,91210590,744166
"1550","ENSG00000102225","ENSG00000102225","CDK16","X",47217860,47229997,12137
"1551","ENSG00000059758","ENSG00000059758","CDK17","12",96278261,96400480,122219
"1552","ENSG00000117266","ENSG00000117266","CDK18","1",205504596,205532793,28197
"1553","ENSG00000155111","ENSG00000155111","CDK19","6",110609978,110815958,205980
"1554","ENSG00000123374","ENSG00000123374","CDK2","12",55966781,55972789,6008
"1555","ENSG00000156345","ENSG00000156345","CDK20","9",87966441,87974753,8312
"1556","ENSG00000111328","ENSG00000111328","CDK2AP1","12",123250112,123272334,22222
"1557","ENSG00000135446","ENSG00000135446","CDK4","12",57747727,57756013,8286
"1558","ENSG00000164885","ENSG00000164885","CDK5","7",151053815,151057897,4082
"1559","ENSG00000176749","ENSG00000176749","CDK5R1","17",32486993,32491253,4260
"1560","ENSG00000171450","ENSG00000171450","CDK5R2","2",218959666,218962155,2489
"1561","ENSG00000101391","ENSG00000101391","CDK5RAP1","20",33358839,33401561,42722
"1562","ENSG00000136861","ENSG00000136861","CDK5RAP2","9",120388875,120580170,191295
"1563","ENSG00000108465","ENSG00000108465","CDK5RAP3","17",47967810,47981781,13971
"1564","ENSG00000105810","ENSG00000105810","CDK6","7",92604921,92836573,231652
"1565","ENSG00000277273","ENSG00000277273","CDK7","HSCHR5_2_CTG1_1",17975,60595,42620
"1566","ENSG00000132964","ENSG00000132964","CDK8","13",26254104,26420982,166878
"1567","ENSG00000136807","ENSG00000136807","CDK9","9",127785679,127790792,5113
"1568","ENSG00000145996","ENSG00000145996","CDKAL1","6",20534457,21232404,697947
"1569","ENSG00000100490","ENSG00000100490","CDKL1","14",50326265,50416461,90196
"1570","ENSG00000138769","ENSG00000138769","CDKL2","4",75576496,75630716,54220
"1571","ENSG00000006837","ENSG00000006837","CDKL3","5",134286350,134371047,84697
"1572","ENSG00000008086","ENSG00000008086","CDKL5","X",18425583,18653629,228046
"1573","ENSG00000124762","ENSG00000124762","CDKN1A","6",36676460,36687337,10877
"1574","ENSG00000111276","ENSG00000111276","CDKN1B","12",12685498,12722369,36871
"1575","ENSG00000273707","ENSG00000273707","CDKN1C","HSCHR11_1_CTG7",115392,118091,2699
"1576","ENSG00000147889","ENSG00000147889","CDKN2A","9",21967752,21995301,27549
"1577","ENSG00000168564","ENSG00000168564","CDKN2AIP","4",183444635,183449064,4429
"1578","ENSG00000147883","ENSG00000147883","CDKN2B","9",22002903,22009305,6402
"1579","ENSG00000123080","ENSG00000123080","CDKN2C","1",50960745,50974634,13889
"1580","ENSG00000129355","ENSG00000129355","CDKN2D","19",10566460,10569059,2599
"1581","ENSG00000100526","ENSG00000100526","CDKN3","14",54396849,54420218,23369
"1582","ENSG00000129596","ENSG00000129596","CDO1","5",115804733,115816659,11926
"1583","ENSG00000064309","ENSG00000064309","CDON","11",125955796,126063335,107539
"1584","ENSG00000140743","ENSG00000140743","CDR2","16",22345936,22437165,91229
"1585","ENSG00000109089","ENSG00000109089","CDR2L","17",74987632,75005800,18168
"1586","ENSG00000163624","ENSG00000163624","CDS1","4",84583127,84651334,68207
"1587","ENSG00000101290","ENSG00000101290","CDS2","20",5126879,5197887,71008
"1588","ENSG00000237165","ENSG00000237165","CDSN","HSCHR6_MHC_MCF_CTG1",2459207,2464559,5352
"1589","ENSG00000167513","ENSG00000167513","CDT1","16",88803789,88809258,5469
"1590","ENSG00000091527","ENSG00000091527","CDV3","3",133573686,133590261,16575
"1591","ENSG00000113722","ENSG00000113722","CDX1","5",150166778,150184558,17780
"1592","ENSG00000165556","ENSG00000165556","CDX2","13",27960918,27969315,8397
"1593","ENSG00000153046","ENSG00000153046","CDYL","6",4706159,4955551,249392
"1594","ENSG00000079385","ENSG00000079385","CEACAM1","19",42507304,42561234,53930
"1595","ENSG00000278565","ENSG00000278565","CEACAM21","HSCHR19_3_CTG3_1",95157,132483,37326
"1596","ENSG00000170956","ENSG00000170956","CEACAM3","19",41796587,41811554,14967
"1597","ENSG00000274131","ENSG00000274131","CEACAM4","HSCHR19_3_CTG3_1",54927,63030,8103
"1598","ENSG00000105388","ENSG00000105388","CEACAM5","19",41708585,41730433,21848
"1599","ENSG00000086548","ENSG00000086548","CEACAM6","19",41750977,41772211,21234
"1600","ENSG00000280501","ENSG00000280501","CEACAM7","HSCHR19_3_CTG3_1",4498,8694,4196
"1601","ENSG00000245848","ENSG00000245848","CEBPA","19",33299934,33302534,2600
"1602","ENSG00000172216","ENSG00000172216","CEBPB","20",50190830,50192668,1838
"1603","ENSG00000221869","ENSG00000221869","CEBPD","8",47736913,47738164,1251
"1604","ENSG00000092067","ENSG00000092067","CEBPE","14",23117036,23120256,3220
"1605","ENSG00000153879","ENSG00000153879","CEBPG","19",33373685,33382686,9001
"1606","ENSG00000115816","ENSG00000115816","CEBPZ","2",37201612,37231596,29984
"1607","ENSG00000170835","ENSG00000170835","CEL","9",133061981,133071861,9880
"1608","ENSG00000139610","ENSG00000139610","CELA1","12",51328442,51346679,18237
"1609","ENSG00000142615","ENSG00000142615","CELA2A","1",15456728,15472091,15363
"1610","ENSG00000215704","ENSG00000215704","CELA2B","1",15465909,15491395,25486
"1611","ENSG00000142789","ENSG00000142789","CELA3A","1",22001657,22012542,10885
"1612","ENSG00000219073","ENSG00000219073","CELA3B","1",21977022,21998642,21620
"1613","ENSG00000149187","ENSG00000149187","CELF1","11",47465933,47565569,99636
"1614","ENSG00000048740","ENSG00000048740","CELF2","10",10798397,11336675,538278
"1615","ENSG00000159409","ENSG00000159409","CELF3","1",151700058,151716803,16745
"1616","ENSG00000075275","ENSG00000075275","CELSR1","22",46360834,46537620,176786
"1617","ENSG00000143126","ENSG00000143126","CELSR2","1",109249539,109275751,26212
"1618","ENSG00000008300","ENSG00000008300","CELSR3","3",48636463,48662886,26423
"1619","ENSG00000103888","ENSG00000103888","CEMIP","15",80779343,80951776,172433
"1620","ENSG00000205923","ENSG00000205923","CEMP1","16",2530035,2531417,1382
"1621","ENSG00000184524","ENSG00000184524","CEND1","11",787115,790113,2998
"1622","ENSG00000115163","ENSG00000115163","CENPA","2",26764289,26801067,36778
"1623","ENSG00000125817","ENSG00000125817","CENPB","20",3783851,3786740,2889
"1624","ENSG00000145241","ENSG00000145241","CENPC","4",67468762,67545503,76741
"1625","ENSG00000138778","ENSG00000138778","CENPE","4",103105349,103198445,93096
"1626","ENSG00000117724","ENSG00000117724","CENPF","1",214603185,214664574,61389
"1627","ENSG00000102384","ENSG00000102384","CENPI","X",101098188,101166126,67938
"1628","ENSG00000151849","ENSG00000151849","CENPJ","13",24882279,24922889,40610
"1629","ENSG00000100162","ENSG00000100162","CENPM","22",41938737,41947152,8415
"1630","ENSG00000166451","ENSG00000166451","CENPN","16",81006552,81033114,26562
"1631","ENSG00000138092","ENSG00000138092","CENPO","2",24793136,24822376,29240
"1632","ENSG00000031691","ENSG00000031691","CENPQ","6",49463370,49493107,29737
"1633","ENSG00000102901","ENSG00000102901","CENPT","16",67828157,67847811,19654
"1634","ENSG00000151725","ENSG00000151725","CENPU","4",184694085,184734130,40045
"1635","ENSG00000116198","ENSG00000116198","CEP104","1",3812086,3857396,45310
"1636","ENSG00000174799","ENSG00000174799","CEP135","4",55948871,56033361,84490
"1637","ENSG00000135315","ENSG00000135315","CEP162","6",84124241,84227643,103402
"1638","ENSG00000110274","ENSG00000110274","CEP164","11",117314557,117413266,98709
"1639","ENSG00000276725","ENSG00000276725","CEP170","HSCHR1_3_CTG32_1",136536,267429,130893
"1640","ENSG00000099814","ENSG00000099814","CEP170B","14",104865268,104896747,31479
"1641","ENSG00000101639","ENSG00000101639","CEP192","18",12991362,13125052,133690
"1642","ENSG00000126001","ENSG00000126001","CEP250","20",35455164,35519280,64116
"1643","ENSG00000198707","ENSG00000198707","CEP290","12",88049016,88142099,93083
"1644","ENSG00000135837","ENSG00000135837","CEP350","1",179954674,180114880,160206
"1645","ENSG00000106477","ENSG00000106477","CEP41","7",130393771,130442433,48662
"1646","ENSG00000138180","ENSG00000138180","CEP55","10",93496612,93529092,32480
"1647","ENSG00000166037","ENSG00000166037","CEP57","11",95789965,95832693,42728
"1648","ENSG00000182923","ENSG00000182923","CEP63","3",134485699,134587789,102090
"1649","ENSG00000011523","ENSG00000011523","CEP68","2",65056354,65087004,30650
"1650","ENSG00000114107","ENSG00000114107","CEP70","3",138494344,138594538,100194
"1651","ENSG00000112877","ENSG00000112877","CEP72","5",612340,667168,54828
"1652","ENSG00000101624","ENSG00000101624","CEP76","18",12661833,12702777,40944
"1653","ENSG00000173588","ENSG00000173588","CEP83","12",94306449,94459988,153539
"1654","ENSG00000130695","ENSG00000130695","CEP85","1",26234200,26278808,44608
"1655","ENSG00000182504","ENSG00000182504","CEP97","3",101724534,101770562,46028
"1656","ENSG00000134255","ENSG00000134255","CEPT1","1",111139479,111185104,45625
"1657","ENSG00000100422","ENSG00000100422","CERK","22",46684410,46738252,53842
"1658","ENSG00000223802","ENSG00000223802","CERS1","19",18868545,18896727,28182
"1659","ENSG00000143418","ENSG00000143418","CERS2","1",150960583,150975003,14420
"1660","ENSG00000090661","ENSG00000090661","CERS4","19",8206736,8262421,55685
"1661","ENSG00000172292","ENSG00000172292","CERS6","2",168456249,168775134,318885
"1662","ENSG00000262243","ENSG00000262243","CES1","HSCHR16_1_CTG3_1",26724,57055,30331
"1663","ENSG00000172831","ENSG00000172831","CES2","16",66934444,66945096,10652
"1664","ENSG00000172828","ENSG00000172828","CES3","16",66961245,66975149,13904
"1665","ENSG00000147400","ENSG00000147400","CETN2","X",152826994,152830757,3763
"1666","ENSG00000153140","ENSG00000153140","CETN3","5",90392257,90409766,17509
"1667","ENSG00000087237","ENSG00000087237","CETP","16",56961923,56983845,21922
"1668","ENSG00000070761","ENSG00000070761","CFAP20","16",58113592,58129381,15789
"1669","ENSG00000197748","ENSG00000197748","CFAP43","10",104129888,104232364,102476
"1670","ENSG00000206530","ENSG00000206530","CFAP44","3",113286930,113441610,154680
"1671","ENSG00000213085","ENSG00000213085","CFAP45","1",159872364,159900165,27801
"1672","ENSG00000105792","ENSG00000105792","CFAP69","7",90245174,90311063,65889
"1673","ENSG00000204359","ENSG00000204359","CFB","HSCHR6_MHC_MANN_CTG1",3250627,3255741,5114
"1674","ENSG00000274619","ENSG00000274619","CFD","HSCHR19_5_CTG2",38523,42509,3986
"1675","ENSG00000153774","ENSG00000153774","CFDP1","16",75293698,75433503,139805
"1676","ENSG00000000971","ENSG00000000971","CFH","1",196651754,196752476,100722
"1677","ENSG00000244414","ENSG00000244414","CFHR1","1",196819731,196837159,17428
"1678","ENSG00000134365","ENSG00000134365","CFHR4","1",196888014,196918795,30781
"1679","ENSG00000134389","ENSG00000134389","CFHR5","1",196975010,197009678,34668
"1680","ENSG00000205403","ENSG00000205403","CFI","4",109731008,109802150,71142
"1681","ENSG00000172757","ENSG00000172757","CFL1","11",65823022,65862026,39004
"1682","ENSG00000003402","ENSG00000003402","CFLAR","2",201116154,201176687,60533
"1683","ENSG00000126759","ENSG00000126759","CFP","X",47623172,47630305,7133
"1684","ENSG00000001626","ENSG00000001626","CFTR","7",117287120,117715971,428851
"1685","ENSG00000135346","ENSG00000135346","CGA","6",87085498,87095106,9608
"1686","ENSG00000196337","ENSG00000196337","CGB7","19",49054274,49058860,4586
"1687","ENSG00000163320","ENSG00000163320","CGGBP1","3",88051944,88149885,97941
"1688","ENSG00000138028","ENSG00000138028","CGREF1","2",27098889,27119128,20239
"1689","ENSG00000100532","ENSG00000100532","CGRRF1","14",54509812,54539292,29480
"1690","ENSG00000138135","ENSG00000138135","CH25H","10",89205629,89207317,1688
"1691","ENSG00000128965","ENSG00000128965","CHAC1","15",40952962,40956512,3550
"1692","ENSG00000136457","ENSG00000136457","CHAD","17",50464496,50468906,4410
"1693","ENSG00000167670","ENSG00000167670","CHAF1A","19",4402640,4445018,42378
"1694","ENSG00000159259","ENSG00000159259","CHAF1B","21",36385392,36419015,33623
"1695","ENSG00000070748","ENSG00000070748","CHAT","10",49609095,49667942,58847
"1696","ENSG00000106153","ENSG00000106153","CHCHD2","7",56101573,56106476,4903
"1697","ENSG00000106554","ENSG00000106554","CHCHD3","7",132784870,133082090,297220
"1698","ENSG00000170791","ENSG00000170791","CHCHD7","8",56211686,56218809,7123
"1699","ENSG00000153922","ENSG00000153922","CHD1","5",98853985,98929007,75022
"1700","ENSG00000131778","ENSG00000131778","CHD1L","1",147242654,147295765,53111
"1701","ENSG00000173575","ENSG00000173575","CHD2","15",92886203,93027996,141793
"1702","ENSG00000170004","ENSG00000170004","CHD3","17",7884796,7912760,27964
"1703","ENSG00000111642","ENSG00000111642","CHD4","12",6570082,6614524,44442
"1704","ENSG00000171316","ENSG00000171316","CHD7","8",60678740,60868028,189288
"1705","ENSG00000100888","ENSG00000100888","CHD8","14",21385194,21456126,70932
"1706","ENSG00000177200","ENSG00000177200","CHD9","16",53054991,53329150,274159
"1707","ENSG00000149554","ENSG00000149554","CHEK1","11",125625163,125676255,51092
"1708","ENSG00000183765","ENSG00000183765","CHEK2","22",28687743,28742422,54679
"1709","ENSG00000085872","ENSG00000085872","CHERP","19",16517894,16542437,24543
"1710","ENSG00000072609","ENSG00000072609","CHFR","12",132822187,132956304,134117
"1711","ENSG00000276781","ENSG00000276781","CHGA","HSCHR14_7_CTG1",37642,49855,12213
"1712","ENSG00000089199","ENSG00000089199","CHGB","20",5911510,5925353,13843
"1713","ENSG00000133048","ENSG00000133048","CHI3L1","1",203178931,203186704,7773
"1714","ENSG00000064886","ENSG00000064886","CHI3L2","1",111200771,111243440,42669
"1715","ENSG00000134216","ENSG00000134216","CHIA","1",111290851,111320566,29715
"1716","ENSG00000109220","ENSG00000109220","CHIC2","4",54009789,54064605,54816
"1717","ENSG00000133063","ENSG00000133063","CHIT1","1",203212827,203273641,60814
"1718","ENSG00000110721","ENSG00000110721","CHKA","11",68052859,68121444,68585
"1719","ENSG00000100288","ENSG00000100288","CHKB","22",50578959,50601455,22496
"1720","ENSG00000134121","ENSG00000134121","CHL1","3",196763,409417,212654
"1721","ENSG00000188419","ENSG00000188419","CHM","X",85861180,86047561,186381
"1722","ENSG00000203668","ENSG00000203668","CHML","1",241628851,241640369,11518
"1723","ENSG00000131165","ENSG00000131165","CHMP1A","16",89640816,89657738,16922
"1724","ENSG00000255112","ENSG00000255112","CHMP1B","18",11851413,11854444,3031
"1725","ENSG00000130724","ENSG00000130724","CHMP2A","19",58551452,58555105,3653
"1726","ENSG00000083937","ENSG00000083937","CHMP2B","3",87227271,87255556,28285
"1727","ENSG00000115561","ENSG00000115561","CHMP3","2",86503430,86563479,60049
"1728","ENSG00000254505","ENSG00000254505","CHMP4A","14",24209615,24213830,4215
"1729","ENSG00000086065","ENSG00000086065","CHMP5","9",33264879,33282070,17191
"1730","ENSG00000176108","ENSG00000176108","CHMP6","17",80991598,81009517,17919
"1731","ENSG00000147457","ENSG00000147457","CHMP7","8",23243637,23262000,18363
"1732","ENSG00000128656","ENSG00000128656","CHN1","2",174798809,175005381,206572
"1733","ENSG00000106069","ENSG00000106069","CHN2","7",29146547,29514328,367781
"1734","ENSG00000110172","ENSG00000110172","CHORDC1","11",90200429,90223077,22648
"1735","ENSG00000187446","ENSG00000187446","CHP1","15",41230839,41281887,51048
"1736","ENSG00000166869","ENSG00000166869","CHP2","16",23755026,23758935,3909
"1737","ENSG00000123989","ENSG00000123989","CHPF","2",219538954,219543809,4855
"1738","ENSG00000033100","ENSG00000033100","CHPF2","7",151232483,151240979,8496
"1739","ENSG00000111666","ENSG00000111666","CHPT1","12",101696947,101744140,47193
"1740","ENSG00000090539","ENSG00000090539","CHRD","3",184380054,184390736,10682
"1741","ENSG00000101938","ENSG00000101938","CHRDL1","X",110673856,110795819,121963
"1742","ENSG00000275917","ENSG00000275917","CHRFAM7A","HSCHR15_4_CTG8",2646214,2678539,32325
"1743","ENSG00000181072","ENSG00000181072","CHRM2","7",136868652,137020255,151603
"1744","ENSG00000133019","ENSG00000133019","CHRM3","1",239386565,239915452,528887
"1745","ENSG00000184984","ENSG00000184984","CHRM5","15",33968497,34067458,98961
"1746","ENSG00000138435","ENSG00000138435","CHRNA1","2",174747592,174787935,40343
"1747","ENSG00000080644","ENSG00000080644","CHRNA3","15",78593052,78621295,28243
"1748","ENSG00000101204","ENSG00000101204","CHRNA4","20",63343223,63378401,35178
"1749","ENSG00000169684","ENSG00000169684","CHRNA5","15",78565520,78595269,29749
"1750","ENSG00000274542","ENSG00000274542","CHRNA7","HSCHR15_4_CTG8",4315611,4454253,138642
"1751","ENSG00000174343","ENSG00000174343","CHRNA9","4",40335333,40355217,19884
"1752","ENSG00000170175","ENSG00000170175","CHRNB1","17",7445061,7457710,12649
"1753","ENSG00000160716","ENSG00000160716","CHRNB2","1",154567778,154580013,12235
"1754","ENSG00000117971","ENSG00000117971","CHRNB4","15",78624111,78727754,103643
"1755","ENSG00000135902","ENSG00000135902","CHRND","2",232525993,232536667,10674
"1756","ENSG00000108556","ENSG00000108556","CHRNE","17",4897771,4934438,36667
"1757","ENSG00000196811","ENSG00000196811","CHRNG","2",232539692,232548115,8423
"1758","ENSG00000175264","ENSG00000175264","CHST1","11",45647689,45665622,17933
"1759","ENSG00000115526","ENSG00000115526","CHST10","2",100391860,100417668,25808
"1760","ENSG00000171310","ENSG00000171310","CHST11","12",104455295,104762014,306719
"1761","ENSG00000136213","ENSG00000136213","CHST12","7",2403588,2448484,44896
"1762","ENSG00000182022","ENSG00000182022","CHST15","10",124007668,124093598,85930
"1763","ENSG00000175040","ENSG00000175040","CHST2","3",143119771,143124014,4243
"1764","ENSG00000122863","ENSG00000122863","CHST3","10",71964395,72013558,49163
"1765","ENSG00000140835","ENSG00000140835","CHST4","16",71525233,71538748,13515
"1766","ENSG00000135702","ENSG00000135702","CHST5","16",75528530,75536108,7578
"1767","ENSG00000183196","ENSG00000183196","CHST6","16",75472052,75495445,23393
"1768","ENSG00000147119","ENSG00000147119","CHST7","X",46573765,46598496,24731
"1769","ENSG00000124302","ENSG00000124302","CHST8","19",33621953,33773509,151556
"1770","ENSG00000131873","ENSG00000131873","CHSY1","15",101175727,101252048,76321
"1771","ENSG00000160679","ENSG00000160679","CHTOP","1",153633982,153646306,12324
"1772","ENSG00000213341","ENSG00000213341","CHUK","10",100188300,100229596,41296
"1773","ENSG00000144021","ENSG00000144021","CIAO1","2",96266159,96274173,8014
"1774","ENSG00000005194","ENSG00000005194","CIAPIN1","16",57428187,57447420,19233
"1775","ENSG00000185043","ENSG00000185043","CIB1","15",90229975,90234047,4072
"1776","ENSG00000136425","ENSG00000136425","CIB2","15",78104606,78131535,26929
"1777","ENSG00000079432","ENSG00000079432","CIC","19",42268537,42295797,27260
"1778","ENSG00000176194","ENSG00000176194","CIDEA","18",12254361,12277595,23234
"1779","ENSG00000136305","ENSG00000136305","CIDEB","14",24305187,24311430,6243
"1780","ENSG00000187288","ENSG00000187288","CIDEC","3",9866711,9880255,13544
"1781","ENSG00000179583","ENSG00000179583","CIITA","16",10866222,10943021,76799
"1782","ENSG00000138615","ENSG00000138615","CILP","15",65194760,65211473,16713
"1783","ENSG00000100865","ENSG00000100865","CINP","14",102341102,102362916,21814
"1784","ENSG00000138433","ENSG00000138433","CIR1","2",174348022,174395712,47690
"1785","ENSG00000099622","ENSG00000099622","CIRBP","19",1259384,1274880,15496
"1786","ENSG00000122873","ENSG00000122873","CISD1","10",58269162,58289586,20424
"1787","ENSG00000114737","ENSG00000114737","CISH","3",50606489,50611774,5285
"1788","ENSG00000122966","ENSG00000122966","CIT","12",119685791,119877320,191529
"1789","ENSG00000125931","ENSG00000125931","CITED1","X",72301638,72307187,5549
"1790","ENSG00000164442","ENSG00000164442","CITED2","6",139371807,139374648,2841
"1791","ENSG00000148337","ENSG00000148337","CIZ1","9",128161251,128204383,43132
"1792","ENSG00000136108","ENSG00000136108","CKAP2","13",52455429,52476628,21199
"1793","ENSG00000136026","ENSG00000136026","CKAP4","12",106237881,106304279,66398
"1794","ENSG00000175216","ENSG00000175216","CKAP5","11",46743048,46846308,103260
"1795","ENSG00000166165","ENSG00000166165","CKB","14",103519667,103522833,3166
"1796","ENSG00000217555","ENSG00000217555","CKLF","16",66552563,66566251,13688
"1797","ENSG00000104879","ENSG00000104879","CKM","19",45306413,45322875,16462
"1798","ENSG00000223572","ENSG00000223572","CKMT1A","15",43692886,43699222,6336
"1799","ENSG00000237289","ENSG00000237289","CKMT1B","15",43593054,43604901,11847
"1800","ENSG00000131730","ENSG00000131730","CKMT2","5",81233320,81266398,33078
"1801","ENSG00000173207","ENSG00000173207","CKS1B","1",154974653,154979251,4598
"1802","ENSG00000123975","ENSG00000123975","CKS2","9",89311195,89316703,5508
"1803","ENSG00000074054","ENSG00000074054","CLASP1","2",121337776,121649476,311700
"1804","ENSG00000163539","ENSG00000163539","CLASP2","3",33496245,33718356,222111
"1805","ENSG00000104859","ENSG00000104859","CLASRP","19",45039045,45070956,31911
"1806","ENSG00000105205","ENSG00000105205","CLC","19",39731255,39738029,6774
"1807","ENSG00000016490","ENSG00000016490","CLCA1","1",86468368,86500259,31891
"1808","ENSG00000137975","ENSG00000137975","CLCA2","1",86424171,86456553,32382
"1809","ENSG00000016602","ENSG00000016602","CLCA4","1",86547078,86580754,33676
"1810","ENSG00000121940","ENSG00000121940","CLCC1","1",108881885,108963527,81642
"1811","ENSG00000175505","ENSG00000175505","CLCF1","11",67364168,67374177,10009
"1812","ENSG00000188037","ENSG00000188037","CLCN1","7",143316111,143352083,35972
"1813","ENSG00000114859","ENSG00000114859","CLCN2","3",184346185,184361650,15465
"1814","ENSG00000109572","ENSG00000109572","CLCN3","4",169612633,169723673,111040
"1815","ENSG00000073464","ENSG00000073464","CLCN4","X",10156975,10237660,80685
"1816","ENSG00000171365","ENSG00000171365","CLCN5","X",49922596,50099235,176639
"1817","ENSG00000011021","ENSG00000011021","CLCN6","1",11806096,11848079,41983
"1818","ENSG00000103249","ENSG00000103249","CLCN7","16",1444934,1475077,30143
"1819","ENSG00000186510","ENSG00000186510","CLCNKA","1",16018875,16034050,15175
"1820","ENSG00000184908","ENSG00000184908","CLCNKB","1",16040252,16057311,17059
"1821","ENSG00000163347","ENSG00000163347","CLDN1","3",190305707,190322446,16739
"1822","ENSG00000134873","ENSG00000134873","CLDN10","13",95433604,95579759,146155
"1823","ENSG00000013297","ENSG00000013297","CLDN11","3",170418868,170454733,35865
"1824","ENSG00000159261","ENSG00000159261","CLDN14","21",36460621,36576569,115948
"1825","ENSG00000106404","ENSG00000106404","CLDN15","7",101232092,101238820,6728
"1826","ENSG00000113946","ENSG00000113946","CLDN16","3",190322541,190412138,89597
"1827","ENSG00000066405","ENSG00000066405","CLDN18","3",137998735,138033655,34920
"1828","ENSG00000165215","ENSG00000165215","CLDN3","7",73768997,73770270,1273
"1829","ENSG00000189143","ENSG00000189143","CLDN4","7",73799542,73832690,33148
"1830","ENSG00000184113","ENSG00000184113","CLDN5","22",19523024,19527545,4521
"1831","ENSG00000184697","ENSG00000184697","CLDN6","16",3014712,3020071,5359
"1832","ENSG00000181885","ENSG00000181885","CLDN7","17",7259903,7263983,4080
"1833","ENSG00000156284","ENSG00000156284","CLDN8","21",30214006,30216097,2091
"1834","ENSG00000213937","ENSG00000213937","CLDN9","16",3012923,3014505,1582
"1835","ENSG00000080822","ENSG00000080822","CLDND1","3",98497912,98523066,25154
"1836","ENSG00000132514","ENSG00000132514","CLEC10A","17",7074537,7080307,5770
"1837","ENSG00000105472","ENSG00000105472","CLEC11A","19",50723364,50725708,2344
"1838","ENSG00000038532","ENSG00000038532","CLEC16A","16",10944539,11182186,237647
"1839","ENSG00000150048","ENSG00000150048","CLEC1A","12",10069554,10111627,42073
"1840","ENSG00000165682","ENSG00000165682","CLEC1B","12",9985642,10013424,27782
"1841","ENSG00000110852","ENSG00000110852","CLEC2B","12",9852369,9869386,17017
"1842","ENSG00000069493","ENSG00000069493","CLEC2D","12",9664969,9699553,34584
"1843","ENSG00000163815","ENSG00000163815","CLEC3B","3",45001548,45036071,34523
"1844","ENSG00000111729","ENSG00000111729","CLEC4A","12",8123617,8138607,14990
"1845","ENSG00000166523","ENSG00000166523","CLEC4E","12",8533305,8540905,7600
"1846","ENSG00000104938","ENSG00000104938","CLEC4M","19",7763210,7769605,6395
"1847","ENSG00000258227","ENSG00000258227","CLEC5A","7",141927357,141947007,19650
"1848","ENSG00000172243","ENSG00000172243","CLEC7A","12",10116777,10130258,13481
"1849","ENSG00000153132","ENSG00000153132","CLGN","4",140388453,140427661,39208
"1850","ENSG00000230685","ENSG00000230685","CLIC1","HSCHR6_MHC_COX_CTG1",3207869,3217043,9174
"1851","ENSG00000155962","ENSG00000155962","CLIC2","X",155276211,155334657,58446
"1852","ENSG00000169583","ENSG00000169583","CLIC3","9",136994608,136996568,1960
"1853","ENSG00000169504","ENSG00000169504","CLIC4","1",24745382,24844321,98939
"1854","ENSG00000112782","ENSG00000112782","CLIC5","6",45880827,46080348,199521
"1855","ENSG00000113282","ENSG00000113282","CLINT1","5",157785743,157859145,73402
"1856","ENSG00000130779","ENSG00000130779","CLIP1","12",122271432,122422669,151237
"1857","ENSG00000106665","ENSG00000106665","CLIP2","7",74289407,74405935,116528
"1858","ENSG00000105270","ENSG00000105270","CLIP3","19",36014660,36033343,18683
"1859","ENSG00000115295","ENSG00000115295","CLIP4","2",29097705,29199777,102072
"1860","ENSG00000013441","ENSG00000013441","CLK1","2",200853009,200864691,11682
"1861","ENSG00000261893","ENSG00000261893","CLK2","HSCHR1_2_CTG31",67891,83514,15623
"1862","ENSG00000179335","ENSG00000179335","CLK3","15",74598500,74645414,46914
"1863","ENSG00000113240","ENSG00000113240","CLK4","5",178602664,178630615,27951
"1864","ENSG00000165959","ENSG00000165959","CLMN","14",95181940,95319908,137968
"1865","ENSG00000188603","ENSG00000188603","CLN3","16",28474111,28495575,21464
"1866","ENSG00000102805","ENSG00000102805","CLN5","13",76990660,77019143,28483
"1867","ENSG00000128973","ENSG00000128973","CLN6","15",68206992,68257211,50219
"1868","ENSG00000278220","ENSG00000278220","CLN8","HSCHR8_7_CTG1",168436,199228,30792
"1869","ENSG00000074201","ENSG00000074201","CLNS1A","11",77514936,77637794,122858
"1870","ENSG00000134852","ENSG00000134852","CLOCK","4",55427903,55546909,119006
"1871","ENSG00000172409","ENSG00000172409","CLP1","11",57648188,57661865,13677
"1872","ENSG00000162129","ENSG00000162129","CLPB","11",72285495,72434680,149185
"1873","ENSG00000125656","ENSG00000125656","CLPP","19",6361531,6370242,8711
"1874","ENSG00000137392","ENSG00000137392","CLPS","6",35794982,35797344,2362
"1875","ENSG00000104853","ENSG00000104853","CLPTM1","19",44954585,44993341,38756
"1876","ENSG00000166855","ENSG00000166855","CLPX","15",65148219,65185342,37123
"1877","ENSG00000092853","ENSG00000092853","CLSPN","1",35720218,35769978,49760
"1878","ENSG00000171603","ENSG00000171603","CLSTN1","1",9728926,9823984,95058
"1879","ENSG00000158258","ENSG00000158258","CLSTN2","3",139935185,140577397,642212
"1880","ENSG00000139182","ENSG00000139182","CLSTN3","12",7129698,7158945,29247
"1881","ENSG00000122705","ENSG00000122705","CLTA","9",36190856,36304781,113925
"1882","ENSG00000175416","ENSG00000175416","CLTB","5",176392501,176416539,24038
"1883","ENSG00000141367","ENSG00000141367","CLTC","17",59619680,59696956,77276
"1884","ENSG00000070371","ENSG00000070371","CLTCL1","22",19179473,19291719,112246
"1885","ENSG00000120885","ENSG00000120885","CLU","8",27596917,27614700,17783
"1886","ENSG00000103351","ENSG00000103351","CLUAP1","16",3500976,3539048,38072
"1887","ENSG00000132361","ENSG00000132361","CLUH","17",2689386,2712663,23277
"1888","ENSG00000079101","ENSG00000079101","CLUL1","18",596988,650334,53346
"1889","ENSG00000092009","ENSG00000092009","CMA1","14",24505353,24508265,2912
"1890","ENSG00000111726","ENSG00000111726","CMAS","12",22046218,22065674,19456
"1891","ENSG00000103121","ENSG00000103121","CMC2","16",80966448,81020270,53822
"1892","ENSG00000182712","ENSG00000182712","CMC4","X",155061622,155071136,9514
"1893","ENSG00000174600","ENSG00000174600","CMKLR1","12",108288044,108339317,51273
"1894","ENSG00000162368","ENSG00000162368","CMPK1","1",47333790,47394866,61076
"1895","ENSG00000091317","ENSG00000091317","CMTM6","3",32481312,32502852,21540
"1896","ENSG00000137200","ENSG00000137200","CMTR1","6",37433219,37482827,49608
"1897","ENSG00000169714","ENSG00000169714","CNBP","3",129167827,129183922,16095
"1898","ENSG00000133313","ENSG00000133313","CNDP2","18",74495816,74523454,27638
"1899","ENSG00000198515","ENSG00000198515","CNGA1","4",47935977,48016681,80704
"1900","ENSG00000144191","ENSG00000144191","CNGA3","2",98346188,98398601,52413
"1901","ENSG00000070729","ENSG00000070729","CNGB1","16",57882340,57971128,88788
"1902","ENSG00000100528","ENSG00000100528","CNIH1","14",54423561,54441391,17830
"1903","ENSG00000143771","ENSG00000143771","CNIH4","1",224356858,224379459,22601
"1904","ENSG00000142675","ENSG00000142675","CNKSR1","1",26177484,26189884,12400
"1905","ENSG00000149970","ENSG00000149970","CNKSR2","X",21372801,21654695,281894
"1906","ENSG00000130176","ENSG00000130176","CNN1","19",11538767,11550323,11556
"1907","ENSG00000064666","ENSG00000064666","CNN2","19",1026586,1039068,12482
"1908","ENSG00000117519","ENSG00000117519","CNN3","1",94896949,94927223,30274
"1909","ENSG00000119946","ENSG00000119946","CNNM1","10",99329356,99394330,64974
"1910","ENSG00000148842","ENSG00000148842","CNNM2","10",102918294,103090222,171928
"1911","ENSG00000168763","ENSG00000168763","CNNM3","2",96816245,96835382,19137
"1912","ENSG00000158158","ENSG00000158158","CNNM4","2",96760902,96811874,50972
"1913","ENSG00000125107","ENSG00000125107","CNOT1","16",58519951,58629885,109934
"1914","ENSG00000111596","ENSG00000111596","CNOT2","12",70243002,70354993,111991
"1915","ENSG00000277615","ENSG00000277615","CNOT3","HSCHR19LRC_PGF2_CTG3_1",112549,130558,18009
"1916","ENSG00000080802","ENSG00000080802","CNOT4","7",135361795,135510145,148350
"1917","ENSG00000113300","ENSG00000113300","CNOT6","5",180494379,180578358,83979
"1918","ENSG00000198791","ENSG00000198791","CNOT7","8",17224966,17246878,21912
"1919","ENSG00000155508","ENSG00000155508","CNOT8","5",154857553,154876792,19239
"1920","ENSG00000144580","ENSG00000144580","CNOT9","2",218568580,218597080,28500
"1921","ENSG00000173786","ENSG00000173786","CNP","17",41966763,41977740,10977
"1922","ENSG00000115649","ENSG00000115649","CNPPD1","2",219171897,219178106,6209
"1923","ENSG00000257727","ENSG00000257727","CNPY2","12",56309842,56316119,6277
"1924","ENSG00000137161","ENSG00000137161","CNPY3","6",42929480,42939294,9814
"1925","ENSG00000166997","ENSG00000166997","CNPY4","7",100119634,100125508,5874
"1926","ENSG00000118432","ENSG00000118432","CNR1","6",88139864,88166347,26483
"1927","ENSG00000188822","ENSG00000188822","CNR2","1",23870515,23913362,42847
"1928","ENSG00000242689","ENSG00000242689","CNTF","11",58622665,58625733,3068
"1929","ENSG00000122756","ENSG00000122756","CNTFR","9",34551432,34590140,38708
"1930","ENSG00000044459","ENSG00000044459","CNTLN","9",17134982,17503923,368941
"1931","ENSG00000018236","ENSG00000018236","CNTN1","12",40692439,41072415,379976
"1932","ENSG00000184144","ENSG00000184144","CNTN2","1",205042937,205078289,35352
"1933","ENSG00000134115","ENSG00000134115","CNTN6","3",1092658,1404217,311559
"1934","ENSG00000108797","ENSG00000108797","CNTNAP1","17",42682531,42699993,17462
"1935","ENSG00000278728","ENSG00000278728","CNTNAP2","HSCHR7_3_CTG6",2415,204593,202178
"1936","ENSG00000119397","ENSG00000119397","CNTRL","9",121074660,121177729,103069
"1937","ENSG00000106603","ENSG00000106603","COA1","7",43608456,43729717,121261
"1938","ENSG00000183978","ENSG00000183978","COA3","17",42795147,42798704,3557
"1939","ENSG00000181924","ENSG00000181924","COA4","11",73872667,73876901,4234
"1940","ENSG00000162377","ENSG00000162377","COA7","1",52684449,52698347,13898
"1941","ENSG00000068120","ENSG00000068120","COASY","17",42561467,42566277,4810
"1942","ENSG00000106078","ENSG00000106078","COBL","7",51016212,51316818,300606
"1943","ENSG00000082438","ENSG00000082438","COBLL1","2",164653624,164843679,190055
"1944","ENSG00000100473","ENSG00000100473","COCH","14",30874514,30895065,20551
"1945","ENSG00000135775","ENSG00000135775","COG2","1",230642481,230693982,51501
"1946","ENSG00000103051","ENSG00000103051","COG4","16",70480568,70523560,42992
"1947","ENSG00000164597","ENSG00000164597","COG5","7",107201372,107564261,362889
"1948","ENSG00000213380","ENSG00000213380","COG8","16",69320140,69339583,19443
"1949","ENSG00000121058","ENSG00000121058","COIL","17",56938199,56961050,22851
"1950","ENSG00000060718","ENSG00000060718","COL11A1","1",102876467,103108872,232405
"1951","ENSG00000235708","ENSG00000235708","COL11A2","HSCHR6_MHC_MCF_CTG1",4598639,4628455,29816
"1952","ENSG00000197467","ENSG00000197467","COL13A1","10",69801880,69964275,162395
"1953","ENSG00000187955","ENSG00000187955","COL14A1","8",120059780,120373573,313793
"1954","ENSG00000204291","ENSG00000204291","COL15A1","9",98943179,99070787,127608
"1955","ENSG00000084636","ENSG00000084636","COL16A1","1",31652263,31704319,52056
"1956","ENSG00000065618","ENSG00000065618","COL17A1","10",104031286,104085880,54594
"1957","ENSG00000182871","ENSG00000182871","COL18A1","21",45405165,45513720,108555
"1958","ENSG00000108821","ENSG00000108821","COL1A1","17",50184101,50201632,17531
"1959","ENSG00000164692","ENSG00000164692","COL1A2","7",94394895,94431227,36332
"1960","ENSG00000124749","ENSG00000124749","COL21A1","6",56056590,56394094,337504
"1961","ENSG00000139219","ENSG00000139219","COL2A1","12",47972967,48004554,31587
"1962","ENSG00000168542","ENSG00000168542","COL3A1","2",188974373,189012746,38373
"1963","ENSG00000187498","ENSG00000187498","COL4A1","13",110148963,110307202,158239
"1964","ENSG00000134871","ENSG00000134871","COL4A2","13",110305812,110513209,207397
"1965","ENSG00000169031","ENSG00000169031","COL4A3","2",227164624,227314792,150168
"1966","ENSG00000081052","ENSG00000081052","COL4A4","2",227002714,227164453,161739
"1967","ENSG00000188153","ENSG00000188153","COL4A5","X",108439838,108697545,257707
"1968","ENSG00000197565","ENSG00000197565","COL4A6","X",108155607,108439497,283890
"1969","ENSG00000130635","ENSG00000130635","COL5A1","9",134641803,134844843,203040
"1970","ENSG00000204262","ENSG00000204262","COL5A2","2",189031898,189225312,193414
"1971","ENSG00000080573","ENSG00000080573","COL5A3","19",9959561,10010504,50943
"1972","ENSG00000142156","ENSG00000142156","COL6A1","21",45981770,46005050,23280
"1973","ENSG00000142173","ENSG00000142173","COL6A2","21",46098112,46132848,34736
"1974","ENSG00000163359","ENSG00000163359","COL6A3","2",237324003,237414328,90325
"1975","ENSG00000114270","ENSG00000114270","COL7A1","3",48564073,48595329,31256
"1976","ENSG00000144810","ENSG00000144810","COL8A1","3",99638475,99799226,160751
"1977","ENSG00000171812","ENSG00000171812","COL8A2","1",36095239,36125222,29983
"1978","ENSG00000112280","ENSG00000112280","COL9A1","6",70216040,70303084,87044
"1979","ENSG00000049089","ENSG00000049089","COL9A2","1",40300489,40317813,17324
"1980","ENSG00000092758","ENSG00000092758","COL9A3","20",62816244,62841159,24915
"1981","ENSG00000184374","ENSG00000184374","COLEC10","8",118995452,119108455,113003
"1982","ENSG00000118004","ENSG00000118004","COLEC11","2",3594832,3644644,49812
"1983","ENSG00000158270","ENSG00000158270","COLEC12","18",316737,500722,183985
"1984","ENSG00000130309","ENSG00000130309","COLGALT1","19",17555649,17583162,27513
"1985","ENSG00000198756","ENSG00000198756","COLGALT2","1",183929854,184037729,107875
"1986","ENSG00000206561","ENSG00000206561","COLQ","3",15450133,15521751,71618
"1987","ENSG00000145781","ENSG00000145781","COMMD10","5",116085016,116412762,327746
"1988","ENSG00000148444","ENSG00000148444","COMMD3","10",22316386,22320306,3920
"1989","ENSG00000140365","ENSG00000140365","COMMD4","15",75336020,75343224,7204
"1990","ENSG00000169019","ENSG00000169019","COMMD8","4",47450787,47463702,12915
"1991","ENSG00000110442","ENSG00000110442","COMMD9","11",36269284,36289449,20165
"1992","ENSG00000105664","ENSG00000105664","COMP","19",18782773,18791305,8532
"1993","ENSG00000093010","ENSG00000093010","COMT","22",19941371,19969975,28604
"1994","ENSG00000122218","ENSG00000122218","COPA","1",160288594,160343566,54972
"1995","ENSG00000129083","ENSG00000129083","COPB1","11",14443440,14500027,56587
"1996","ENSG00000184432","ENSG00000184432","COPB2","3",139353946,139389736,35790
"1997","ENSG00000105669","ENSG00000105669","COPE","19",18899514,18919387,19873
"1998","ENSG00000181789","ENSG00000181789","COPG1","3",129249606,129277773,28167
"1999","ENSG00000166200","ENSG00000166200","COPS2","15",49106068,49155661,49593
"2000","ENSG00000141030","ENSG00000141030","COPS3","17",17246616,17281273,34657
"2001","ENSG00000138663","ENSG00000138663","COPS4","4",83034447,83075818,41371
"2002","ENSG00000121022","ENSG00000121022","COPS5","8",67043079,67083783,40704
"2003","ENSG00000168090","ENSG00000168090","COPS6","7",100088969,100092187,3218
"2004","ENSG00000111652","ENSG00000111652","COPS7A","12",6724014,6731875,7861
"2005","ENSG00000144524","ENSG00000144524","COPS7B","2",231781671,231809254,27583
"2006","ENSG00000198612","ENSG00000198612","COPS8","2",237085882,237100474,14592
"2007","ENSG00000111481","ENSG00000111481","COPZ1","12",54301202,54351846,50644
"2008","ENSG00000005243","ENSG00000005243","COPZ2","17",48026167,48038030,11863
"2009","ENSG00000115520","ENSG00000115520","COQ10B","2",197453493,197475310,21817
"2010","ENSG00000173085","ENSG00000173085","COQ2","4",83261536,83284914,23378
"2011","ENSG00000132423","ENSG00000132423","COQ3","6",99369401,99394195,24794
"2012","ENSG00000167113","ENSG00000167113","COQ4","9",128322544,128334072,11528
"2013","ENSG00000119723","ENSG00000119723","COQ6","14",73949926,73963670,13744
"2014","ENSG00000167186","ENSG00000167186","COQ7","16",19067614,19080095,12481
"2015","ENSG00000145244","ENSG00000145244","CORIN","4",47593999,47838106,244107
"2016","ENSG00000102879","ENSG00000102879","CORO1A","16",30182827,30189076,6249
"2017","ENSG00000172725","ENSG00000172725","CORO1B","11",67435510,67443821,8311
"2018","ENSG00000110880","ENSG00000110880","CORO1C","12",108645109,108731526,86417
"2019","ENSG00000106789","ENSG00000106789","CORO2A","9",98120975,98192637,71662
"2020","ENSG00000103647","ENSG00000103647","CORO2B","15",68578993,68727806,148813
"2021","ENSG00000282725","ENSG00000282725","CORO7","HSCHR16_3_CTG1",56867,128028,71161
"2022","ENSG00000241563","ENSG00000241563","CORT","1",10450031,10451998,1967
"2023","ENSG00000103187","ENSG00000103187","COTL1","16",84565596,84618078,52482
"2024","ENSG00000006695","ENSG00000006695","COX10","17",14069490,14231736,162246
"2025","ENSG00000166260","ENSG00000166260","COX11","17",54951902,54968703,16801
"2026","ENSG00000178449","ENSG00000178449","COX14","12",50112082,50120457,8375
"2027","ENSG00000014919","ENSG00000014919","COX15","10",99710868,99732127,21259
"2028","ENSG00000133983","ENSG00000133983","COX16","14",70325081,70416984,91903
"2029","ENSG00000138495","ENSG00000138495","COX17","3",119654513,119677454,22941
"2030","ENSG00000131143","ENSG00000131143","COX4I1","16",85798633,85807068,8435
"2031","ENSG00000178741","ENSG00000178741","COX5A","15",74919791,74938083,18292
"2032","ENSG00000135940","ENSG00000135940","COX5B","2",97646062,97648383,2321
"2033","ENSG00000111775","ENSG00000111775","COX6A1","12",120438090,120440737,2647
"2034","ENSG00000126267","ENSG00000126267","COX6B1","19",35648323,35658782,10459
"2035","ENSG00000164919","ENSG00000164919","COX6C","8",99873200,99893707,20507
"2036","ENSG00000161281","ENSG00000161281","COX7A1","19",36150922,36152449,1527
"2037","ENSG00000112695","ENSG00000112695","COX7A2","6",75237675,75250323,12648
"2038","ENSG00000115944","ENSG00000115944","COX7A2L","2",42333546,42425088,91542
"2039","ENSG00000131174","ENSG00000131174","COX7B","X",77899440,77907376,7936
"2040","ENSG00000127184","ENSG00000127184","COX7C","5",86617928,86620962,3034
"2041","ENSG00000047457","ENSG00000047457","CP","3",149162410,149221829,59419
"2042","ENSG00000091704","ENSG00000091704","CPA1","7",130380339,130388114,7775
"2043","ENSG00000158516","ENSG00000158516","CPA2","7",130266863,130289798,22935
"2044","ENSG00000163751","ENSG00000163751","CPA3","3",148865296,148897203,31907
"2045","ENSG00000128510","ENSG00000128510","CPA4","7",130293134,130324180,31046
"2046","ENSG00000153002","ENSG00000153002","CPB1","3",148791102,148860187,69085
"2047","ENSG00000080618","ENSG00000080618","CPB2","13",46053186,46105033,51847
"2048","ENSG00000108582","ENSG00000108582","CPD","17",30378927,30469989,91062
"2049","ENSG00000277445","ENSG00000277445","CPEB1","HSCHR15_5_CTG8",332306,430788,98482
"2050","ENSG00000107864","ENSG00000107864","CPEB3","10",92046692,92291078,244386
"2051","ENSG00000106034","ENSG00000106034","CPED1","7",120988697,121297442,308745
"2052","ENSG00000145920","ENSG00000145920","CPLX2","5",175796310,175884021,87711
"2053","ENSG00000213578","ENSG00000213578","CPLX3","15",74826627,74831802,5175
"2054","ENSG00000135678","ENSG00000135678","CPM","12",68842197,68971570,129373
"2055","ENSG00000120054","ENSG00000120054","CPN1","10",100042193,100081869,39676
"2056","ENSG00000178772","ENSG00000178772","CPN2","3",194339768,194351328,11560
"2057","ENSG00000214078","ENSG00000214078","CPNE1","20",35626031,35664956,38925
"2058","ENSG00000085719","ENSG00000085719","CPNE3","8",86514435,86561498,47063
"2059","ENSG00000100884","ENSG00000100884","CPNE6","14",24070837,24078100,7263
"2060","ENSG00000178773","ENSG00000178773","CPNE7","16",89575758,89597246,21488
"2061","ENSG00000080819","ENSG00000080819","CPOX","3",98579446,98593648,14202
"2062","ENSG00000103381","ENSG00000103381","CPPED1","16",12659799,12803887,144088
"2063","ENSG00000104324","ENSG00000104324","CPQ","8",96645242,97149654,504412
"2064","ENSG00000021826","ENSG00000021826","CPS1","2",210477682,210679107,201425
"2065","ENSG00000071894","ENSG00000071894","CPSF1","8",144393229,144409335,16106
"2066","ENSG00000160917","ENSG00000160917","CPSF4","7",99438922,99457373,18451
"2067","ENSG00000111605","ENSG00000111605","CPSF6","12",69239569,69274358,34789
"2068","ENSG00000149532","ENSG00000149532","CPSF7","11",61402641,61430031,27390
"2069","ENSG00000110090","ENSG00000110090","CPT1A","11",68754620,68844410,89790
"2070","ENSG00000205560","ENSG00000205560","CPT1B","22",50568861,50578465,9604
"2071","ENSG00000157184","ENSG00000157184","CPT2","1",53196792,53214197,17405
"2072","ENSG00000224051","ENSG00000224051","CPTP","1",1324756,1328896,4140
"2073","ENSG00000106066","ENSG00000106066","CPVL","7",28995235,29195451,200216
"2074","ENSG00000109625","ENSG00000109625","CPZ","4",8592660,8619759,27099
"2075","ENSG00000203710","ENSG00000203710","CR1","1",207496147,207641765,145618
"2076","ENSG00000117322","ENSG00000117322","CR2","1",207453024,207489895,36871
"2077","ENSG00000166426","ENSG00000166426","CRABP1","15",78340353,78348225,7872
"2078","ENSG00000169372","ENSG00000169372","CRADD","12",93677375,93894840,217465
"2079","ENSG00000095321","ENSG00000095321","CRAT","9",129094142,129111189,17047
"2080","ENSG00000134376","ENSG00000134376","CRB1","1",197268204,197478455,210251
"2081","ENSG00000113851","ENSG00000113851","CRBN","3",3144628,3179727,35099
"2082","ENSG00000241258","ENSG00000241258","CRCP","7",66114604,66154568,39964
"2083","ENSG00000169509","ENSG00000169509","CRCT1","1",152514482,152516008,1526
"2084","ENSG00000118260","ENSG00000118260","CREB1","2",207529737,207605988,76251
"2085","ENSG00000107175","ENSG00000107175","CREB3","9",35732598,35736999,4401
"2086","ENSG00000157613","ENSG00000157613","CREB3L1","11",46277662,46321409,43747
"2087","ENSG00000182158","ENSG00000182158","CREB3L2","7",137874979,138002086,127107
"2088","ENSG00000146592","ENSG00000146592","CREB5","7",28299321,28825894,526573
"2089","ENSG00000005339","ENSG00000005339","CREBBP","16",3725054,3880713,155659
"2090","ENSG00000111269","ENSG00000111269","CREBL2","12",12611827,12645108,33281
"2091","ENSG00000137504","ENSG00000137504","CREBZF","11",85657742,85682908,25166
"2092","ENSG00000143162","ENSG00000143162","CREG1","1",167529117,167553805,24688
"2093","ENSG00000163703","ENSG00000163703","CRELD1","3",9933793,9945413,11620
"2094","ENSG00000184164","ENSG00000184164","CRELD2","22",49918167,49927540,9373
"2095","ENSG00000095794","ENSG00000095794","CREM","10",35126791,35212958,86167
"2096","ENSG00000147571","ENSG00000147571","CRH","8",66176376,66178464,2088
"2097","ENSG00000145708","ENSG00000145708","CRHBP","5",76953045,76981158,28113
"2098","ENSG00000276191","ENSG00000276191","CRHR1","HSCHR17_2_CTG5",486391,537950,51559
"2099","ENSG00000106113","ENSG00000106113","CRHR2","7",30651942,30700129,48187
"2100","ENSG00000150938","ENSG00000150938","CRIM1","2",36355778,36551135,195357
"2101","ENSG00000213145","ENSG00000213145","CRIP1","14",105486317,105488947,2630
"2102","ENSG00000182809","ENSG00000182809","CRIP2","14",105472962,105480162,7200
"2103","ENSG00000119878","ENSG00000119878","CRIPT","2",46616416,46630176,13760
"2104","ENSG00000124490","ENSG00000124490","CRISP2","6",49692358,49713590,21232
"2105","ENSG00000096006","ENSG00000096006","CRISP3","6",49727376,49744437,17061
"2106","ENSG00000103196","ENSG00000103196","CRISPLD2","16",84819985,84920768,100783
"2107","ENSG00000167193","ENSG00000167193","CRK","17",1420689,1463162,42473
"2108","ENSG00000099942","ENSG00000099942","CRKL","22",20917407,20953747,36340
"2109","ENSG00000006016","ENSG00000006016","CRLF1","19",18572220,18607741,35521
"2110","ENSG00000205755","ENSG00000205755","CRLF2","X",1190490,1212723,22233
"2111","ENSG00000176390","ENSG00000176390","CRLF3","17",30769388,30824692,55304
"2112","ENSG00000072832","ENSG00000072832","CRMP1","4",5748084,5893086,145002
"2113","ENSG00000101343","ENSG00000101343","CRNKL1","20",20034368,20056046,21678
"2114","ENSG00000143536","ENSG00000143536","CRNN","1",152409243,152414263,5020
"2115","ENSG00000058453","ENSG00000058453","CROCC","1",16740273,16972964,232691
"2116","ENSG00000005469","ENSG00000005469","CROT","7",87345664,87399794,54130
"2117","ENSG00000132693","ENSG00000132693","CRP","1",159712289,159714589,2300
"2118","ENSG00000095713","ENSG00000095713","CRTAC1","10",97865000,98030828,165828
"2119","ENSG00000170275","ENSG00000170275","CRTAP","3",33114014,33147773,33759
"2120","ENSG00000105662","ENSG00000105662","CRTC1","19",18683678,18782333,98655
"2121","ENSG00000140577","ENSG00000140577","CRTC3","15",90529923,90645345,115422
"2122","ENSG00000105392","ENSG00000105392","CRX","19",47819779,47843330,23551
"2123","ENSG00000008405","ENSG00000008405","CRY1","12",106991364,107093549,102185
"2124","ENSG00000121671","ENSG00000121671","CRY2","11",45847118,45883248,36130
"2125","ENSG00000160202","ENSG00000160202","CRYAA","21",43169008,43172805,3797
"2126","ENSG00000109846","ENSG00000109846","CRYAB","11",111908564,111923722,15158
"2127","ENSG00000163499","ENSG00000163499","CRYBA2","2",218990189,218993422,3233
"2128","ENSG00000196431","ENSG00000196431","CRYBA4","22",26621963,26630669,8706
"2129","ENSG00000100122","ENSG00000100122","CRYBB1","22",26599278,26618027,18749
"2130","ENSG00000244752","ENSG00000244752","CRYBB2","22",25212564,25231870,19306
"2131","ENSG00000100053","ENSG00000100053","CRYBB3","22",25199858,25207359,7501
"2132","ENSG00000118231","ENSG00000118231","CRYGD","2",208121607,208124524,2917
"2133","ENSG00000165475","ENSG00000165475","CRYL1","13",20403666,20525873,122207
"2134","ENSG00000103316","ENSG00000103316","CRYM","16",21238874,21303083,64209
"2135","ENSG00000116791","ENSG00000116791","CRYZ","1",74705482,74733408,27926
"2136","ENSG00000205758","ENSG00000205758","CRYZL1","21",33589341,33643926,54585
"2137","ENSG00000062485","ENSG00000062485","CS","12",56271699,56300391,28692
"2138","ENSG00000139631","ENSG00000139631","CSAD","12",53157663,53180925,23262
"2139","ENSG00000172346","ENSG00000172346","CSDC2","22",41561010,41577741,16731
"2140","ENSG00000009307","ENSG00000009307","CSDE1","1",114716913,114758676,41763
"2141","ENSG00000124207","ENSG00000124207","CSE1L","20",49046246,49096960,50714
"2142","ENSG00000184371","ENSG00000184371","CSF1","1",109910242,109930992,20750
"2143","ENSG00000182578","ENSG00000182578","CSF1R","5",150053291,150113372,60081
"2144","ENSG00000164400","ENSG00000164400","CSF2","5",132073789,132076170,2381
"2145","ENSG00000198223","ENSG00000198223","CSF2RA","X",1268800,1310381,41581
"2146","ENSG00000100368","ENSG00000100368","CSF2RB","22",36913628,36940439,26811
"2147","ENSG00000108342","ENSG00000108342","CSF3","17",40015361,40017813,2452
"2148","ENSG00000119535","ENSG00000119535","CSF3R","1",36466043,36483278,17235
"2149","ENSG00000147408","ENSG00000147408","CSGALNACT1","8",19404161,19758029,353868
"2150","ENSG00000169826","ENSG00000169826","CSGALNACT2","10",43138445,43185302,46857
"2151","ENSG00000213218","ENSG00000213218","CSH2","17",63872012,63873766,1754
"2152","ENSG00000103653","ENSG00000103653","CSK","15",74782080,74803197,21117
"2153","ENSG00000113712","ENSG00000113712","CSNK1A1","5",149492982,149551471,58489
"2154","ENSG00000141551","ENSG00000141551","CSNK1D","17",82239023,82273700,34677
"2155","ENSG00000213923","ENSG00000213923","CSNK1E","22",38290691,38318084,27393
"2156","ENSG00000133275","ENSG00000133275","CSNK1G2","19",1941172,1981338,40166
"2157","ENSG00000151292","ENSG00000151292","CSNK1G3","5",123512177,123617049,104872
"2158","ENSG00000101266","ENSG00000101266","CSNK2A1","20",472498,543835,71337
"2159","ENSG00000070770","ENSG00000070770","CSNK2A2","16",58157907,58198106,40199
"2160","ENSG00000232960","ENSG00000232960","CSNK2B","HSCHR6_MHC_MANN_CTG1",2970283,2977329,7046
"2161","ENSG00000173546","ENSG00000173546","CSPG4","15",75674322,75712848,38526
"2162","ENSG00000114646","ENSG00000114646","CSPG5","3",47562238,47580792,18554
"2163","ENSG00000104218","ENSG00000104218","CSPP1","8",67062417,67196778,134361
"2164","ENSG00000110925","ENSG00000110925","CSRNP2","12",51061205,51083664,22459
"2165","ENSG00000178662","ENSG00000178662","CSRNP3","2",165469647,165689407,219760
"2166","ENSG00000159176","ENSG00000159176","CSRP1","1",201483530,201509456,25926
"2167","ENSG00000175183","ENSG00000175183","CSRP2","12",76858709,76879023,20314
"2168","ENSG00000129170","ENSG00000129170","CSRP3","11",19182030,19210571,28541
"2169","ENSG00000101439","ENSG00000101439","CST3","20",23626706,23638473,11767
"2170","ENSG00000101441","ENSG00000101441","CST4","20",23685640,23689038,3398
"2171","ENSG00000175315","ENSG00000175315","CST6","11",66012008,66013505,1497
"2172","ENSG00000077984","ENSG00000077984","CST7","20",24949269,24959928,10659
"2173","ENSG00000121552","ENSG00000121552","CSTA","3",122325248,122341969,16721
"2174","ENSG00000160213","ENSG00000160213","CSTB","21",43772511,43776330,3819
"2175","ENSG00000101138","ENSG00000101138","CSTF1","20",56392371,56406362,13991
"2176","ENSG00000101811","ENSG00000101811","CSTF2","X",100820391,100841520,21129
"2177","ENSG00000177613","ENSG00000177613","CSTF2T","10",51695486,51699595,4109
"2178","ENSG00000176102","ENSG00000176102","CSTF3","11",33077188,33162371,85183
"2179","ENSG00000169551","ENSG00000169551","CT55","X",135156540,135171398,14858
"2180","ENSG00000225362","ENSG00000225362","CT62","15",71110244,71115494,5250
"2181","ENSG00000159692","ENSG00000159692","CTBP1","4",1211445,1250333,38888
"2182","ENSG00000175029","ENSG00000175029","CTBP2","10",124984317,125161170,176853
"2183","ENSG00000117151","ENSG00000117151","CTBS","1",84549611,84574480,24869
"2184","ENSG00000178971","ENSG00000178971","CTC1","17",8224815,8248058,23243
"2185","ENSG00000102974","ENSG00000102974","CTCF","16",67562467,67639177,76710
"2186","ENSG00000175826","ENSG00000175826","CTDNEP1","17",7243591,7252491,8900
"2187","ENSG00000060069","ENSG00000060069","CTDP1","18",79679803,79754503,74700
"2188","ENSG00000144579","ENSG00000144579","CTDSP1","2",218397136,218405941,8805
"2189","ENSG00000175215","ENSG00000175215","CTDSP2","12",57819927,57846729,26802
"2190","ENSG00000144677","ENSG00000144677","CTDSPL","3",37861880,37984469,122589
"2191","ENSG00000150281","ENSG00000150281","CTF1","16",30896614,30903547,6933
"2192","ENSG00000116761","ENSG00000116761","CTH","1",70411218,70439851,28633
"2193","ENSG00000134030","ENSG00000134030","CTIF","18",48539031,48863217,324186
"2194","ENSG00000163599","ENSG00000163599","CTLA4","2",203853888,203873965,20077
"2195","ENSG00000044115","ENSG00000044115","CTNNA1","5",138610967,138935034,324067
"2196","ENSG00000066032","ENSG00000066032","CTNNA2","2",79185231,80648861,1463630
"2197","ENSG00000183230","ENSG00000183230","CTNNA3","10",65912457,67763637,1851180
"2198","ENSG00000119326","ENSG00000119326","CTNNAL1","9",108942569,109013522,70953
"2199","ENSG00000168036","ENSG00000168036","CTNNB1","3",41194741,41260096,65355
"2200","ENSG00000178585","ENSG00000178585","CTNNBIP1","1",9848276,9910336,62060
"2201","ENSG00000132792","ENSG00000132792","CTNNBL1","20",37694030,37872129,178099
"2202","ENSG00000198561","ENSG00000198561","CTNND1","11",57753243,57819546,66303
"2203","ENSG00000169862","ENSG00000169862","CTNND2","5",10971836,11904446,932610
"2204","ENSG00000040531","ENSG00000040531","CTNS","17",3636459,3663103,26644
"2205","ENSG00000171793","ENSG00000171793","CTPS1","1",40979300,41012565,33265
"2206","ENSG00000047230","ENSG00000047230","CTPS2","X",16587999,16712936,124937
"2207","ENSG00000198730","ENSG00000198730","CTR9","11",10751018,10801625,50607
"2208","ENSG00000168925","ENSG00000168925","CTRB1","16",75218988,75226338,7350
"2209","ENSG00000168928","ENSG00000168928","CTRB2","16",75204103,75207161,3058
"2210","ENSG00000162438","ENSG00000162438","CTRC","1",15438442,15449242,10800
"2211","ENSG00000141086","ENSG00000141086","CTRL","16",67927640,67932365,4725
"2212","ENSG00000064601","ENSG00000064601","CTSA","20",45890144,45898949,8805
"2213","ENSG00000164733","ENSG00000164733","CTSB","8",11842524,11869533,27009
"2214","ENSG00000109861","ENSG00000109861","CTSC","11",88265069,88359684,94615
"2215","ENSG00000117984","ENSG00000117984","CTSD","11",1752752,1764573,11821
"2216","ENSG00000196188","ENSG00000196188","CTSE","1",206008535,206023909,15374
"2217","ENSG00000174080","ENSG00000174080","CTSF","11",66563464,66568879,5415
"2218","ENSG00000100448","ENSG00000100448","CTSG","14",24573518,24576250,2732
"2219","ENSG00000103811","ENSG00000103811","CTSH","15",78921058,78949574,28516
"2220","ENSG00000143387","ENSG00000143387","CTSK","1",150794880,150809577,14697
"2221","ENSG00000135047","ENSG00000135047","CTSL","9",87724051,87731469,7418
"2222","ENSG00000263238","ENSG00000263238","CTSO","HSCHR4_1_CTG12",88741,118534,29793
"2223","ENSG00000163131","ENSG00000163131","CTSS","1",150730079,150765957,35878
"2224","ENSG00000136943","ENSG00000136943","CTSV","9",97029677,97156556,126879
"2225","ENSG00000172543","ENSG00000172543","CTSW","11",65879809,65883741,3932
"2226","ENSG00000101160","ENSG00000101160","CTSZ","20",58985686,59008238,22552
"2227","ENSG00000085733","ENSG00000085733","CTTN","11",70398404,70436584,38180
"2228","ENSG00000107611","ENSG00000107611","CUBN","10",16823966,17129811,305845
"2229","ENSG00000107874","ENSG00000107874","CUEDC2","10",102423245,102432584,9339
"2230","ENSG00000055130","ENSG00000055130","CUL1","7",148697914,148801110,103196
"2231","ENSG00000108094","ENSG00000108094","CUL2","10",35008504,35127006,118502
"2232","ENSG00000036257","ENSG00000036257","CUL3","2",224470150,224585397,115247
"2233","ENSG00000139842","ENSG00000139842","CUL4A","13",113208193,113267108,58915
"2234","ENSG00000158290","ENSG00000158290","CUL4B","X",120505920,120604074,98154
"2235","ENSG00000166266","ENSG00000166266","CUL5","11",108008898,108107761,98863
"2236","ENSG00000044090","ENSG00000044090","CUL7","6",43037617,43053943,16326
"2237","ENSG00000226492","ENSG00000226492","CUTA","HSCHR6_MHC_SSTO_CTG1",4865167,4867042,1875
"2238","ENSG00000119929","ENSG00000119929","CUTC","10",99702558,99756134,53576
"2239","ENSG00000257923","ENSG00000257923","CUX1","7",101815904,102283958,468054
"2240","ENSG00000111249","ENSG00000111249","CUX2","12",111034165,111350554,316389
"2241","ENSG00000138161","ENSG00000138161","CUZD1","10",122832158,122846175,14017
"2242","ENSG00000276761","ENSG00000276761","CWC25","HSCHR17_7_CTG4",2835753,2860800,25047
"2243","ENSG00000095485","ENSG00000095485","CWF19L1","10",100232298,100267680,35382
"2244","ENSG00000109182","ENSG00000109182","CWH43","4",48986275,49062081,75806
"2245","ENSG00000006210","ENSG00000006210","CX3CL1","16",57372477,57385044,12567
"2246","ENSG00000168329","ENSG00000168329","CX3CR1","3",39263495,39281735,18240
"2247","ENSG00000154639","ENSG00000154639","CXADR","21",17513043,17593579,80536
"2248","ENSG00000163739","ENSG00000163739","CXCL1","4",73869393,73871308,1915
"2249","ENSG00000169245","ENSG00000169245","CXCL10","4",76021118,76023497,2379
"2250","ENSG00000169248","ENSG00000169248","CXCL11","4",76033682,76041415,7733
"2251","ENSG00000107562","ENSG00000107562","CXCL12","10",44370165,44386493,16328
"2252","ENSG00000156234","ENSG00000156234","CXCL13","4",77511753,77611834,100081
"2253","ENSG00000145824","ENSG00000145824","CXCL14","5",135570679,135579279,8600
"2254","ENSG00000081041","ENSG00000081041","CXCL2","4",74097040,74099196,2156
"2255","ENSG00000163734","ENSG00000163734","CXCL3","4",74036589,74038807,2218
"2256","ENSG00000163735","ENSG00000163735","CXCL5","4",73995642,73998677,3035
"2257","ENSG00000124875","ENSG00000124875","CXCL6","4",73836640,73849064,12424
"2258","ENSG00000169429","ENSG00000169429","CXCL8","4",73740519,73743716,3197
"2259","ENSG00000138755","ENSG00000138755","CXCL9","4",76001275,76007509,6234
"2260","ENSG00000163464","ENSG00000163464","CXCR1","2",218162841,218166962,4121
"2261","ENSG00000180871","ENSG00000180871","CXCR2","2",218125289,218137251,11962
"2262","ENSG00000186810","ENSG00000186810","CXCR3","X",71615916,71618511,2595
"2263","ENSG00000121966","ENSG00000121966","CXCR4","2",136114349,136119177,4828
"2264","ENSG00000160683","ENSG00000160683","CXCR5","11",118883892,118897787,13895
"2265","ENSG00000172215","ENSG00000172215","CXCR6","3",45940933,45948351,7418
"2266","ENSG00000154832","ENSG00000154832","CXXC1","18",50282343,50287839,5496
"2267","ENSG00000168772","ENSG00000168772","CXXC4","4",104468308,104494901,26593
"2268","ENSG00000008283","ENSG00000008283","CYB561","17",63432304,63446354,14050
"2269","ENSG00000114395","ENSG00000114395","CYB561D2","3",50350845,50358460,7615
"2270","ENSG00000166347","ENSG00000166347","CYB5A","18",74250846,74291973,41127
"2271","ENSG00000103018","ENSG00000103018","CYB5B","16",69398402,69466264,67862
"2272","ENSG00000159348","ENSG00000159348","CYB5R1","1",202961873,202967275,5402
"2273","ENSG00000166394","ENSG00000166394","CYB5R2","11",7665100,7677222,12122
"2274","ENSG00000100243","ENSG00000100243","CYB5R3","22",42615730,42720870,105140
"2275","ENSG00000065615","ENSG00000065615","CYB5R4","6",83859656,83967423,107767
"2276","ENSG00000051523","ENSG00000051523","CYBA","16",88643275,88651083,7808
"2277","ENSG00000165168","ENSG00000165168","CYBB","X",37780018,37813461,33443
"2278","ENSG00000071967","ENSG00000071967","CYBRD1","2",171522247,171558129,35882
"2279","ENSG00000179091","ENSG00000179091","CYC1","8",144095039,144097525,2486
"2280","ENSG00000273749","ENSG00000273749","CYFIP1","15",22867052,22981063,114011
"2281","ENSG00000055163","ENSG00000055163","CYFIP2","5",157266079,157395595,129516
"2282","ENSG00000155833","ENSG00000155833","CYLC2","9",102995311,103018488,23177
"2283","ENSG00000083799","ENSG00000083799","CYLD","16",50742050,50801935,59885
"2284","ENSG00000140459","ENSG00000140459","CYP11A1","15",74337759,74367646,29887
"2285","ENSG00000160882","ENSG00000160882","CYP11B1","8",142872356,142879846,7490
"2286","ENSG00000148795","ENSG00000148795","CYP17A1","10",102830531,102837472,6941
"2287","ENSG00000137869","ENSG00000137869","CYP19A1","15",51208057,51338601,130544
"2288","ENSG00000140465","ENSG00000140465","CYP1A1","15",74719542,74725536,5994
"2289","ENSG00000140505","ENSG00000140505","CYP1A2","15",74748845,74756607,7762
"2290","ENSG00000138061","ENSG00000138061","CYP1B1","2",38066973,38109902,42929
"2291","ENSG00000119004","ENSG00000119004","CYP20A1","2",203238977,203306026,67049
"2292","ENSG00000232414","ENSG00000232414","CYP21A2","HSCHR6_MHC_DBB_CTG1",3279706,3283078,3372
"2293","ENSG00000019186","ENSG00000019186","CYP24A1","20",54153446,54173986,20540
"2294","ENSG00000095596","ENSG00000095596","CYP26A1","10",93073475,93077885,4410
"2295","ENSG00000003137","ENSG00000003137","CYP26B1","2",72129238,72147862,18624
"2296","ENSG00000135929","ENSG00000135929","CYP27A1","2",218781749,218815293,33544
"2297","ENSG00000111012","ENSG00000111012","CYP27B1","12",57762334,57768986,6652
"2298","ENSG00000255974","ENSG00000255974","CYP2A6","19",40843541,40850447,6906
"2299","ENSG00000198077","ENSG00000198077","CYP2A7","19",40875439,40882752,7313
"2300","ENSG00000197408","ENSG00000197408","CYP2B6","19",40991282,41018398,27116
"2301","ENSG00000108242","ENSG00000108242","CYP2C18","10",94683729,94736190,52461
"2302","ENSG00000138115","ENSG00000138115","CYP2C8","10",95036772,95069497,32725
"2303","ENSG00000138109","ENSG00000138109","CYP2C9","10",94938658,94990091,51433
"2304","ENSG00000280905","ENSG00000280905","CYP2D6","HSCHR22_5_CTG1",12065,16431,4366
"2305","ENSG00000130649","ENSG00000130649","CYP2E1","10",133520406,133561220,40814
"2306","ENSG00000197446","ENSG00000197446","CYP2F1","19",41114432,41128381,13949
"2307","ENSG00000134716","ENSG00000134716","CYP2J2","1",59893308,59926773,33465
"2308","ENSG00000186104","ENSG00000186104","CYP2R1","11",14877440,14892231,14791
"2309","ENSG00000155016","ENSG00000155016","CYP2U1","4",107931549,107953461,21912
"2310","ENSG00000073067","ENSG00000073067","CYP2W1","7",983181,989640,6459
"2311","ENSG00000146233","ENSG00000146233","CYP39A1","6",46549580,46652830,103250
"2312","ENSG00000160868","ENSG00000160868","CYP3A4","7",99756960,99784248,27288
"2313","ENSG00000021461","ENSG00000021461","CYP3A43","7",99828013,99866093,38080
"2314","ENSG00000106258","ENSG00000106258","CYP3A5","7",99648194,99679996,31802
"2315","ENSG00000160870","ENSG00000160870","CYP3A7","7",99705036,99735196,30160
"2316","ENSG00000036530","ENSG00000036530","CYP46A1","14",99684298,99727301,43003
"2317","ENSG00000187048","ENSG00000187048","CYP4A11","1",46929177,46941484,12307
"2318","ENSG00000142973","ENSG00000142973","CYP4B1","1",46757838,46819413,61575
"2319","ENSG00000171903","ENSG00000171903","CYP4F11","19",15912367,15934867,22500
"2320","ENSG00000186204","ENSG00000186204","CYP4F12","19",15673018,15697174,24156
"2321","ENSG00000186115","ENSG00000186115","CYP4F2","19",15878023,15898077,20054
"2322","ENSG00000186529","ENSG00000186529","CYP4F3","19",15640897,15662825,21928
"2323","ENSG00000186526","ENSG00000186526","CYP4F8","19",15615218,15630639,15421
"2324","ENSG00000001630","ENSG00000001630","CYP51A1","7",92084987,92134803,49816
"2325","ENSG00000167910","ENSG00000167910","CYP7A1","8",58490178,58500163,9985
"2326","ENSG00000172817","ENSG00000172817","CYP7B1","8",64587763,64798737,210974
"2327","ENSG00000173198","ENSG00000173198","CYSLTR1","X",78271468,78327691,56223
"2328","ENSG00000152207","ENSG00000152207","CYSLTR2","13",48653711,48711226,57515
"2329","ENSG00000108669","ENSG00000108669","CYTH1","17",78674048,78782297,108249
"2330","ENSG00000105443","ENSG00000105443","CYTH2","19",48469208,48482314,13106
"2331","ENSG00000008256","ENSG00000008256","CYTH3","7",6161779,6272644,110865
"2332","ENSG00000100055","ENSG00000100055","CYTH4","22",37282027,37315341,33314
"2333","ENSG00000115165","ENSG00000115165","CYTIP","2",157414619,157488961,74342
"2334","ENSG00000170891","ENSG00000170891","CYTL1","4",5014586,5019458,4872
"2335","ENSG00000100592","ENSG00000100592","DAAM1","14",59188646,59371405,182759
"2336","ENSG00000146122","ENSG00000146122","DAAM2","6",39792298,39904877,112579
"2337","ENSG00000173406","ENSG00000173406","DAB1","1",56994778,58546734,1551956
"2338","ENSG00000153071","ENSG00000153071","DAB2","5",39371675,39462300,90625
"2339","ENSG00000276644","ENSG00000276644","DACH1","13",71437966,71867204,429238
"2340","ENSG00000165617","ENSG00000165617","DACT1","14",58633967,58648321,14354
"2341","ENSG00000129562","ENSG00000129562","DAD1","14",22564907,22589224,24317
"2342","ENSG00000173402","ENSG00000173402","DAG1","3",49468713,49535618,66905
"2343","ENSG00000134780","ENSG00000134780","DAGLA","11",61680391,61747001,66610
"2344","ENSG00000178149","ENSG00000178149","DALRD3","3",49015488,49022293,6805
"2345","ENSG00000110887","ENSG00000110887","DAO","12",108858932,108901043,42111
"2346","ENSG00000112977","ENSG00000112977","DAP","5",10679230,10761234,82004
"2347","ENSG00000132676","ENSG00000132676","DAP3","1",155687960,155739010,51050
"2348","ENSG00000196730","ENSG00000196730","DAPK1","9",87497228,87708634,211406
"2349","ENSG00000035664","ENSG00000035664","DAPK2","15",63907036,64072033,164997
"2350","ENSG00000167657","ENSG00000167657","DAPK3","19",3958453,3971123,12670
"2351","ENSG00000070190","ENSG00000070190","DAPP1","4",99816827,99870190,53363
"2352","ENSG00000117593","ENSG00000117593","DARS2","1",173824653,173858808,34155
"2353","ENSG00000231617","ENSG00000231617","DAXX","HSCHR6_MHC_MCF_CTG1",4754493,4765202,10709
"2354","ENSG00000188120","ENSG00000188120","DAZ1","Y",23129355,23199010,69655
"2355","ENSG00000071626","ENSG00000071626","DAZAP1","19",1407569,1435687,28118
"2356","ENSG00000183283","ENSG00000183283","DAZAP2","12",51238724,51271362,32638
"2357","ENSG00000092345","ENSG00000092345","DAZL","3",16586792,16670306,83514
"2358","ENSG00000006634","ENSG00000006634","DBF4","7",87876216,87909553,33337
"2359","ENSG00000161692","ENSG00000161692","DBF4B","17",44708608,44752264,43656
"2360","ENSG00000123454","ENSG00000123454","DBH","9",133636363,133659329,22966
"2361","ENSG00000155368","ENSG00000155368","DBI","2",119366924,119372550,5626
"2362","ENSG00000113758","ENSG00000113758","DBN1","5",177456608,177474401,17793
"2363","ENSG00000003249","ENSG00000003249","DBNDD1","16",90004871,90019890,15019
"2364","ENSG00000244274","ENSG00000244274","DBNDD2","20",45406057,45410610,4553
"2365","ENSG00000105516","ENSG00000105516","DBP","19",48630030,48637379,7349
"2366","ENSG00000138231","ENSG00000138231","DBR1","3",138160988,138174949,13961
"2367","ENSG00000137992","ENSG00000137992","DBT","1",100186919,100249834,62915
"2368","ENSG00000145041","ENSG00000145041","DCAF1","3",51395867,51500015,104148
"2369","ENSG00000122741","ENSG00000122741","DCAF10","9",37800554,37867666,67112
"2370","ENSG00000100897","ENSG00000100897","DCAF11","14",24114195,24125242,11047
"2371","ENSG00000164934","ENSG00000164934","DCAF13","8",103414714,103443453,28739
"2372","ENSG00000132017","ENSG00000132017","DCAF15","19",13952509,13961449,8940
"2373","ENSG00000163257","ENSG00000163257","DCAF16","4",17800655,17810758,10103
"2374","ENSG00000115827","ENSG00000115827","DCAF17","2",171434217,171485052,50835
"2375","ENSG00000119599","ENSG00000119599","DCAF4","14",72926377,72959703,33326
"2376","ENSG00000143164","ENSG00000143164","DCAF6","1",167935783,168075843,140060
"2377","ENSG00000136485","ENSG00000136485","DCAF7","17",63550222,63594286,44064
"2378","ENSG00000132716","ENSG00000132716","DCAF8","1",160215715,160262549,46834
"2379","ENSG00000172992","ENSG00000172992","DCAKD","17",45023338,45061131,37793
"2380","ENSG00000057019","ENSG00000057019","DCBLD2","3",98795941,98901695,105754
"2381","ENSG00000187323","ENSG00000187323","DCC","18",52340197,53535899,1195702
"2382","ENSG00000166341","ENSG00000166341","DCHS1","11",6621330,6655809,34479
"2383","ENSG00000197410","ENSG00000197410","DCHS2","4",154231742,154491799,260057
"2384","ENSG00000156136","ENSG00000156136","DCK","4",70992538,71030914,38376
"2385","ENSG00000133083","ENSG00000133083","DCLK1","13",35768652,36131382,362730
"2386","ENSG00000170390","ENSG00000170390","DCLK2","4",150078445,150257438,178993
"2387","ENSG00000198924","ENSG00000198924","DCLRE1A","10",113834725,113854383,19658
"2388","ENSG00000118655","ENSG00000118655","DCLRE1B","1",113904619,113914086,9467
"2389","ENSG00000152457","ENSG00000152457","DCLRE1C","10",14897359,14954432,57073
"2390","ENSG00000011465","ENSG00000011465","DCN","12",91140484,91183217,42733
"2391","ENSG00000272886","ENSG00000272886","DCP1A","3",53283429,53347586,64157
"2392","ENSG00000110063","ENSG00000110063","DCPS","11",126304060,126350005,45945
"2393","ENSG00000080166","ENSG00000080166","DCT","13",94436811,94479682,42871
"2394","ENSG00000129187","ENSG00000129187","DCTD","4",182890060,182917936,27876
"2395","ENSG00000204843","ENSG00000204843","DCTN1","2",74361154,74392087,30933
"2396","ENSG00000175203","ENSG00000175203","DCTN2","12",57529633,57547224,17591
"2397","ENSG00000137100","ENSG00000137100","DCTN3","9",34613545,34620523,6978
"2398","ENSG00000132912","ENSG00000132912","DCTN4","5",150708440,150759095,50655
"2399","ENSG00000166847","ENSG00000166847","DCTN5","16",23641466,23677472,36006
"2400","ENSG00000104671","ENSG00000104671","DCTN6","8",30156319,30183639,27320
"2401","ENSG00000179958","ENSG00000179958","DCTPP1","16",30423615,30430030,6415
"2402","ENSG00000150401","ENSG00000150401","DCUN1D2","13",113455819,113490951,35132
"2403","ENSG00000109184","ENSG00000109184","DCUN1D4","4",51843000,51916837,73837
"2404","ENSG00000077279","ENSG00000077279","DCX","X",111293779,111412429,118650
"2405","ENSG00000169738","ENSG00000169738","DCXR","17",82035136,82037709,2573
"2406","ENSG00000130311","ENSG00000130311","DDA1","19",17309518,17323298,13780
"2407","ENSG00000153904","ENSG00000153904","DDAH1","1",85318481,85578363,259882
"2408","ENSG00000233076","ENSG00000233076","DDAH2","HSCHR6_MHC_MANN_CTG1",3032085,3035664,3579
"2409","ENSG00000167986","ENSG00000167986","DDB1","11",61299451,61342596,43145
"2410","ENSG00000134574","ENSG00000134574","DDB2","11",47214465,47239217,24752
"2411","ENSG00000132437","ENSG00000132437","DDC","7",50458436,50565405,106969
"2412","ENSG00000085788","ENSG00000085788","DDHD2","8",38225218,38275558,50340
"2413","ENSG00000197312","ENSG00000197312","DDI2","1",15617458,15669044,51586
"2414","ENSG00000175197","ENSG00000175197","DDIT3","12",57516588,57521737,5149
"2415","ENSG00000168209","ENSG00000168209","DDIT4","10",72273919,72276036,2117
"2416","ENSG00000181418","ENSG00000181418","DDN","12",48995149,48999375,4226
"2417","ENSG00000203797","ENSG00000203797","DDO","6",110391771,110415575,23804
"2418","ENSG00000244038","ENSG00000244038","DDOST","1",20651767,20661544,9777
"2419","ENSG00000223680","ENSG00000223680","DDR1","HSCHR6_MHC_MCF_CTG1",2225124,2236239,11115
"2420","ENSG00000162733","ENSG00000162733","DDR2","1",162631373,162787405,156032
"2421","ENSG00000198171","ENSG00000198171","DDRGK1","20",3190350,3204685,14335
"2422","ENSG00000275003","ENSG00000275003","DDT","HSCHR22_1_CTG7",207729,216835,9106
"2423","ENSG00000275758","ENSG00000275758","DDTL","HSCHR22_1_CTG7",203264,208896,5632
"2424","ENSG00000079785","ENSG00000079785","DDX1","2",15591178,15634346,43168
"2425","ENSG00000178105","ENSG00000178105","DDX10","11",108665058,108940999,275941
"2426","ENSG00000013573","ENSG00000013573","DDX11","12",31073860,31104799,30939
"2427","ENSG00000100201","ENSG00000100201","DDX17","22",38483438,38507660,24222
"2428","ENSG00000088205","ENSG00000088205","DDX18","2",117814691,117832377,17686
"2429","ENSG00000168872","ENSG00000168872","DDX19A","16",70346861,70373383,26522
"2430","ENSG00000157349","ENSG00000157349","DDX19B","16",70289663,70335305,45642
"2431","ENSG00000165732","ENSG00000165732","DDX21","10",68956135,68985068,28933
"2432","ENSG00000174243","ENSG00000174243","DDX23","12",48829756,48852842,23086
"2433","ENSG00000273761","ENSG00000273761","DDX24","HSCHR14_7_CTG1",1165482,1195807,30325
"2434","ENSG00000109832","ENSG00000109832","DDX25","11",125903348,125943702,40354
"2435","ENSG00000124228","ENSG00000124228","DDX27","20",49219347,49244077,24730
"2436","ENSG00000182810","ENSG00000182810","DDX28","16",68020916,68023232,2316
"2437","ENSG00000125485","ENSG00000125485","DDX31","9",132592997,132670401,77404
"2438","ENSG00000123136","ENSG00000123136","DDX39A","19",14408798,14419383,10585
"2439","ENSG00000237889","ENSG00000237889","DDX39B","HSCHR6_MHC_APD_CTG1",2862768,2871733,8965
"2440","ENSG00000215301","ENSG00000215301","DDX3X","X",41333348,41364472,31124
"2441","ENSG00000067048","ENSG00000067048","DDX3Y","Y",12904108,12920478,16370
"2442","ENSG00000152670","ENSG00000152670","DDX4","5",55738017,55817157,79140
"2443","ENSG00000183258","ENSG00000183258","DDX41","5",177511577,177516961,5384
"2444","ENSG00000198231","ENSG00000198231","DDX42","17",63773603,63819317,45714
"2445","ENSG00000080007","ENSG00000080007","DDX43","6",73394828,73417566,22738
"2446","ENSG00000145833","ENSG00000145833","DDX46","5",134758771,134855133,96362
"2447","ENSG00000213782","ENSG00000213782","DDX47","12",12813316,12829981,16665
"2448","ENSG00000105671","ENSG00000105671","DDX49","19",18919705,18929189,9484
"2449","ENSG00000108654","ENSG00000108654","DDX5","17",64498254,64508199,9945
"2450","ENSG00000107625","ENSG00000107625","DDX50","10",68901286,68946847,45561
"2451","ENSG00000185163","ENSG00000185163","DDX51","12",132136594,132144319,7725
"2452","ENSG00000278053","ENSG00000278053","DDX52","17",37609739,37643446,33707
"2453","ENSG00000123064","ENSG00000123064","DDX54","12",113157173,113185479,28306
"2454","ENSG00000136271","ENSG00000136271","DDX56","7",44565804,44575051,9247
"2455","ENSG00000110367","ENSG00000110367","DDX6","11",118747763,118791164,43401
"2456","ENSG00000137628","ENSG00000137628","DDX60","4",168216291,168318883,102592
"2457","ENSG00000282712","ENSG00000282712","DEAF1","HSCHR11_1_CTG8",176113,206708,30595
"2458","ENSG00000104325","ENSG00000104325","DECR1","8",90001405,90053633,52228
"2459","ENSG00000274296","ENSG00000274296","DECR2","HSCHR16_CTG2",972,11633,10661
"2460","ENSG00000158796","ENSG00000158796","DEDD","1",161120974,161132688,11714
"2461","ENSG00000023892","ENSG00000023892","DEF6","6",35297818,35321771,23953
"2462","ENSG00000140995","ENSG00000140995","DEF8","16",89948697,89968060,19363
"2463","ENSG00000164821","ENSG00000164821","DEFA4","8",6935820,6938306,2486
"2464","ENSG00000164825","ENSG00000164825","DEFB1","8",6870592,6877936,7344
"2465","ENSG00000171711","ENSG00000171711","DEFB4A","8",7894677,7896716,2039
"2466","ENSG00000143753","ENSG00000143753","DEGS1","1",224175756,224193441,17685
"2467","ENSG00000124795","ENSG00000124795","DEK","6",18223860,18264548,40688
"2468","ENSG00000119522","ENSG00000119522","DENND1A","9",123379654,123930152,550498
"2469","ENSG00000213047","ENSG00000213047","DENND1B","1",197504748,197775696,270948
"2470","ENSG00000205744","ENSG00000205744","DENND1C","19",6467207,6482557,15350
"2471","ENSG00000146966","ENSG00000146966","DENND2A","7",140518420,140673993,155573
"2472","ENSG00000162777","ENSG00000162777","DENND2D","1",111185969,111204535,18566
"2473","ENSG00000105339","ENSG00000105339","DENND3","8",141117278,141195808,78530
"2474","ENSG00000174485","ENSG00000174485","DENND4A","15",65658046,65792293,134247
"2475","ENSG00000198837","ENSG00000198837","DENND4B","1",153929501,153946718,17217
"2476","ENSG00000137145","ENSG00000137145","DENND4C","9",19230435,19374281,143846
"2477","ENSG00000184014","ENSG00000184014","DENND5A","11",9138825,9265959,127134
"2478","ENSG00000170456","ENSG00000170456","DENND5B","12",31382226,31591136,208910
"2479","ENSG00000139726","ENSG00000139726","DENR","12",122752824,122771064,18240
"2480","ENSG00000024526","ENSG00000024526","DEPDC1","1",68474152,68497221,23069
"2481","ENSG00000100150","ENSG00000100150","DEPDC5","22",31753867,31908033,154166
"2482","ENSG00000155792","ENSG00000155792","DEPTOR","8",119873717,120050918,177201
"2483","ENSG00000023697","ENSG00000023697","DERA","12",15911302,16037381,126079
"2484","ENSG00000136986","ENSG00000136986","DERL1","8",123013170,123042302,29132
"2485","ENSG00000072849","ENSG00000072849","DERL2","17",5471254,5486811,15557
"2486","ENSG00000175084","ENSG00000175084","DES","2",219418377,219426735,8358
"2487","ENSG00000100418","ENSG00000100418","DESI1","22",41598028,41621043,23015
"2488","ENSG00000121644","ENSG00000121644","DESI2","1",244653103,244709033,55930
"2489","ENSG00000140543","ENSG00000140543","DET1","15",88494440,88546681,52241
"2490","ENSG00000182108","ENSG00000182108","DEXI","16",10928891,10942468,13577
"2491","ENSG00000160049","ENSG00000160049","DFFA","1",10456522,10472529,16007
"2492","ENSG00000169598","ENSG00000169598","DFFB","1",3857267,3885429,28162
"2493","ENSG00000185000","ENSG00000185000","DGAT1","8",144314584,144326910,12326
"2494","ENSG00000070413","ENSG00000070413","DGCR2","22",19036282,19122454,86172
"2495","ENSG00000273032","ENSG00000273032","DGCR5","22",18970439,19031242,60803
"2496","ENSG00000183628","ENSG00000183628","DGCR6","22",18906028,18914238,8210
"2497","ENSG00000128185","ENSG00000128185","DGCR6L","22",20314238,20320080,5842
"2498","ENSG00000128191","ENSG00000128191","DGCR8","22",20080221,20111877,31656
"2499","ENSG00000065357","ENSG00000065357","DGKA","12",55927319,55954027,26708
"2500","ENSG00000077044","ENSG00000077044","DGKD","2",233354494,233472104,117610
"2501","ENSG00000153933","ENSG00000153933","DGKE","17",56834107,56869567,35460
"2502","ENSG00000058866","ENSG00000058866","DGKG","3",186105668,186362234,256566
"2503","ENSG00000102780","ENSG00000102780","DGKH","13",42040036,42256578,216542
"2504","ENSG00000157680","ENSG00000157680","DGKI","7",137381037,137847092,466055
"2505","ENSG00000145214","ENSG00000145214","DGKQ","4",958887,986895,28008
"2506","ENSG00000149091","ENSG00000149091","DGKZ","11",46332905,46380554,47649
"2507","ENSG00000114956","ENSG00000114956","DGUOK","2",73926826,73958961,32135
"2508","ENSG00000116133","ENSG00000116133","DHCR24","1",54849627,54887195,37568
"2509","ENSG00000172893","ENSG00000172893","DHCR7","11",71428193,71452868,24675
"2510","ENSG00000117682","ENSG00000117682","DHDDS","1",26432282,26471306,39024
"2511","ENSG00000228716","ENSG00000228716","DHFR","5",80626226,80654983,28757
"2512","ENSG00000102967","ENSG00000102967","DHODH","16",72008588,72027664,19076
"2513","ENSG00000095059","ENSG00000095059","DHPS","19",12675717,12681880,6163
"2514","ENSG00000157379","ENSG00000157379","DHRS1","14",24290598,24299780,9182
"2515","ENSG00000278535","ENSG00000278535","DHRS11","17",36591879,36600804,8925
"2516","ENSG00000102796","ENSG00000102796","DHRS12","13",51767993,51804163,36170
"2517","ENSG00000100867","ENSG00000100867","DHRS2","14",23630115,23645639,15524
"2518","ENSG00000162496","ENSG00000162496","DHRS3","1",12567909,12620133,52224
"2519","ENSG00000157326","ENSG00000157326","DHRS4","14",23953734,23969279,15545
"2520","ENSG00000187630","ENSG00000187630","DHRS4L2","14",23969874,24006408,36534
"2521","ENSG00000100612","ENSG00000100612","DHRS7","14",60144119,60169856,25737
"2522","ENSG00000109016","ENSG00000109016","DHRS7B","17",21123364,21193265,69901
"2523","ENSG00000073737","ENSG00000073737","DHRS9","2",169064789,169096167,31378
"2524","ENSG00000181192","ENSG00000181192","DHTKD1","10",12068954,12123221,54267
"2525","ENSG00000109606","ENSG00000109606","DHX15","4",24517441,24584554,67113
"2526","ENSG00000233561","ENSG00000233561","DHX16","HSCHR6_MHC_COX_CTG1",2132833,2152781,19948
"2527","ENSG00000067248","ENSG00000067248","DHX29","5",55256055,55307694,51639
"2528","ENSG00000132153","ENSG00000132153","DHX30","3",47802909,47850195,47286
"2529","ENSG00000089876","ENSG00000089876","DHX32","10",125836337,125896436,60099
"2530","ENSG00000134815","ENSG00000134815","DHX34","19",47349315,47382704,33389
"2531","ENSG00000101452","ENSG00000101452","DHX35","20",38962299,39039723,77424
"2532","ENSG00000140829","ENSG00000140829","DHX38","16",72093613,72112912,19299
"2533","ENSG00000108406","ENSG00000108406","DHX40","17",59565558,59608345,42787
"2534","ENSG00000163214","ENSG00000163214","DHX57","2",38797729,38875934,78205
"2535","ENSG00000108771","ENSG00000108771","DHX58","17",42101404,42112714,11310
"2536","ENSG00000067596","ENSG00000067596","DHX8","17",43483865,43610338,126473
"2537","ENSG00000135829","ENSG00000135829","DHX9","1",182839347,182887982,48635
"2538","ENSG00000184047","ENSG00000184047","DIABLO","12",122207668,122226062,18394
"2539","ENSG00000131504","ENSG00000131504","DIAPH1","5",141515016,141619055,104039
"2540","ENSG00000147202","ENSG00000147202","DIAPH2","X",96684712,97604997,920285
"2541","ENSG00000139734","ENSG00000139734","DIAPH3","13",59665583,60163928,498345
"2542","ENSG00000100697","ENSG00000100697","DICER1","14",95086228,95158010,71782
"2543","ENSG00000101191","ENSG00000101191","DIDO1","20",62877738,62937952,60214
"2544","ENSG00000086189","ENSG00000086189","DIMT1","5",62347284,62403943,56659
"2545","ENSG00000211452","ENSG00000211452","DIO1","1",53891239,53911086,19847
"2546","ENSG00000211448","ENSG00000211448","DIO2","14",80197526,80387757,190231
"2547","ENSG00000197406","ENSG00000197406","DIO3","14",101560139,101563452,3313
"2548","ENSG00000160305","ENSG00000160305","DIP2A","21",46458891,46570015,111124
"2549","ENSG00000151240","ENSG00000151240","DIP2C","10",274201,689668,415467
"2550","ENSG00000165023","ENSG00000165023","DIRAS2","9",90609832,90642862,33030
"2551","ENSG00000162595","ENSG00000162595","DIRAS3","1",68045886,68051717,5831
"2552","ENSG00000083520","ENSG00000083520","DIS3","13",72752169,72782096,29927
"2553","ENSG00000162946","ENSG00000162946","DISC1","1",231626790,232041272,414482
"2554","ENSG00000150764","ENSG00000150764","DIXDC1","11",111927144,112022653,95509
"2555","ENSG00000130826","ENSG00000130826","DKC1","X",154762742,154777689,14947
"2556","ENSG00000107984","ENSG00000107984","DKK1","10",52314281,52318042,3761
"2557","ENSG00000155011","ENSG00000155011","DKK2","4",106921802,107283806,362004
"2558","ENSG00000050165","ENSG00000050165","DKK3","11",11956207,12009769,53562
"2559","ENSG00000104371","ENSG00000104371","DKK4","8",42374063,42377229,3166
"2560","ENSG00000104901","ENSG00000104901","DKKL1","19",49361783,49375116,13333
"2561","ENSG00000150768","ENSG00000150768","DLAT","11",112025033,112064404,39371
"2562","ENSG00000164741","ENSG00000164741","DLC1","8",13083361,13604610,521249
"2563","ENSG00000091140","ENSG00000091140","DLD","7",107891162,107931730,40568
"2564","ENSG00000008226","ENSG00000008226","DLEC1","3",38039205,38124025,84820
"2565","ENSG00000075711","ENSG00000075711","DLG1","3",197042560,197299330,256770
"2566","ENSG00000150672","ENSG00000150672","DLG2","11",83455012,85628335,2173323
"2567","ENSG00000082458","ENSG00000082458","DLG3","X",70444835,70505490,60655
"2568","ENSG00000132535","ENSG00000132535","DLG4","17",7187187,7219836,32649
"2569","ENSG00000274429","ENSG00000274429","DLG5","HSCHR10_1_CTG4",29483,165218,135735
"2570","ENSG00000170579","ENSG00000170579","DLGAP1","18",3496032,4455307,959275
"2571","ENSG00000282318","ENSG00000282318","DLGAP2","HSCHR8_7_CTG1",40124,121138,81014
"2572","ENSG00000080845","ENSG00000080845","DLGAP4","20",36306336,36528637,222301
"2573","ENSG00000126787","ENSG00000126787","DLGAP5","14",55148112,55191608,43496
"2574","ENSG00000185559","ENSG00000185559","DLK1","14",100725705,100738224,12519
"2575","ENSG00000171462","ENSG00000171462","DLK2","6",43450352,43456632,6280
"2576","ENSG00000090932","ENSG00000090932","DLL3","19",39498895,39508481,9586
"2577","ENSG00000119689","ENSG00000119689","DLST","14",74881891,74903743,21852
"2578","ENSG00000115844","ENSG00000115844","DLX2","2",172099438,172102900,3462
"2579","ENSG00000108813","ENSG00000108813","DLX4","17",49968588,49974959,6371
"2580","ENSG00000105880","ENSG00000105880","DLX5","7",97020396,97024950,4554
"2581","ENSG00000006377","ENSG00000006377","DLX6","7",97005553,97011040,5487
"2582","ENSG00000187908","ENSG00000187908","DMBT1","10",122560665,122643736,83071
"2583","ENSG00000100206","ENSG00000100206","DMC1","22",38518948,38570204,51256
"2584","ENSG00000198947","ENSG00000198947","DMD","X",31097677,33339609,2241932
"2585","ENSG00000152592","ENSG00000152592","DMP1","4",87650280,87664361,14081
"2586","ENSG00000104936","ENSG00000104936","DMPK","19",45769709,45782552,12843
"2587","ENSG00000135164","ENSG00000135164","DMTF1","7",87152409,87196337,43928
"2588","ENSG00000158856","ENSG00000158856","DMTN","8",22048995,22082527,33532
"2589","ENSG00000185800","ENSG00000185800","DMWD","19",45782947,45792845,9898
"2590","ENSG00000172869","ENSG00000172869","DMXL1","5",119037772,119249138,211366
"2591","ENSG00000104093","ENSG00000104093","DMXL2","15",51447711,51622833,175122
"2592","ENSG00000138346","ENSG00000138346","DNA2","10",68414064,68472121,58057
"2593","ENSG00000165506","ENSG00000165506","DNAAF2","14",49625174,49635244,10070
"2594","ENSG00000164818","ENSG00000164818","DNAAF5","7",726699,786475,59776
"2595","ENSG00000183914","ENSG00000183914","DNAH2","17",7717744,7833742,115998
"2596","ENSG00000158486","ENSG00000158486","DNAH3","16",20933111,21159441,226330
"2597","ENSG00000118997","ENSG00000118997","DNAH7","2",195737703,196068837,331134
"2598","ENSG00000007174","ENSG00000007174","DNAH9","17",11598470,11969748,371278
"2599","ENSG00000122735","ENSG00000122735","DNAI1","9",34457414,34520988,63574
"2600","ENSG00000171595","ENSG00000171595","DNAI2","17",74274234,74314884,40650
"2601","ENSG00000086061","ENSG00000086061","DNAJA1","9",33025273,33039907,14634
"2602","ENSG00000069345","ENSG00000069345","DNAJA2","16",46955362,46973674,18312
"2603","ENSG00000276726","ENSG00000276726","DNAJA3","HSCHR16_3_CTG1",128128,159098,30970
"2604","ENSG00000140403","ENSG00000140403","DNAJA4","15",78264086,78282196,18110
"2605","ENSG00000132002","ENSG00000132002","DNAJB1","19",14514769,14560391,45622
"2606","ENSG00000148719","ENSG00000148719","DNAJB12","10",72332830,72355149,22319
"2607","ENSG00000164031","ENSG00000164031","DNAJB14","4",99896248,99946618,50370
"2608","ENSG00000135924","ENSG00000135924","DNAJB2","2",219279342,219286898,7556
"2609","ENSG00000162616","ENSG00000162616","DNAJB4","1",77979175,78017964,38789
"2610","ENSG00000137094","ENSG00000137094","DNAJB5","9",34989641,34998900,9259
"2611","ENSG00000105993","ENSG00000105993","DNAJB6","7",157335381,157417439,82058
"2612","ENSG00000128590","ENSG00000128590","DNAJB9","7",108569867,108574850,4983
"2613","ENSG00000136770","ENSG00000136770","DNAJC1","10",21756548,22003769,247221
"2614","ENSG00000077232","ENSG00000077232","DNAJC10","2",182716255,182794464,78209
"2615","ENSG00000007923","ENSG00000007923","DNAJC11","1",6634168,6701924,67756
"2616","ENSG00000108176","ENSG00000108176","DNAJC12","10",67796669,67838188,41519
"2617","ENSG00000138246","ENSG00000138246","DNAJC13","3",132417502,132539032,121530
"2618","ENSG00000120675","ENSG00000120675","DNAJC15","13",43023203,43114213,91010
"2619","ENSG00000116138","ENSG00000116138","DNAJC16","1",15526813,15592379,65566
"2620","ENSG00000104129","ENSG00000104129","DNAJC17","15",40765161,40807478,42317
"2621","ENSG00000178401","ENSG00000178401","DNAJC22","12",49346888,49357546,10658
"2622","ENSG00000170946","ENSG00000170946","DNAJC24","11",31369840,31432835,62995
"2623","ENSG00000244115","ENSG00000244115","DNAJC25-GNG10","9",111631386,111670229,38843
"2624","ENSG00000262911","ENSG00000262911","DNAJC28","HSCHR21_4_CTG1_1",89659,95850,6191
"2625","ENSG00000102580","ENSG00000102580","DNAJC3","13",95677139,95794988,117849
"2626","ENSG00000110011","ENSG00000110011","DNAJC4","11",64230278,64234286,4008
"2627","ENSG00000116675","ENSG00000116675","DNAJC6","1",65248219,65415871,167652
"2628","ENSG00000168259","ENSG00000168259","DNAJC7","17",41976421,42021376,44955
"2629","ENSG00000126698","ENSG00000126698","DNAJC8","1",28199456,28233029,33573
"2630","ENSG00000213551","ENSG00000213551","DNAJC9","10",73183362,73247255,63893
"2631","ENSG00000100246","ENSG00000100246","DNAL4","22",38778508,38794198,15690
"2632","ENSG00000163879","ENSG00000163879","DNALI1","1",37556919,37566857,9938
"2633","ENSG00000213918","ENSG00000213918","DNASE1","16",3611728,3680143,68415
"2634","ENSG00000013563","ENSG00000013563","DNASE1L1","X",154401236,154412112,10876
"2635","ENSG00000167968","ENSG00000167968","DNASE1L2","16",2235816,2238711,2895
"2636","ENSG00000163687","ENSG00000163687","DNASE1L3","3",58192257,58214697,22440
"2637","ENSG00000105612","ENSG00000105612","DNASE2","19",12875209,12881595,6386
"2638","ENSG00000137976","ENSG00000137976","DNASE2B","1",84398484,84415018,16534
"2639","ENSG00000106976","ENSG00000106976","DNM1","9",128191655,128255248,63593
"2640","ENSG00000087470","ENSG00000087470","DNM1L","12",32679200,32745650,66450
"2641","ENSG00000079805","ENSG00000079805","DNM2","19",10718055,10833488,115433
"2642","ENSG00000197959","ENSG00000197959","DNM3","1",171817887,172418466,600579
"2643","ENSG00000107554","ENSG00000107554","DNMBP","10",99875577,100009947,134370
"2644","ENSG00000130816","ENSG00000130816","DNMT1","19",10133342,10231286,97944
"2645","ENSG00000119772","ENSG00000119772","DNMT3A","2",25227855,25342590,114735
"2646","ENSG00000088305","ENSG00000088305","DNMT3B","20",32762385,32809359,46974
"2647","ENSG00000142182","ENSG00000142182","DNMT3L","21",44246339,44262216,15877
"2648","ENSG00000123992","ENSG00000123992","DNPEP","2",219372043,219400022,27979
"2649","ENSG00000112667","ENSG00000112667","DNPH1","6",43225629,43229481,3852
"2650","ENSG00000107447","ENSG00000107447","DNTT","10",96304409,96338564,34155
"2651","ENSG00000067334","ENSG00000067334","DNTTIP2","1",93866284,93879918,13634
"2652","ENSG00000149927","ENSG00000149927","DOC2A","16",30005514,30023270,17756
"2653","ENSG00000150760","ENSG00000150760","DOCK1","10",126905409,127452517,547108
"2654","ENSG00000135905","ENSG00000135905","DOCK10","2",224765090,225042468,277378
"2655","ENSG00000088538","ENSG00000088538","DOCK3","3",50674927,51384198,709271
"2656","ENSG00000128512","ENSG00000128512","DOCK4","7",111726110,112206407,480297
"2657","ENSG00000147459","ENSG00000147459","DOCK5","8",25184689,25418082,233393
"2658","ENSG00000130158","ENSG00000130158","DOCK6","19",11199295,11262524,63229
"2659","ENSG00000088387","ENSG00000088387","DOCK9","13",98793429,99086625,293196
"2660","ENSG00000129932","ENSG00000129932","DOHH","19",3490821,3500674,9853
"2661","ENSG00000115325","ENSG00000115325","DOK1","2",74549026,74557551,8525
"2662","ENSG00000147443","ENSG00000147443","DOK2","8",21908873,21913690,4817
"2663","ENSG00000146094","ENSG00000146094","DOK3","5",177501904,177511274,9370
"2664","ENSG00000125170","ENSG00000125170","DOK4","16",57471922,57487327,15405
"2665","ENSG00000101134","ENSG00000101134","DOK5","20",54475593,54651169,175576
"2666","ENSG00000175283","ENSG00000175283","DOLK","9",128945530,128947603,2073
"2667","ENSG00000167130","ENSG00000167130","DOLPP1","9",129081111,129090438,9327
"2668","ENSG00000159147","ENSG00000159147","DONSON","21",33559542,33588706,29164
"2669","ENSG00000104885","ENSG00000104885","DOT1L","19",2163933,2232578,68645
"2670","ENSG00000172269","ENSG00000172269","DPAGT1","11",119096025,119108331,12306
"2671","ENSG00000015413","ENSG00000015413","DPEP1","16",89613308,89638456,25148
"2672","ENSG00000167261","ENSG00000167261","DPEP2","16",67987394,68000586,13192
"2673","ENSG00000141096","ENSG00000141096","DPEP3","16",67975663,67980549,4886
"2674","ENSG00000011332","ENSG00000011332","DPF1","19",38211006,38229714,18708
"2675","ENSG00000133884","ENSG00000133884","DPF2","11",65333843,65354262,20419
"2676","ENSG00000205683","ENSG00000205683","DPF3","14",72609034,72894101,285067
"2677","ENSG00000108963","ENSG00000108963","DPH1","17",2030137,2043898,13761
"2678","ENSG00000132768","ENSG00000132768","DPH2","1",43970000,43973369,3369
"2679","ENSG00000117543","ENSG00000117543","DPH5","1",100989623,101026088,36465
"2680","ENSG00000000419","ENSG00000000419","DPM1","20",50934867,50959140,24273
"2681","ENSG00000136908","ENSG00000136908","DPM2","9",127935099,127937854,2755
"2682","ENSG00000179085","ENSG00000179085","DPM3","1",155139891,155140595,704
"2683","ENSG00000254986","ENSG00000254986","DPP3","11",66480013,66509657,29644
"2684","ENSG00000197635","ENSG00000197635","DPP4","2",161992245,162074394,82149
"2685","ENSG00000130226","ENSG00000130226","DPP6","7",153748133,154894285,1146152
"2686","ENSG00000074603","ENSG00000074603","DPP8","15",65442463,65517704,75241
"2687","ENSG00000121570","ENSG00000121570","DPPA4","3",109326144,109337546,11402
"2688","ENSG00000143196","ENSG00000143196","DPT","1",168695468,168729206,33738
"2689","ENSG00000173852","ENSG00000173852","DPY19L1","7",34927292,35038271,110979
"2690","ENSG00000156162","ENSG00000156162","DPY19L4","8",94719703,94793836,74133
"2691","ENSG00000162961","ENSG00000162961","DPY30","2",31867809,32039805,171996
"2692","ENSG00000188641","ENSG00000188641","DPYD","1",97077743,97995000,917257
"2693","ENSG00000147647","ENSG00000147647","DPYS","8",104330324,104467055,136731
"2694","ENSG00000092964","ENSG00000092964","DPYSL2","8",26514031,26658178,144147
"2695","ENSG00000113657","ENSG00000113657","DPYSL3","5",147390808,147510068,119260
"2696","ENSG00000151640","ENSG00000151640","DPYSL4","10",132186948,132205759,18811
"2697","ENSG00000117505","ENSG00000117505","DR1","1",93345907,93369493,23586
"2698","ENSG00000136048","ENSG00000136048","DRAM1","12",101877580,102012130,134550
"2699","ENSG00000175550","ENSG00000175550","DRAP1","11",65919274,65921563,2289
"2700","ENSG00000184845","ENSG00000184845","DRD1","5",175440036,175444182,4146
"2701","ENSG00000149295","ENSG00000149295","DRD2","11",113409605,113475691,66086
"2702","ENSG00000276825","ENSG00000276825","DRD4","HSCHR11_1_CTG8",167166,170577,3411
"2703","ENSG00000169676","ENSG00000169676","DRD5","4",9781634,9784009,2375
"2704","ENSG00000185721","ENSG00000185721","DRG1","22",31399604,31528740,129136
"2705","ENSG00000108591","ENSG00000108591","DRG2","17",18087892,18107970,20078
"2706","ENSG00000189269","ENSG00000189269","DRICH1","22",23608452,23632321,23869
"2707","ENSG00000113360","ENSG00000113360","DROSHA","5",31400494,31532196,131702
"2708","ENSG00000134765","ENSG00000134765","DSC1","18",31129236,31162856,33620
"2709","ENSG00000134755","ENSG00000134755","DSC2","18",31058545,31102600,44055
"2710","ENSG00000134762","ENSG00000134762","DSC3","18",30989365,31042815,53450
"2711","ENSG00000171587","ENSG00000171587","DSCAM","21",40010999,40847158,836159
"2712","ENSG00000136982","ENSG00000136982","DSCC1","8",119833976,119855894,21918
"2713","ENSG00000184029","ENSG00000184029","DSCR4","21",37951425,38121360,169935
"2714","ENSG00000111817","ENSG00000111817","DSE","6",116254173,116444861,190688
"2715","ENSG00000134760","ENSG00000134760","DSG1","18",31318160,31359246,41086
"2716","ENSG00000046604","ENSG00000046604","DSG2","18",31497624,31551351,53727
"2717","ENSG00000134757","ENSG00000134757","DSG3","18",31447741,31478702,30961
"2718","ENSG00000149636","ENSG00000149636","DSN1","20",36751791,36773818,22027
"2719","ENSG00000096696","ENSG00000096696","DSP","6",7541326,7586717,45391
"2720","ENSG00000151914","ENSG00000151914","DST","6",56457987,56954830,496843
"2721","ENSG00000125868","ENSG00000125868","DSTN","20",17570075,17609919,39844
"2722","ENSG00000133059","ENSG00000133059","DSTYK","1",205142505,205211702,69197
"2723","ENSG00000143476","ENSG00000143476","DTL","1",212035553,212107400,71847
"2724","ENSG00000134769","ENSG00000134769","DTNA","18",34493291,34891844,398553
"2725","ENSG00000138101","ENSG00000138101","DTNB","2",25377198,25673647,296449
"2726","ENSG00000104047","ENSG00000104047","DTWD1","15",49621037,49656232,35195
"2727","ENSG00000282379","ENSG00000282379","DTX2","HSCHR7_2_CTG4_4",286,5014,4728
"2728","ENSG00000178498","ENSG00000178498","DTX3","12",57604622,57609804,5182
"2729","ENSG00000110042","ENSG00000110042","DTX4","11",59171430,59208588,37158
"2730","ENSG00000168393","ENSG00000168393","DTYMK","2",241675747,241686944,11197
"2731","ENSG00000137857","ENSG00000137857","DUOX1","15",45129933,45165576,35643
"2732","ENSG00000169718","ENSG00000169718","DUS1L","17",82057506,82065887,8381
"2733","ENSG00000167264","ENSG00000167264","DUS2","16",67987746,68079320,91574
"2734","ENSG00000105865","ENSG00000105865","DUS4L","7",107563484,107578523,15039
"2735","ENSG00000120129","ENSG00000120129","DUSP1","5",172768096,172771195,3099
"2736","ENSG00000143507","ENSG00000143507","DUSP10","1",221701424,221742089,40665
"2737","ENSG00000144048","ENSG00000144048","DUSP11","2",73761782,73780132,18350
"2738","ENSG00000081721","ENSG00000081721","DUSP12","1",161749758,161757238,7480
"2739","ENSG00000276023","ENSG00000276023","DUSP14","17",37489891,37513501,23610
"2740","ENSG00000158050","ENSG00000158050","DUSP2","2",96143169,96145440,2271
"2741","ENSG00000112679","ENSG00000112679","DUSP22","6",291630,351355,59725
"2742","ENSG00000133878","ENSG00000133878","DUSP26","8",33591330,33600023,8693
"2743","ENSG00000108861","ENSG00000108861","DUSP3","17",43766125,43778977,12852
"2744","ENSG00000120875","ENSG00000120875","DUSP4","8",29333064,29350684,17620
"2745","ENSG00000138166","ENSG00000138166","DUSP5","10",110497907,110511533,13626
"2746","ENSG00000139318","ENSG00000139318","DUSP6","12",89347235,89352501,5266
"2747","ENSG00000164086","ENSG00000164086","DUSP7","3",52048919,52056571,7652
"2748","ENSG00000278165","ENSG00000278165","DUSP8","HSCHR11_2_CTG1_1",30571,48447,17876
"2749","ENSG00000130829","ENSG00000130829","DUSP9","X",153642492,153651326,8834
"2750","ENSG00000128951","ENSG00000128951","DUT","15",48331011,48343373,12362
"2751","ENSG00000107404","ENSG00000107404","DVL1","1",1335276,1349418,14142
"2752","ENSG00000004975","ENSG00000004975","DVL2","17",7225342,7234517,9175
"2753","ENSG00000161202","ENSG00000161202","DVL3","3",184155377,184173614,18237
"2754","ENSG00000236765","ENSG00000236765","DXO","HSCHR6_MHC_DBB_CTG1",3217585,3220067,2482
"2755","ENSG00000141627","ENSG00000141627","DYM","18",49036387,49461347,424960
"2756","ENSG00000197102","ENSG00000197102","DYNC1H1","14",101964573,102056443,91870
"2757","ENSG00000158560","ENSG00000158560","DYNC1I1","7",95772506,96110322,337816
"2758","ENSG00000077380","ENSG00000077380","DYNC1I2","2",171687409,171750158,62749
"2759","ENSG00000144635","ENSG00000144635","DYNC1LI1","3",32525974,32570858,44884
"2760","ENSG00000135720","ENSG00000135720","DYNC1LI2","16",66720893,66751609,30716
"2761","ENSG00000187240","ENSG00000187240","DYNC2H1","11",103109410,103479863,370453
"2762","ENSG00000138036","ENSG00000138036","DYNC2LI1","2",43774039,43810010,35971
"2763","ENSG00000088986","ENSG00000088986","DYNLL1","12",120469850,120498493,28643
"2764","ENSG00000125971","ENSG00000125971","DYNLRB1","20",34516395,34540958,24563
"2765","ENSG00000146425","ENSG00000146425","DYNLT1","6",158636474,158644743,8269
"2766","ENSG00000165169","ENSG00000165169","DYNLT3","X",37836757,37847571,10814
"2767","ENSG00000157540","ENSG00000157540","DYRK1A","21",37365573,37526358,160785
"2768","ENSG00000281320","ENSG00000281320","DYRK1B","HG2021_PATCH",85226,94077,8851
"2769","ENSG00000127334","ENSG00000127334","DYRK2","12",67648338,67665406,17068
"2770","ENSG00000143479","ENSG00000143479","DYRK3","1",206635536,206684419,48883
"2771","ENSG00000010219","ENSG00000010219","DYRK4","12",4562208,4615302,53094
"2772","ENSG00000135636","ENSG00000135636","DYSF","2",71453561,71686763,233202
"2773","ENSG00000089091","ENSG00000089091","DZANK1","20",18383367,18467281,83914
"2774","ENSG00000134874","ENSG00000134874","DZIP1","13",95578202,95644706,66504
"2775","ENSG00000198919","ENSG00000198919","DZIP3","3",108589705,108694840,105135
"2776","ENSG00000101412","ENSG00000101412","E2F1","20",33675477,33686385,10908
"2777","ENSG00000112242","ENSG00000112242","E2F3","6",20401879,20493714,91835
"2778","ENSG00000205250","ENSG00000205250","E2F4","16",67192155,67198918,6763
"2779","ENSG00000133740","ENSG00000133740","E2F5","8",85177154,85217158,40004
"2780","ENSG00000169016","ENSG00000169016","E2F6","2",11444375,11466177,21802
"2781","ENSG00000129173","ENSG00000129173","E2F8","11",19224063,19241620,17557
"2782","ENSG00000167967","ENSG00000167967","E4F1","16",2223580,2235742,12162
"2783","ENSG00000145088","ENSG00000145088","EAF2","3",121835183,121886526,51343
"2784","ENSG00000129518","ENSG00000129518","EAPP","14",34515938,34539704,23766
"2785","ENSG00000147654","ENSG00000147654","EBAG9","8",109539711,109570072,30361
"2786","ENSG00000221818","ENSG00000221818","EBF2","8",25841725,26045413,203688
"2787","ENSG00000105246","ENSG00000105246","EBI3","19",4229523,4237528,8005
"2788","ENSG00000255423","ENSG00000255423","EBLN2","3",73061659,73063337,1678
"2789","ENSG00000117395","ENSG00000117395","EBNA1BP2","1",43164175,43270936,106761
"2790","ENSG00000147155","ENSG00000147155","EBP","X",48521799,48528716,6917
"2791","ENSG00000122882","ENSG00000122882","ECD","10",73130155,73169055,38900
"2792","ENSG00000117298","ENSG00000117298","ECE1","1",21217247,21345572,128325
"2793","ENSG00000145194","ENSG00000145194","ECE2","3",184276011,184293031,17020
"2794","ENSG00000171551","ENSG00000171551","ECEL1","2",232479827,232487834,8007
"2795","ENSG00000104823","ENSG00000104823","ECH1","19",38815422,38831841,16419
"2796","ENSG00000093144","ENSG00000093144","ECHDC1","6",127288712,127343609,54897
"2797","ENSG00000121310","ENSG00000121310","ECHDC2","1",52895910,52927212,31302
"2798","ENSG00000134463","ENSG00000134463","ECHDC3","10",11742366,11764070,21704
"2799","ENSG00000127884","ENSG00000127884","ECHS1","10",133362485,133373354,10869
"2800","ENSG00000167969","ENSG00000167969","ECI1","16",2239402,2252300,12898
"2801","ENSG00000198721","ENSG00000198721","ECI2","6",4115693,4135597,19904
"2802","ENSG00000143369","ENSG00000143369","ECM1","1",150508062,150513789,5727
"2803","ENSG00000106823","ENSG00000106823","ECM2","9",92493554,92536655,43101
"2804","ENSG00000130159","ENSG00000130159","ECSIT","19",11505929,11529172,23243
"2805","ENSG00000114346","ENSG00000114346","ECT2","3",172750682,172821474,70792
"2806","ENSG00000158813","ENSG00000158813","EDA","X",69616067,70039472,423405
"2807","ENSG00000131080","ENSG00000131080","EDA2R","X",66595637,66639298,43661
"2808","ENSG00000135960","ENSG00000135960","EDAR","2",108894471,108989372,94901
"2809","ENSG00000179151","ENSG00000179151","EDC3","15",74630558,74696292,65734
"2810","ENSG00000038358","ENSG00000038358","EDC4","16",67873052,67884499,11447
"2811","ENSG00000134109","ENSG00000134109","EDEM1","3",5187646,5219958,32312
"2812","ENSG00000088298","ENSG00000088298","EDEM2","20",35115364,35147336,31972
"2813","ENSG00000116406","ENSG00000116406","EDEM3","1",184690237,184754907,64670
"2814","ENSG00000107223","ENSG00000107223","EDF1","9",136862119,136866308,4189
"2815","ENSG00000164176","ENSG00000164176","EDIL3","5",83940554,84384880,444326
"2816","ENSG00000078401","ENSG00000078401","EDN1","6",12290361,12297194,6833
"2817","ENSG00000127129","ENSG00000127129","EDN2","1",41478775,41484683,5908
"2818","ENSG00000124205","ENSG00000124205","EDN3","20",59300443,59325992,25549
"2819","ENSG00000151617","ENSG00000151617","EDNRA","4",147480917,147544954,64037
"2820","ENSG00000136160","ENSG00000136160","EDNRB","13",77895481,77975529,80048
"2821","ENSG00000107938","ENSG00000107938","EDRF1","10",125719515,125764143,44628
"2822","ENSG00000102189","ENSG00000102189","EEA1","12",92770637,92929331,158694
"2823","ENSG00000074266","ENSG00000074266","EED","11",86201212,86278813,77601
"2824","ENSG00000156508","ENSG00000156508","EEF1A1","6",73489308,73525587,36279
"2825","ENSG00000101210","ENSG00000101210","EEF1A2","20",63488013,63499239,11226
"2826","ENSG00000114942","ENSG00000114942","EEF1B2","2",206159585,206162928,3343
"2827","ENSG00000273594","ENSG00000273594","EEF1D","HSCHR8_3_CTG7",69737,87784,18047
"2828","ENSG00000124802","ENSG00000124802","EEF1E1","6",8073360,8102559,29199
"2829","ENSG00000254772","ENSG00000254772","EEF1G","11",62559596,62574086,14490
"2830","ENSG00000167658","ENSG00000167658","EEF2","19",3976056,3985463,9407
"2831","ENSG00000140025","ENSG00000140025","EFCAB11","14",89794669,89954777,160108
"2832","ENSG00000159658","ENSG00000159658","EFCAB14","1",46674659,46719146,44487
"2833","ENSG00000203666","ENSG00000203666","EFCAB2","1",244969682,245127164,157482
"2834","ENSG00000186976","ENSG00000186976","EFCAB6","22",43528744,43812337,283593
"2835","ENSG00000114654","ENSG00000114654","EFCC1","3",129001304,129040742,39438
"2836","ENSG00000115380","ENSG00000115380","EFEMP1","2",55865967,55924139,58172
"2837","ENSG00000172638","ENSG00000172638","EFEMP2","11",65866441,65873592,7151
"2838","ENSG00000096093","ENSG00000096093","EFHC1","6",52362123,52529886,167763
"2839","ENSG00000183690","ENSG00000183690","EFHC2","X",44147872,44343672,195800
"2840","ENSG00000115468","ENSG00000115468","EFHD1","2",232606057,232682776,76719
"2841","ENSG00000142634","ENSG00000142634","EFHD2","1",15409888,15430339,20451
"2842","ENSG00000140598","ENSG00000140598","EFL1","15",82130206,82262773,132567
"2843","ENSG00000169242","ENSG00000169242","EFNA1","1",155127876,155134899,7023
"2844","ENSG00000099617","ENSG00000099617","EFNA2","19",1285873,1301431,15558
"2845","ENSG00000143590","ENSG00000143590","EFNA3","1",155078837,155087538,8701
"2846","ENSG00000243364","ENSG00000243364","EFNA4","1",155063737,155069553,5816
"2847","ENSG00000184349","ENSG00000184349","EFNA5","5",107376894,107670937,294043
"2848","ENSG00000090776","ENSG00000090776","EFNB1","X",68829021,68842160,13139
"2849","ENSG00000125266","ENSG00000125266","EFNB2","13",106489745,106535662,45917
"2850","ENSG00000108947","ENSG00000108947","EFNB3","17",7705202,7711372,6170
"2851","ENSG00000132294","ENSG00000132294","EFR3A","8",131904093,132013642,109549
"2852","ENSG00000084710","ENSG00000084710","EFR3B","2",25042076,25159135,117059
"2853","ENSG00000100842","ENSG00000100842","EFS","14",23356403,23365752,9349
"2854","ENSG00000138798","ENSG00000138798","EGF","4",109912883,110013766,100883
"2855","ENSG00000198759","ENSG00000198759","EGFL6","X",13569601,13633575,63974
"2856","ENSG00000172889","ENSG00000172889","EGFL7","9",136658856,136672678,13822
"2857","ENSG00000244444","ENSG00000244444","EGFL8","HSCHR6_MHC_QBL_CTG1",3387784,3391482,3698
"2858","ENSG00000146648","ENSG00000146648","EGFR","7",55019017,55211628,192611
"2859","ENSG00000135766","ENSG00000135766","EGLN1","1",231363751,231422287,58536
"2860","ENSG00000269858","ENSG00000269858","EGLN2","19",40798996,40808434,9438
"2861","ENSG00000129521","ENSG00000129521","EGLN3","14",33924227,34462774,538547
"2862","ENSG00000120738","ENSG00000120738","EGR1","5",138465479,138469303,3824
"2863","ENSG00000122877","ENSG00000122877","EGR2","10",62811996,62819167,7171
"2864","ENSG00000179388","ENSG00000179388","EGR3","8",22687659,22693480,5821
"2865","ENSG00000135625","ENSG00000135625","EGR4","2",73290929,73293701,2772
"2866","ENSG00000115504","ENSG00000115504","EHBP1","2",62673851,63046487,372636
"2867","ENSG00000110047","ENSG00000110047","EHD1","11",64851642,64888296,36654
"2868","ENSG00000024422","ENSG00000024422","EHD2","19",47713422,47743134,29712
"2869","ENSG00000013016","ENSG00000013016","EHD3","2",31234152,31269451,35299
"2870","ENSG00000103966","ENSG00000103966","EHD4","15",41895933,41972557,76624
"2871","ENSG00000135373","ENSG00000135373","EHF","11",34621093,34663288,42195
"2872","ENSG00000113790","ENSG00000113790","EHHADH","3",185190624,185281990,91366
"2873","ENSG00000181090","ENSG00000181090","EHMT1","9",137618992,137870016,251024
"2874","ENSG00000238134","ENSG00000238134","EHMT2","HSCHR6_MHC_MCF_CTG1",3221824,3239759,17935
"2875","ENSG00000149547","ENSG00000149547","EI24","11",125569280,125584684,15404
"2876","ENSG00000255302","ENSG00000255302","EID1","15",48878134,48880173,2039
"2877","ENSG00000173812","ENSG00000173812","EIF1","17",41688885,41692668,3783
"2878","ENSG00000173674","ENSG00000173674","EIF1AX","X",20124525,20141838,17313
"2879","ENSG00000198692","ENSG00000198692","EIF1AY","Y",20575776,20593154,17378
"2880","ENSG00000114784","ENSG00000114784","EIF1B","3",40309707,40312424,2717
"2881","ENSG00000086232","ENSG00000086232","EIF2AK1","7",6022247,6059175,36928
"2882","ENSG00000055332","ENSG00000055332","EIF2AK2","2",37099210,37157522,58312
"2883","ENSG00000172071","ENSG00000172071","EIF2AK3","2",88556741,88691518,134777
"2884","ENSG00000111361","ENSG00000111361","EIF2B1","12",123620406,123633766,13360
"2885","ENSG00000119718","ENSG00000119718","EIF2B2","14",75002921,75012366,9445
"2886","ENSG00000070785","ENSG00000070785","EIF2B3","1",44850522,44986722,136200
"2887","ENSG00000115211","ENSG00000115211","EIF2B4","2",27364352,27370338,5986
"2888","ENSG00000145191","ENSG00000145191","EIF2B5","3",184135038,184146127,11089
"2889","ENSG00000143486","ENSG00000143486","EIF2D","1",206571292,206612465,41173
"2890","ENSG00000134001","ENSG00000134001","EIF2S1","14",67360328,67386516,26188
"2891","ENSG00000125977","ENSG00000125977","EIF2S2","20",34088309,34112243,23934
"2892","ENSG00000130741","ENSG00000130741","EIF2S3","X",24054946,24078810,23864
"2893","ENSG00000107581","ENSG00000107581","EIF3A","10",119033670,119080817,47147
"2894","ENSG00000106263","ENSG00000106263","EIF3B","7",2354086,2380745,26659
"2895","ENSG00000184110","ENSG00000184110","EIF3C","16",28688558,28735727,47169
"2896","ENSG00000205609","ENSG00000205609","EIF3CL","16",28379579,28403841,24262
"2897","ENSG00000100353","ENSG00000100353","EIF3D","22",36510855,36529184,18329
"2898","ENSG00000104408","ENSG00000104408","EIF3E","8",108162787,108443496,280709
"2899","ENSG00000175390","ENSG00000175390","EIF3F","11",7970251,8001862,31611
"2900","ENSG00000130811","ENSG00000130811","EIF3G","19",10115014,10119918,4904
"2901","ENSG00000147677","ENSG00000147677","EIF3H","8",116642130,116766925,124795
"2902","ENSG00000084623","ENSG00000084623","EIF3I","1",32221077,32245397,24320
"2903","ENSG00000104131","ENSG00000104131","EIF3J","15",44537125,44563029,25904
"2904","ENSG00000178982","ENSG00000178982","EIF3K","19",38619082,38636955,17873
"2905","ENSG00000100129","ENSG00000100129","EIF3L","22",37848868,37889407,40539
"2906","ENSG00000149100","ENSG00000149100","EIF3M","11",32583798,32606264,22466
"2907","ENSG00000161960","ENSG00000161960","EIF4A1","17",7572824,7579006,6182
"2908","ENSG00000156976","ENSG00000156976","EIF4A2","3",186783205,186789897,6692
"2909","ENSG00000141543","ENSG00000141543","EIF4A3","17",80134369,80147151,12782
"2910","ENSG00000063046","ENSG00000063046","EIF4B","12",53006282,53042215,35933
"2911","ENSG00000151247","ENSG00000151247","EIF4E","4",98879276,98929133,49857
"2912","ENSG00000135930","ENSG00000135930","EIF4E2","2",232550659,232583644,32985
"2913","ENSG00000187840","ENSG00000187840","EIF4EBP1","8",38030534,38060365,29831
"2914","ENSG00000148730","ENSG00000148730","EIF4EBP2","10",70404145,70428618,24473
"2915","ENSG00000243056","ENSG00000243056","EIF4EBP3","5",140547662,140549576,1914
"2916","ENSG00000184708","ENSG00000184708","EIF4ENIF1","22",31436977,31496108,59131
"2917","ENSG00000114867","ENSG00000114867","EIF4G1","3",184314495,184335358,20863
"2918","ENSG00000110321","ENSG00000110321","EIF4G2","11",10797050,10808940,11890
"2919","ENSG00000075151","ENSG00000075151","EIF4G3","1",20806292,21177285,370993
"2920","ENSG00000106682","ENSG00000106682","EIF4H","7",74174231,74197122,22891
"2921","ENSG00000100664","ENSG00000100664","EIF5","14",103333544,103345025,11481
"2922","ENSG00000132507","ENSG00000132507","EIF5A","17",7306999,7312463,5464
"2923","ENSG00000163577","ENSG00000163577","EIF5A2","3",170888418,170908644,20226
"2924","ENSG00000158417","ENSG00000158417","EIF5B","2",99337389,99401326,63937
"2925","ENSG00000242372","ENSG00000242372","EIF6","20",35278907,35284985,6078
"2926","ENSG00000141642","ENSG00000141642","ELAC1","18",50967991,50988121,20130
"2927","ENSG00000006744","ENSG00000006744","ELAC2","17",12991612,13018065,26453
"2928","ENSG00000066044","ENSG00000066044","ELAVL1","19",7958573,8005659,47086
"2929","ENSG00000107105","ENSG00000107105","ELAVL2","9",23690104,23826337,136233
"2930","ENSG00000196361","ENSG00000196361","ELAVL3","19",11451326,11481046,29720
"2931","ENSG00000162374","ENSG00000162374","ELAVL4","1",50024029,50203772,179743
"2932","ENSG00000120690","ENSG00000120690","ELF1","13",40931924,41061440,129516
"2933","ENSG00000109381","ENSG00000109381","ELF2","4",139028112,139177218,149106
"2934","ENSG00000163435","ENSG00000163435","ELF3","1",202007945,202017183,9238
"2935","ENSG00000102034","ENSG00000102034","ELF4","X",130063955,130110716,46761
"2936","ENSG00000135374","ENSG00000135374","ELF5","11",34478791,34525193,46402
"2937","ENSG00000126767","ENSG00000126767","ELK1","X",47635521,47650604,15083
"2938","ENSG00000111145","ENSG00000111145","ELK3","12",96194375,96269824,75449
"2939","ENSG00000158711","ENSG00000158711","ELK4","1",205597556,205632011,34455
"2940","ENSG00000105656","ENSG00000105656","ELL","19",18442663,18522116,79453
"2941","ENSG00000118985","ENSG00000118985","ELL2","5",95885098,95961851,76753
"2942","ENSG00000128886","ENSG00000128886","ELL3","15",43772605,43777315,4710
"2943","ENSG00000155849","ENSG00000155849","ELMO1","7",36852906,37449223,596317
"2944","ENSG00000062598","ENSG00000062598","ELMO2","20",46366050,46432985,66935
"2945","ENSG00000102890","ENSG00000102890","ELMO3","16",67199111,67204029,4918
"2946","ENSG00000049540","ENSG00000049540","ELN","7",74027789,74069907,42118
"2947","ENSG00000066322","ENSG00000066322","ELOVL1","1",43363398,43368074,4676
"2948","ENSG00000197977","ENSG00000197977","ELOVL2","6",10980759,11044305,63546
"2949","ENSG00000118402","ENSG00000118402","ELOVL4","6",79914814,79947553,32739
"2950","ENSG00000012660","ENSG00000012660","ELOVL5","6",53267398,53349179,81781
"2951","ENSG00000170522","ENSG00000170522","ELOVL6","4",110045846,110199199,153353
"2952","ENSG00000134014","ENSG00000134014","ELP3","8",28089673,28191156,101483
"2953","ENSG00000109911","ENSG00000109911","ELP4","11",31509755,31790324,280569
"2954","ENSG00000170291","ENSG00000170291","ELP5","17",7251416,7259940,8524
"2955","ENSG00000163832","ENSG00000163832","ELP6","3",47495640,47513712,18072
"2956","ENSG00000127463","ENSG00000127463","EMC1","1",19215660,19251552,35892
"2957","ENSG00000161671","ENSG00000161671","EMC10","19",50476400,50490871,14471
"2958","ENSG00000104412","ENSG00000104412","EMC2","8",108443601,108489196,45595
"2959","ENSG00000125037","ENSG00000125037","EMC3","3",9962682,10011202,48520
"2960","ENSG00000127774","ENSG00000127774","EMC6","17",3668812,3669668,856
"2961","ENSG00000134153","ENSG00000134153","EMC7","15",34084017,34101862,17845
"2962","ENSG00000131148","ENSG00000131148","EMC8","16",85771758,85799608,27850
"2963","ENSG00000100908","ENSG00000100908","EMC9","14",24138959,24141591,2632
"2964","ENSG00000164035","ENSG00000164035","EMCN","4",100395341,100880126,484785
"2965","ENSG00000102119","ENSG00000102119","EMD","X",154379273,154381574,2301
"2966","ENSG00000126749","ENSG00000126749","EMG1","12",6970913,6979936,9023
"2967","ENSG00000186998","ENSG00000186998","EMID1","22",29205896,29259597,53701
"2968","ENSG00000138080","ENSG00000138080","EMILIN1","2",27078615,27086403,7788
"2969","ENSG00000132205","ENSG00000132205","EMILIN2","18",2847006,2916003,68997
"2970","ENSG00000066629","ENSG00000066629","EML1","14",99737693,99942060,204367
"2971","ENSG00000125746","ENSG00000125746","EML2","19",45606994,45645602,38608
"2972","ENSG00000143924","ENSG00000143924","EML4","2",42169353,42332548,163195
"2973","ENSG00000134531","ENSG00000134531","EMP1","12",13196723,13219941,23218
"2974","ENSG00000213853","ENSG00000213853","EMP2","16",10528422,10580632,52210
"2975","ENSG00000142227","ENSG00000142227","EMP3","19",48321509,48330553,9044
"2976","ENSG00000158636","ENSG00000158636","EMSY","11",76444923,76553031,108108
"2977","ENSG00000135638","ENSG00000135638","EMX1","2",72916260,72936071,19811
"2978","ENSG00000170370","ENSG00000170370","EMX2","10",117542445,117549546,7101
"2979","ENSG00000163064","ENSG00000163064","EN1","2",118842171,118847648,5477
"2980","ENSG00000164778","ENSG00000164778","EN2","7",155458129,155464831,6702
"2981","ENSG00000154380","ENSG00000154380","ENAH","1",225486765,225653142,166377
"2982","ENSG00000171617","ENSG00000171617","ENC1","5",74627406,74641424,14018
"2983","ENSG00000149218","ENSG00000149218","ENDOD1","11",95089846,95132645,42799
"2984","ENSG00000167136","ENSG00000167136","ENDOG","9",128818500,128822676,4176
"2985","ENSG00000111405","ENSG00000111405","ENDOU","12",47709734,47725567,15833
"2986","ENSG00000106991","ENSG00000106991","ENG","9",127811130,127854773,43643
"2987","ENSG00000167280","ENSG00000167280","ENGASE","17",79074824,79088599,13775
"2988","ENSG00000074800","ENSG00000074800","ENO1","1",8861000,8879190,18190
"2989","ENSG00000111674","ENSG00000111674","ENO2","12",6913745,6923698,9953
"2990","ENSG00000108515","ENSG00000108515","ENO3","17",4948092,4957131,9039
"2991","ENSG00000145293","ENSG00000145293","ENOPH1","4",82430590,82461177,30587
"2992","ENSG00000132199","ENSG00000132199","ENOSF1","18",670318,712662,42344
"2993","ENSG00000120658","ENSG00000120658","ENOX1","13",43213130,43786972,573842
"2994","ENSG00000165675","ENSG00000165675","ENOX2","X",130622325,130903234,280909
"2995","ENSG00000138792","ENSG00000138792","ENPEP","4",110365733,110565285,199552
"2996","ENSG00000197594","ENSG00000197594","ENPP1","6",131808016,131895155,87139
"2997","ENSG00000136960","ENSG00000136960","ENPP2","8",119557086,119673453,116367
"2998","ENSG00000154269","ENSG00000154269","ENPP3","6",131628442,131747418,118976
"2999","ENSG00000001561","ENSG00000001561","ENPP4","6",46129989,46146688,16699
"3000","ENSG00000143420","ENSG00000143420","ENSA","1",150600851,150629612,28761
"3001","ENSG00000138185","ENSG00000138185","ENTPD1","10",95711779,95877266,165487
"3002","ENSG00000054179","ENSG00000054179","ENTPD2","9",137048107,137054061,5954
"3003","ENSG00000168032","ENSG00000168032","ENTPD3","3",40387184,40428744,41560
"3004","ENSG00000197217","ENSG00000197217","ENTPD4","8",23385783,23457695,71912
"3005","ENSG00000187097","ENSG00000187097","ENTPD5","14",73958010,74019399,61389
"3006","ENSG00000197586","ENSG00000197586","ENTPD6","20",25195693,25228075,32382
"3007","ENSG00000198018","ENSG00000198018","ENTPD7","10",99659509,99711241,51732
"3008","ENSG00000120533","ENSG00000120533","ENY2","8",109334324,109345954,11630
"3009","ENSG00000163378","ENSG00000163378","EOGT","3",68975217,69013684,38467
"3010","ENSG00000100393","ENSG00000100393","EP300","22",41092510,41180077,87567
"3011","ENSG00000183495","ENSG00000183495","EP400","12",131949942,132080460,130518
"3012","ENSG00000116016","ENSG00000116016","EPAS1","2",46293667,46386697,93030
"3013","ENSG00000159023","ENSG00000159023","EPB41","1",28887091,29120046,232955
"3014","ENSG00000088367","ENSG00000088367","EPB41L1","20",36091504,36232799,141295
"3015","ENSG00000079819","ENSG00000079819","EPB41L2","6",130839347,131063322,223975
"3016","ENSG00000082397","ENSG00000082397","EPB41L3","18",5392381,5630700,238319
"3017","ENSG00000129595","ENSG00000129595","EPB41L4A","5",112142441,112419313,276872
"3018","ENSG00000095203","ENSG00000095203","EPB41L4B","9",109171974,109321059,149085
"3019","ENSG00000115109","ENSG00000115109","EPB41L5","2",120013077,120179119,166042
"3020","ENSG00000166947","ENSG00000166947","EPB42","15",43197227,43221018,23791
"3021","ENSG00000119888","ENSG00000119888","EPCAM","2",47345158,47387601,42443
"3022","ENSG00000146904","ENSG00000146904","EPHA1","7",143390289,143408856,18567
"3023","ENSG00000142627","ENSG00000142627","EPHA2","1",16124337,16156069,31732
"3024","ENSG00000044524","ENSG00000044524","EPHA3","3",89107621,89482134,374513
"3025","ENSG00000116106","ENSG00000116106","EPHA4","2",221418027,221574202,156175
"3026","ENSG00000135333","ENSG00000135333","EPHA7","6",93240020,93419687,179667
"3027","ENSG00000154928","ENSG00000154928","EPHB1","3",134795260,135260467,465207
"3028","ENSG00000133216","ENSG00000133216","EPHB2","1",22710839,22921500,210661
"3029","ENSG00000182580","ENSG00000182580","EPHB3","3",184561785,184582408,20623
"3030","ENSG00000196411","ENSG00000196411","EPHB4","7",100802565,100827523,24958
"3031","ENSG00000275482","ENSG00000275482","EPHB6","HSCHR7_2_CTG6",878117,894135,16018
"3032","ENSG00000143819","ENSG00000143819","EPHX1","1",225810124,225845563,35439
"3033","ENSG00000120915","ENSG00000120915","EPHX2","8",27490781,27545564,54783
"3034","ENSG00000105131","ENSG00000105131","EPHX3","19",15226919,15233435,6516
"3035","ENSG00000112425","ENSG00000112425","EPM2A","6",145382535,145736023,353488
"3036","ENSG00000178567","ENSG00000178567","EPM2AIP1","3",36985043,36993131,8088
"3037","ENSG00000063245","ENSG00000063245","EPN1","19",55675226,55709858,34632
"3038","ENSG00000072134","ENSG00000072134","EPN2","17",19215615,19336715,121100
"3039","ENSG00000049283","ENSG00000049283","EPN3","17",50532682,50543750,11068
"3040","ENSG00000130427","ENSG00000130427","EPO","7",100720468,100723700,3232
"3041","ENSG00000187266","ENSG00000187266","EPOR","19",11377207,11384342,7135
"3042","ENSG00000101448","ENSG00000101448","EPPIN","20",45540626,45547752,7126
"3043","ENSG00000261150","ENSG00000261150","EPPK1","8",143857324,143878467,21143
"3044","ENSG00000085832","ENSG00000085832","EPS15","1",51354263,51519328,165065
"3045","ENSG00000127527","ENSG00000127527","EPS15L1","19",16355225,16472085,116860
"3046","ENSG00000151491","ENSG00000151491","EPS8","12",15620134,15882329,262195
"3047","ENSG00000131037","ENSG00000131037","EPS8L1","19",55072020,55087923,15903
"3048","ENSG00000177106","ENSG00000177106","EPS8L2","11",694438,727727,33289
"3049","ENSG00000198758","ENSG00000198758","EPS8L3","1",109750080,109764027,13947
"3050","ENSG00000083782","ENSG00000083782","EPYC","12",90963682,91005026,41344
"3051","ENSG00000132591","ENSG00000132591","ERAL1","17",28855010,28861061,6051
"3052","ENSG00000164307","ENSG00000164307","ERAP1","5",96760810,96808100,47290
"3053","ENSG00000164308","ENSG00000164308","ERAP2","5",96875986,96919703,43717
"3054","ENSG00000141736","ENSG00000141736","ERBB2","17",39687914,39730426,42512
"3055","ENSG00000065361","ENSG00000065361","ERBB3","12",56076799,56103505,26706
"3056","ENSG00000178568","ENSG00000178568","ERBB4","2",211375717,212538841,1163124
"3057","ENSG00000112851","ENSG00000112851","ERBIN","5",65883128,66082546,199418
"3058","ENSG00000082805","ENSG00000082805","ERC1","12",990509,1495933,505424
"3059","ENSG00000187672","ENSG00000187672","ERC2","3",55508311,56469095,960784
"3060","ENSG00000012061","ENSG00000012061","ERCC1","19",45407334,45478828,71494
"3061","ENSG00000104884","ENSG00000104884","ERCC2","19",45349837,45370918,21081
"3062","ENSG00000163161","ENSG00000163161","ERCC3","2",127257290,127294166,36876
"3063","ENSG00000175595","ENSG00000175595","ERCC4","16",13920138,13952348,32210
"3064","ENSG00000134899","ENSG00000134899","ERCC5","13",102845831,102875995,30164
"3065","ENSG00000225830","ENSG00000225830","ERCC6","10",49454168,49539538,85370
"3066","ENSG00000186871","ENSG00000186871","ERCC6L","X",72204657,72239027,34370
"3067","ENSG00000049167","ENSG00000049167","ERCC8","5",60866454,60945073,78619
"3068","ENSG00000124882","ENSG00000124882","EREG","4",74365145,74388749,23604
"3069","ENSG00000105722","ENSG00000105722","ERF","19",42247569,42255128,7559
"3070","ENSG00000157554","ENSG00000157554","ERG","21",38380027,38661780,281753
"3071","ENSG00000087502","ENSG00000087502","ERGIC2","12",29337352,29381189,43837
"3072","ENSG00000125991","ENSG00000125991","ERGIC3","20",35542038,35557634,15596
"3073","ENSG00000100632","ENSG00000100632","ERH","14",69380128,69398299,18171
"3074","ENSG00000117419","ENSG00000117419","ERI3","1",44221070,44355260,134190
"3075","ENSG00000104714","ENSG00000104714","ERICH1","8",614746,738106,123360
"3076","ENSG00000107566","ENSG00000107566","ERLIN1","10",100150094,100186033,35939
"3077","ENSG00000147475","ENSG00000147475","ERLIN2","8",37736601,37758422,21821
"3078","ENSG00000164010","ENSG00000164010","ERMAP","1",42817122,42844991,27869
"3079","ENSG00000099219","ENSG00000099219","ERMP1","9",5749832,5879537,129705
"3080","ENSG00000134398","ENSG00000134398","ERN2","16",23690310,23713226,22916
"3081","ENSG00000197930","ENSG00000197930","ERO1A","14",52639915,52695900,55985
"3082","ENSG00000086619","ENSG00000086619","ERO1B","1",236214681,236282019,67338
"3083","ENSG00000089248","ENSG00000089248","ERP29","12",112013348,112023449,10101
"3084","ENSG00000023318","ENSG00000023318","ERP44","9",99979185,100099052,119867
"3085","ENSG00000226887","ENSG00000226887","ERVMER34-1","4",52722618,52751586,28968
"3086","ENSG00000139684","ENSG00000139684","ESD","13",46771256,46797420,26164
"3087","ENSG00000089048","ENSG00000089048","ESF1","20",13714322,13784919,70597
"3088","ENSG00000164283","ENSG00000164283","ESM1","5",54977867,55022671,44804
"3089","ENSG00000135476","ENSG00000135476","ESPL1","12",53268299,53293638,25339
"3090","ENSG00000187017","ENSG00000187017","ESPN","1",6424776,6461367,36591
"3091","ENSG00000091831","ENSG00000091831","ESR1","6",151656691,152129619,472928
"3092","ENSG00000140009","ENSG00000140009","ESR2","14",64084232,64338112,253880
"3093","ENSG00000104413","ENSG00000104413","ESRP1","8",94641074,94707466,66392
"3094","ENSG00000103067","ENSG00000103067","ESRP2","16",68229033,68238102,9069
"3095","ENSG00000173153","ENSG00000173153","ESRRA","11",64305497,64316743,11246
"3096","ENSG00000119715","ENSG00000119715","ESRRB","14",76310712,76501837,191125
"3097","ENSG00000196482","ENSG00000196482","ESRRG","1",216503246,217137755,634509
"3098","ENSG00000139641","ENSG00000139641","ESYT1","12",56118250,56144674,26424
"3099","ENSG00000143971","ENSG00000143971","ETAA1","2",67397322,67412089,14767
"3100","ENSG00000120705","ENSG00000120705","ETF1","5",138506095,138543236,37141
"3101","ENSG00000140374","ENSG00000140374","ETFA","15",76188555,76311730,123175
"3102","ENSG00000105379","ENSG00000105379","ETFB","19",51345169,51366388,21219
"3103","ENSG00000171503","ENSG00000171503","ETFDH","4",158671968,158710742,38774
"3104","ENSG00000105755","ENSG00000105755","ETHE1","19",43506719,43527230,20511
"3105","ENSG00000139163","ENSG00000139163","ETNK1","12",22625075,22690665,65590
"3106","ENSG00000143845","ENSG00000143845","ETNK2","1",204131062,204152044,20982
"3107","ENSG00000164089","ENSG00000164089","ETNPPL","4",108742048,108763054,21006
"3108","ENSG00000134954","ENSG00000134954","ETS1","11",128458761,128587558,128797
"3109","ENSG00000157557","ENSG00000157557","ETS2","21",38805183,38824955,19772
"3110","ENSG00000006468","ENSG00000006468","ETV1","7",13891229,13991425,100196
"3111","ENSG00000117036","ENSG00000117036","ETV3","1",157121191,157138474,17283
"3112","ENSG00000175832","ENSG00000175832","ETV4","17",43527844,43579620,51776
"3113","ENSG00000244405","ENSG00000244405","ETV5","3",186046314,186110318,64004
"3114","ENSG00000139083","ENSG00000139083","ETV6","12",11649674,11895377,245703
"3115","ENSG00000010030","ENSG00000010030","ETV7","6",36354091,36387800,33709
"3116","ENSG00000142694","ENSG00000142694","EVA1B","1",36322030,36324154,2124
"3117","ENSG00000072840","ENSG00000072840","EVC","4",5711201,5814305,103104
"3118","ENSG00000126860","ENSG00000126860","EVI2A","17",31316410,31321749,5339
"3119","ENSG00000185862","ENSG00000185862","EVI2B","17",31303770,31314105,10335
"3120","ENSG00000067208","ENSG00000067208","EVI5","1",92508696,92792404,283708
"3121","ENSG00000196405","ENSG00000196405","EVL","14",99971449,100144236,172787
"3122","ENSG00000167880","ENSG00000167880","EVPL","17",76004502,76027306,22804
"3123","ENSG00000106038","ENSG00000106038","EVX1","7",27242700,27250493,7793
"3124","ENSG00000182944","ENSG00000182944","EWSR1","22",29268009,29300525,32516
"3125","ENSG00000081177","ENSG00000081177","EXD2","14",69191498,69244020,52522
"3126","ENSG00000187609","ENSG00000187609","EXD3","9",137306896,137423211,116315
"3127","ENSG00000174371","ENSG00000174371","EXO1","1",241847967,241895148,47181
"3128","ENSG00000164002","ENSG00000164002","EXO5","1",40508741,40516038,7297
"3129","ENSG00000090989","ENSG00000090989","EXOC1","4",55853648,55905086,51438
"3130","ENSG00000112685","ENSG00000112685","EXOC2","6",485154,693139,207985
"3131","ENSG00000180104","ENSG00000180104","EXOC3","5",443175,471937,28762
"3132","ENSG00000070367","ENSG00000070367","EXOC5","14",57200507,57268905,68398
"3133","ENSG00000144036","ENSG00000144036","EXOC6B","2",72175984,72826041,650057
"3134","ENSG00000182473","ENSG00000182473","EXOC7","17",76081016,76121576,40560
"3135","ENSG00000157036","ENSG00000157036","EXOG","3",38496127,38542161,46034
"3136","ENSG00000171311","ENSG00000171311","EXOSC1","10",97435909,97446017,10108
"3137","ENSG00000171824","ENSG00000171824","EXOSC10","1",11066618,11099869,33251
"3138","ENSG00000130713","ENSG00000130713","EXOSC2","9",130693721,130707288,13567
"3139","ENSG00000178896","ENSG00000178896","EXOSC4","8",144078648,144080648,2000
"3140","ENSG00000077348","ENSG00000077348","EXOSC5","19",41386371,41397362,10991
"3141","ENSG00000075914","ENSG00000075914","EXOSC7","3",44975241,45036066,60825
"3142","ENSG00000120699","ENSG00000120699","EXOSC8","13",36998816,37025881,27065
"3143","ENSG00000123737","ENSG00000123737","EXOSC9","4",121801318,121817021,15703
"3144","ENSG00000110723","ENSG00000110723","EXPH5","11",108505435,108593768,88333
"3145","ENSG00000182197","ENSG00000182197","EXT1","8",117794490,118111826,317336
"3146","ENSG00000151348","ENSG00000151348","EXT2","11",44095648,44251962,156314
"3147","ENSG00000158008","ENSG00000158008","EXTL1","1",26019884,26036464,16580
"3148","ENSG00000162694","ENSG00000162694","EXTL2","1",100872372,100895179,22807
"3149","ENSG00000012232","ENSG00000012232","EXTL3","8",28600469,28756561,156092
"3150","ENSG00000104313","ENSG00000104313","EYA1","8",71197433,71592025,394592
"3151","ENSG00000064655","ENSG00000064655","EYA2","20",46894624,47188844,294220
"3152","ENSG00000158161","ENSG00000158161","EYA3","1",27970344,28088637,118293
"3153","ENSG00000112319","ENSG00000112319","EYA4","6",133240514,133532128,291614
"3154","ENSG00000108799","ENSG00000108799","EZH1","17",42700275,42745049,44774
"3155","ENSG00000106462","ENSG00000106462","EZH2","7",148807257,148884321,77064
"3156","ENSG00000092820","ENSG00000092820","EZR","6",158765741,158819368,53627
"3157","ENSG00000126218","ENSG00000126218","F10","13",113122799,113149529,26730
"3158","ENSG00000088926","ENSG00000088926","F11","4",186266189,186289681,23492
"3159","ENSG00000158769","ENSG00000158769","F11R","1",160995211,161021175,25964
"3160","ENSG00000131187","ENSG00000131187","F12","5",177402133,177416583,14450
"3161","ENSG00000124491","ENSG00000124491","F13A1","6",6144084,6321013,176929
"3162","ENSG00000143278","ENSG00000143278","F13B","1",197038741,197067260,28519
"3163","ENSG00000180210","ENSG00000180210","F2","11",46719196,46739506,20310
"3164","ENSG00000181104","ENSG00000181104","F2R","5",76716126,76735770,19644
"3165","ENSG00000164251","ENSG00000164251","F2RL1","5",76818933,76835315,16382
"3166","ENSG00000164220","ENSG00000164220","F2RL2","5",76615482,76623413,7931
"3167","ENSG00000127533","ENSG00000127533","F2RL3","19",16888999,16892606,3607
"3168","ENSG00000117525","ENSG00000117525","F3","1",94529173,94541759,12586
"3169","ENSG00000198734","ENSG00000198734","F5","1",169511951,169586588,74637
"3170","ENSG00000057593","ENSG00000057593","F7","13",113105788,113120685,14897
"3171","ENSG00000185010","ENSG00000185010","F8","X",154835788,155026940,191152
"3172","ENSG00000101981","ENSG00000101981","F9","X",139530739,139563459,32720
"3173","ENSG00000103089","ENSG00000103089","FA2H","16",74712955,74774831,61876
"3174","ENSG00000117480","ENSG00000117480","FAAH","1",46394317,46413848,19531
"3175","ENSG00000185504","ENSG00000185504","FAAP100","17",81539885,81553961,14076
"3176","ENSG00000163586","ENSG00000163586","FABP1","2",88122982,88128062,5080
"3177","ENSG00000145384","ENSG00000145384","FABP2","4",119317250,119322138,4888
"3178","ENSG00000121769","ENSG00000121769","FABP3","1",31365253,31376850,11597
"3179","ENSG00000170323","ENSG00000170323","FABP4","8",81478419,81483236,4817
"3180","ENSG00000164687","ENSG00000164687","FABP5","8",81280536,81284777,4241
"3181","ENSG00000170231","ENSG00000170231","FABP6","5",160187367,160238735,51368
"3182","ENSG00000164434","ENSG00000164434","FABP7","6",122779716,122784074,4358
"3183","ENSG00000168040","ENSG00000168040","FADD","11",70203296,70207390,4094
"3184","ENSG00000149485","ENSG00000149485","FADS1","11",61799627,61829318,29691
"3185","ENSG00000134824","ENSG00000134824","FADS2","11",61792980,61867354,74374
"3186","ENSG00000221968","ENSG00000221968","FADS3","11",61873519,61892051,18532
"3187","ENSG00000185104","ENSG00000185104","FAF1","1",50437028,50960267,523239
"3188","ENSG00000113194","ENSG00000113194","FAF2","5",176447628,176510074,62446
"3189","ENSG00000103876","ENSG00000103876","FAH","15",80152490,80186946,34456
"3190","ENSG00000115042","ENSG00000115042","FAHD2A","2",95402708,95416616,13908
"3191","ENSG00000144199","ENSG00000144199","FAHD2B","2",97083583,97094882,11299
"3192","ENSG00000158234","ENSG00000158234","FAIM","3",138608606,138633376,24770
"3193","ENSG00000135472","ENSG00000135472","FAIM2","12",49866896,49904217,37321
"3194","ENSG00000168309","ENSG00000168309","FAM107A","3",58564117,58627610,63493
"3195","ENSG00000169122","ENSG00000169122","FAM110B","8",57994523,58204279,209756
"3196","ENSG00000197245","ENSG00000197245","FAM110D","1",26159079,26163962,4883
"3197","ENSG00000166801","ENSG00000166801","FAM111A","11",59142748,59155039,12291
"3198","ENSG00000197712","ENSG00000197712","FAM114A1","4",38867677,38945739,78062
"3199","ENSG00000055147","ENSG00000055147","FAM114A2","5",153990148,154038936,48788
"3200","ENSG00000121104","ENSG00000121104","FAM117A","17",49710332,49789180,78848
"3201","ENSG00000100376","ENSG00000100376","FAM118A","22",45308968,45341955,32987
"3202","ENSG00000048828","ENSG00000048828","FAM120A","9",93451685,93566112,114427
"3203","ENSG00000184083","ENSG00000184083","FAM120C","X",54068324,54183281,114957
"3204","ENSG00000124019","ENSG00000124019","FAM124B","2",224378698,224402107,23409
"3205","ENSG00000159784","ENSG00000159784","FAM131B","7",143353400,143362770,9370
"3206","ENSG00000082269","ENSG00000082269","FAM135A","6",70412941,70561174,148233
"3207","ENSG00000035141","ENSG00000035141","FAM136A","2",70295976,70302067,6091
"3208","ENSG00000138640","ENSG00000138640","FAM13A","4",88725955,89111398,385443
"3209","ENSG00000031003","ENSG00000031003","FAM13B","5",137937960,138051961,114001
"3210","ENSG00000148541","ENSG00000148541","FAM13C","10",59246130,59363181,117051
"3211","ENSG00000109794","ENSG00000109794","FAM149A","4",186104419,186175337,70918
"3212","ENSG00000138286","ENSG00000138286","FAM149B1","10",73168119,73244504,76385
"3213","ENSG00000170074","ENSG00000170074","FAM153A","5",177707981,177784435,76454
"3214","ENSG00000114023","ENSG00000114023","FAM162A","3",122384161,122412334,28173
"3215","ENSG00000054965","ENSG00000054965","FAM168A","11",73400487,73598189,197702
"3216","ENSG00000152102","ENSG00000152102","FAM168B","2",131047876,131093460,45584
"3217","ENSG00000198780","ENSG00000198780","FAM169A","5",74777574,74866966,89392
"3218","ENSG00000148468","ENSG00000148468","FAM171A1","10",15211643,15371289,159646
"3219","ENSG00000113391","ENSG00000113391","ARB2A","5",93617725,94111699,493974
"3220","ENSG00000185442","ENSG00000185442","FAM174B","15",92617448,92809884,192436
"3221","ENSG00000111879","ENSG00000111879","FAM184A","6",118959763,119149387,189624
"3222","ENSG00000125386","ENSG00000125386","FAM193A","4",2536647,2732573,195926
"3223","ENSG00000146067","ENSG00000146067","FAM193B","5",177519789,177554586,34797
"3224","ENSG00000165669","ENSG00000165669","FAM204A","10",118297925,118342328,44403
"3225","ENSG00000116199","ENSG00000116199","FAM20B","1",179025804,179076567,50763
"3226","ENSG00000204856","ENSG00000204856","FAM216A","12",110468415,110490385,21970
"3227","ENSG00000173065","ENSG00000173065","FAM222B","17",28755980,28855232,99252
"3228","ENSG00000166262","ENSG00000166262","FAM227B","15",49326962,49620929,293967
"3229","ENSG00000084444","ENSG00000084444","FAM234B","12",13044381,13142521,98140
"3230","ENSG00000105058","ENSG00000105058","FAM32A","19",16185380,16192046,6666
"3231","ENSG00000071889","ENSG00000071889","FAM3A","X",154506159,154516242,10083
"3232","ENSG00000196937","ENSG00000196937","FAM3C","7",121348878,121396364,47486
"3233","ENSG00000145945","ENSG00000145945","FAM50B","6",3849373,3851320,1947
"3234","ENSG00000189319","ENSG00000189319","FAM53B","10",124619292,124744378,125086
"3235","ENSG00000120709","ENSG00000120709","FAM53C","5",138331935,138349729,17794
"3236","ENSG00000105523","ENSG00000105523","FAM83E","19",48599961,48615076,15115
"3237","ENSG00000176973","ENSG00000176973","FAM89B","11",65572349,65574198,1849
"3238","ENSG00000137414","ENSG00000137414","FAM8A1","6",17600302,17611719,11417
"3239","ENSG00000119812","ENSG00000119812","FAM98A","2",33532744,33599347,66603
"3240","ENSG00000276787","ENSG00000276787","FAN1","HSCHR15_4_CTG8",3189605,3228834,39229
"3241","ENSG00000187741","ENSG00000187741","FANCA","16",89726683,89816977,90294
"3242","ENSG00000158169","ENSG00000158169","FANCC","9",95099054,95426796,327742
"3243","ENSG00000112039","ENSG00000112039","FANCE","6",35452338,35467104,14766
"3244","ENSG00000183161","ENSG00000183161","FANCF","11",22622533,22625823,3290
"3245","ENSG00000221829","ENSG00000221829","FANCG","9",35073835,35080004,6169
"3246","ENSG00000115392","ENSG00000115392","FANCL","2",58159243,58241410,82167
"3247","ENSG00000078098","ENSG00000078098","FAP","2",162170684,162245151,74467
"3248","ENSG00000064763","ENSG00000064763","FAR2","12",29149016,29341121,192105
"3249","ENSG00000152767","ENSG00000152767","FARP1","13",98142562,98455176,312614
"3250","ENSG00000006607","ENSG00000006607","FARP2","2",241356285,241494841,138556
"3251","ENSG00000145982","ENSG00000145982","FARS2","6",5261044,5829192,568148
"3252","ENSG00000179115","ENSG00000179115","FARSA","19",12922479,12934037,11558
"3253","ENSG00000026103","ENSG00000026103","FAS","10",88953813,89029605,75792
"3254","ENSG00000169710","ENSG00000169710","FASN","17",82078338,82098294,19956
"3255","ENSG00000164896","ENSG00000164896","FASTK","7",151076624,151080866,4242
"3256","ENSG00000138399","ENSG00000138399","FASTKD1","2",169528508,169573875,45367
"3257","ENSG00000118246","ENSG00000118246","FASTKD2","2",206765357,206796189,30832
"3258","ENSG00000124279","ENSG00000124279","FASTKD3","5",7859159,7869037,9878
"3259","ENSG00000215251","ENSG00000215251","FASTKD5","20",3146519,3159865,13346
"3260","ENSG00000083857","ENSG00000083857","FAT1","4",186587794,186726722,138928
"3261","ENSG00000086570","ENSG00000086570","FAT2","5",151504092,151591331,87239
"3262","ENSG00000196159","ENSG00000196159","FAT4","4",125314918,125492932,178014
"3263","ENSG00000149806","ENSG00000149806","FAU","11",65120630,65122177,1547
"3264","ENSG00000170271","ENSG00000170271","FAXDC2","5",154818492,154859252,40760
"3265","ENSG00000280548","ENSG00000280548","FBL","HG2021_PATCH",94334,106255,11921
"3266","ENSG00000077942","ENSG00000077942","FBLN1","22",45502238,45601135,98897
"3267","ENSG00000163520","ENSG00000163520","FBLN2","3",13549125,13638422,89297
"3268","ENSG00000140092","ENSG00000140092","FBLN5","14",91869411,91947987,78576
"3269","ENSG00000166147","ENSG00000166147","FBN1","15",48408313,48645721,237408
"3270","ENSG00000138829","ENSG00000138829","FBN2","5",128257909,128659185,401276
"3271","ENSG00000165140","ENSG00000165140","FBP1","9",94603133,94640249,37116
"3272","ENSG00000130957","ENSG00000130957","FBP2","9",94558720,94593824,35104
"3273","ENSG00000156860","ENSG00000156860","FBRS","16",30658431,30670810,12379
"3274","ENSG00000127452","ENSG00000127452","FBXL12","19",9810267,9827816,17549
"3275","ENSG00000171823","ENSG00000171823","FBXL14","12",1565993,1594581,28588
"3276","ENSG00000107872","ENSG00000107872","FBXL15","10",102419189,102423136,3947
"3277","ENSG00000155034","ENSG00000155034","FBXL18","7",5431335,5513809,82474
"3278","ENSG00000153558","ENSG00000153558","FBXL2","3",33277025,33403662,126637
"3279","ENSG00000112234","ENSG00000112234","FBXL4","6",98868535,98948006,79471
"3280","ENSG00000118564","ENSG00000118564","FBXL5","4",15604381,15681679,77298
"3281","ENSG00000182325","ENSG00000182325","FBXL6","8",144355431,144359376,3945
"3282","ENSG00000183580","ENSG00000183580","FBXL7","5",15500180,15939795,439615
"3283","ENSG00000135722","ENSG00000135722","FBXL8","16",67159932,67164570,4638
"3284","ENSG00000138081","ENSG00000138081","FBXO11","2",47789316,47906498,117182
"3285","ENSG00000214050","ENSG00000214050","FBXO16","8",28348287,28490278,141991
"3286","ENSG00000269190","ENSG00000269190","FBXO17","19",38941401,38975742,34341
"3287","ENSG00000116661","ENSG00000116661","FBXO2","1",11637018,11655785,18767
"3288","ENSG00000135108","ENSG00000135108","FBXO21","12",117141991,117190470,48479
"3289","ENSG00000167196","ENSG00000167196","FBXO22","15",75903876,75942511,38635
"3290","ENSG00000143756","ENSG00000143756","FBXO28","1",224114111,224162047,47936
"3291","ENSG00000110429","ENSG00000110429","FBXO3","11",33740939,33774543,33604
"3292","ENSG00000103264","ENSG00000103264","FBXO31","16",87326987,87392142,65155
"3293","ENSG00000178974","ENSG00000178974","FBXO34","14",55271344,55370053,98709
"3294","ENSG00000145868","ENSG00000145868","FBXO38","5",148383935,148442836,58901
"3295","ENSG00000151876","ENSG00000151876","FBXO4","5",41925254,41941743,16489
"3296","ENSG00000163833","ENSG00000163833","FBXO40","3",121593379,121630295,36916
"3297","ENSG00000163013","ENSG00000163013","FBXO41","2",73254682,73284478,29796
"3298","ENSG00000037637","ENSG00000037637","FBXO42","1",16246840,16352480,105640
"3299","ENSG00000177051","ENSG00000177051","FBXO46","19",45710629,45730896,20267
"3300","ENSG00000112029","ENSG00000112029","FBXO5","6",152970519,152983579,13060
"3301","ENSG00000100225","ENSG00000100225","FBXO7","22",32474676,32498829,24153
"3302","ENSG00000112146","ENSG00000112146","FBXO9","6",53051991,53100873,48882
"3303","ENSG00000072803","ENSG00000072803","FBXW11","5",171861549,172006873,145324
"3304","ENSG00000119402","ENSG00000119402","FBXW2","9",120751978,120793416,41438
"3305","ENSG00000107829","ENSG00000107829","FBXW4","10",101610664,101695295,84631
"3306","ENSG00000109670","ENSG00000109670","FBXW7","4",152320544,152536092,215548
"3307","ENSG00000278415","ENSG00000278415","FCAR","HSCHR19LRC_COX2_CTG3_1",519503,536649,17146
"3308","ENSG00000179639","ENSG00000179639","FCER1A","1",159289714,159308224,18510
"3309","ENSG00000158869","ENSG00000158869","FCER1G","1",161215234,161220699,5465
"3310","ENSG00000104921","ENSG00000104921","FCER2","19",7688758,7702146,13388
"3311","ENSG00000119616","ENSG00000119616","FCF1","14",74713144,74738620,25476
"3312","ENSG00000281123","ENSG00000281123","FCGBP","HG2021_PATCH",123199,209777,86578
"3313","ENSG00000150337","ENSG00000150337","FCGR1A","1",149782671,149791675,9004
"3314","ENSG00000143226","ENSG00000143226","FCGR2A","1",161505430,161524013,18583
"3315","ENSG00000072694","ENSG00000072694","FCGR2B","1",161663143,161678654,15511
"3316","ENSG00000203747","ENSG00000203747","FCGR3A","1",161541759,161550968,9209
"3317","ENSG00000162747","ENSG00000162747","FCGR3B","1",161623196,161631963,8767
"3318","ENSG00000104870","ENSG00000104870","FCGRT","19",49506816,49526428,19612
"3319","ENSG00000130475","ENSG00000130475","FCHO1","19",17747718,17788568,40850
"3320","ENSG00000137478","ENSG00000137478","FCHSD2","11",72836745,73142318,305573
"3321","ENSG00000162894","ENSG00000162894","FCMR","1",206903317,206923247,19930
"3322","ENSG00000085265","ENSG00000085265","FCN1","9",134903232,134917912,14680
"3323","ENSG00000160339","ENSG00000160339","FCN2","9",134880810,134887523,6713
"3324","ENSG00000142748","ENSG00000142748","FCN3","1",27369110,27374824,5714
"3325","ENSG00000132704","ENSG00000132704","FCRL2","1",157745733,157777132,31399
"3326","ENSG00000079459","ENSG00000079459","FDFT1","8",11795573,11839395,43822
"3327","ENSG00000160752","ENSG00000160752","FDPS","1",155308748,155320666,11918
"3328","ENSG00000161513","ENSG00000161513","FDXR","17",74862497,74873031,10534
"3329","ENSG00000066926","ENSG00000066926","FECH","18",57544377,57586732,42355
"3330","ENSG00000169018","ENSG00000169018","FEM1B","15",68277745,68295862,18117
"3331","ENSG00000145780","ENSG00000145780","FEM1C","5",115520908,115544775,23867
"3332","ENSG00000168496","ENSG00000168496","FEN1","11",61792911,61797238,4327
"3333","ENSG00000151422","ENSG00000151422","FER","5",108747841,109196841,449000
"3334","ENSG00000101311","ENSG00000101311","FERMT1","20",6074845,6123214,48369
"3335","ENSG00000073712","ENSG00000073712","FERMT2","14",52857268,52952435,95167
"3336","ENSG00000182511","ENSG00000182511","FES","15",90883695,90895776,12081
"3337","ENSG00000090512","ENSG00000090512","FETUB","3",186635969,186653141,17172
"3338","ENSG00000163497","ENSG00000163497","FEV","2",218981087,218985184,4097
"3339","ENSG00000149557","ENSG00000149557","FEZ1","11",125442881,125592568,149687
"3340","ENSG00000171055","ENSG00000171055","FEZ2","2",36531805,36646087,114282
"3341","ENSG00000153266","ENSG00000153266","FEZF2","3",62369681,62374324,4643
"3342","ENSG00000126262","ENSG00000126262","FFAR2","19",35443907,35451767,7860
"3343","ENSG00000185897","ENSG00000185897","FFAR3","19",35358460,35360489,2029
"3344","ENSG00000171560","ENSG00000171560","FGA","4",154583126,154590742,7616
"3345","ENSG00000171564","ENSG00000171564","FGB","4",154563011,154572807,9796
"3346","ENSG00000102302","ENSG00000102302","FGD1","X",54445454,54496234,50780
"3347","ENSG00000180263","ENSG00000180263","FGD6","12",95076749,95217482,140733
"3348","ENSG00000113578","ENSG00000113578","FGF1","5",142592178,142698070,105892
"3349","ENSG00000114279","ENSG00000114279","FGF12","3",192139390,192767764,628374
"3350","ENSG00000129682","ENSG00000129682","FGF13","X",138614727,139222777,608050
"3351","ENSG00000102466","ENSG00000102466","FGF14","13",101710804,102402457,691653
"3352","ENSG00000156427","ENSG00000156427","FGF18","5",171419647,171457626,37979
"3353","ENSG00000138685","ENSG00000138685","FGF2","4",122826682,122898236,71554
"3354","ENSG00000078579","ENSG00000078579","FGF20","8",16992181,17002345,10164
"3355","ENSG00000105550","ENSG00000105550","FGF21","19",48755524,48758333,2809
"3356","ENSG00000118972","ENSG00000118972","FGF23","12",4368227,4379712,11485
"3357","ENSG00000138675","ENSG00000138675","FGF5","4",80266639,80336680,70041
"3358","ENSG00000107831","ENSG00000107831","FGF8","10",101770109,101780371,10262
"3359","ENSG00000102678","ENSG00000102678","FGF9","13",21671073,21704498,33425
"3360","ENSG00000137440","ENSG00000137440","FGFBP1","4",15935577,15938740,3163
"3361","ENSG00000077782","ENSG00000077782","FGFR1","8",38400215,38468834,68619
"3362","ENSG00000066468","ENSG00000066468","FGFR2","10",121478332,121598458,120126
"3363","ENSG00000068078","ENSG00000068078","FGFR3","4",1793293,1808872,15579
"3364","ENSG00000160867","ENSG00000160867","FGFR4","5",177086905,177098144,11239
"3365","ENSG00000171557","ENSG00000171557","FGG","4",154604134,154612967,8833
"3366","ENSG00000172456","ENSG00000172456","FGGY","1",59296638,59810647,514009
"3367","ENSG00000104760","ENSG00000104760","FGL1","8",17864380,17910365,45985
"3368","ENSG00000127951","ENSG00000127951","FGL2","7",77193369,77199848,6479
"3369","ENSG00000000938","ENSG00000000938","FGR","1",27612064,27635185,23121
"3370","ENSG00000091483","ENSG00000091483","FH","1",241497511,241519799,22288
"3371","ENSG00000189283","ENSG00000189283","FHIT","3",59747277,61251459,1504182
"3372","ENSG00000022267","ENSG00000022267","FHL1","X",136146702,136211359,64657
"3373","ENSG00000115641","ENSG00000115641","FHL2","2",105357712,105438513,80801
"3374","ENSG00000183386","ENSG00000183386","FHL3","1",37996770,38005606,8836
"3375","ENSG00000112214","ENSG00000112214","FHL5","6",96562548,96618626,56078
"3376","ENSG00000135723","ENSG00000135723","FHOD1","16",67229387,67247481,18094
"3377","ENSG00000134775","ENSG00000134775","FHOD3","18",36297713,36780220,482507
"3378","ENSG00000172500","ENSG00000172500","FIBP","11",65883740,65888531,4791
"3379","ENSG00000198855","ENSG00000198855","FICD","12",108515277,108525837,10560
"3380","ENSG00000112367","ENSG00000112367","FIG4","6",109690609,109878098,187489
"3381","ENSG00000168386","ENSG00000168386","FILIP1L","3",99828811,100114513,285702
"3382","ENSG00000145216","ENSG00000145216","FIP1L1","4",53377569,53464382,86813
"3383","ENSG00000214253","ENSG00000214253","FIS1","7",101239458,101252316,12858
"3384","ENSG00000179431","ENSG00000179431","FJX1","11",35618460,35620865,2405
"3385","ENSG00000141756","ENSG00000141756","FKBP10","17",41812680,41823213,10533
"3386","ENSG00000134285","ENSG00000134285","FKBP11","12",48921518,48926474,4956
"3387","ENSG00000106080","ENSG00000106080","FKBP14","7",30010587,30026702,16115
"3388","ENSG00000119321","ENSG00000119321","FKBP15","9",113161006,113221458,60452
"3389","ENSG00000088832","ENSG00000088832","FKBP1A","20",1368977,1393164,24187
"3390","ENSG00000119782","ENSG00000119782","FKBP1B","2",24049701,24063681,13980
"3391","ENSG00000173486","ENSG00000173486","FKBP2","11",64241003,64244132,3129
"3392","ENSG00000100442","ENSG00000100442","FKBP3","14",45115599,45135319,19720
"3393","ENSG00000004478","ENSG00000004478","FKBP4","12",2794970,2805423,10453
"3394","ENSG00000077800","ENSG00000077800","FKBP6","7",73328161,73358637,30476
"3395","ENSG00000105701","ENSG00000105701","FKBP8","19",18531751,18544077,12326
"3396","ENSG00000122642","ENSG00000122642","FKBP9","7",32957404,33006930,49526
"3397","ENSG00000230907","ENSG00000230907","FKBPL","HSCHR6_MHC_COX_CTG1",3567038,3568622,1584
"3398","ENSG00000181027","ENSG00000181027","FKRP","19",46746046,46776988,30942
"3399","ENSG00000106692","ENSG00000106692","FKTN","9",105558122,105653820,95698
"3400","ENSG00000160688","ENSG00000160688","FLAD1","1",154983338,154993111,9773
"3401","ENSG00000154803","ENSG00000154803","FLCN","17",17212212,17237188,24976
"3402","ENSG00000151702","ENSG00000151702","FLI1","11",128686535,128813267,126732
"3403","ENSG00000177731","ENSG00000177731","FLII","17",18244815,18258738,13923
"3404","ENSG00000196924","ENSG00000196924","FLNA","X",154348524,154374634,26110
"3405","ENSG00000136068","ENSG00000136068","FLNB","3",58008398,58172251,163853
"3406","ENSG00000128591","ENSG00000128591","FLNC","7",128830406,128859274,28868
"3407","ENSG00000224740","ENSG00000224740","FLOT1","HSCHR6_MHC_MCF_CTG1",2071784,2085614,13830
"3408","ENSG00000132589","ENSG00000132589","FLOT2","17",28879335,28897733,18398
"3409","ENSG00000126500","ENSG00000126500","FLRT1","11",64035931,64119173,83242
"3410","ENSG00000185070","ENSG00000185070","FLRT2","14",85530144,85654428,124284
"3411","ENSG00000125848","ENSG00000125848","FLRT3","20",14322985,14337614,14629
"3412","ENSG00000102755","ENSG00000102755","FLT1","13",28300346,28495145,194799
"3413","ENSG00000122025","ENSG00000122025","FLT3","13",28003274,28100592,97318
"3414","ENSG00000090554","ENSG00000090554","FLT3LG","19",49474207,49486231,12024
"3415","ENSG00000037280","ENSG00000037280","FLT4","5",180601506,180649624,48118
"3416","ENSG00000119686","ENSG00000119686","FLVCR2","14",75578620,75663214,84594
"3417","ENSG00000184922","ENSG00000184922","FMNL1","17",45221444,45247319,25875
"3418","ENSG00000010932","ENSG00000010932","FMO1","1",171248471,171285978,37507
"3419","ENSG00000094963","ENSG00000094963","FMO2","1",171185249,171212686,27437
"3420","ENSG00000007933","ENSG00000007933","FMO3","1",171090901,171117819,26918
"3421","ENSG00000076258","ENSG00000076258","FMO4","1",171314183,171342084,27901
"3422","ENSG00000131781","ENSG00000131781","FMO5","1",147175351,147243050,67699
"3423","ENSG00000122176","ENSG00000122176","FMOD","1",203340628,203351758,11130
"3424","ENSG00000167363","ENSG00000167363","FN3K","17",82735615,82751196,15581
"3425","ENSG00000141560","ENSG00000141560","FN3KRP","17",82716706,82730328,13622
"3426","ENSG00000187239","ENSG00000187239","FNBP1","9",129887187,130043189,156002
"3427","ENSG00000137942","ENSG00000137942","FNBP1L","1",93448118,93554661,106543
"3428","ENSG00000109920","ENSG00000109920","FNBP4","11",47716494,47767443,50949
"3429","ENSG00000125531","ENSG00000125531","FNDC11","20",63547891,63556695,8804
"3430","ENSG00000102531","ENSG00000102531","FNDC3A","13",48975912,49209779,233867
"3431","ENSG00000075420","ENSG00000075420","FNDC3B","3",172039578,172401669,362091
"3432","ENSG00000115226","ENSG00000115226","FNDC4","2",27491883,27495200,3317
"3433","ENSG00000073598","ENSG00000073598","FNDC8","17",35121615,35130732,9117
"3434","ENSG00000168522","ENSG00000168522","FNTA","8",43034194,43085788,51594
"3435","ENSG00000257365","ENSG00000257365","FNTB","14",64986895,65062652,75757
"3436","ENSG00000188352","ENSG00000188352","FOCAD","9",20658309,20995955,337646
"3437","ENSG00000086205","ENSG00000086205","FOLH1","11",49145092,49208638,63546
"3438","ENSG00000110195","ENSG00000110195","FOLR1","11",72189558,72196323,6765
"3439","ENSG00000165457","ENSG00000165457","FOLR2","11",72216601,72221950,5349
"3440","ENSG00000110203","ENSG00000110203","FOLR3","11",72114869,72139892,25023
"3441","ENSG00000170345","ENSG00000170345","FOS","14",75278826,75282230,3404
"3442","ENSG00000125740","ENSG00000125740","FOSB","19",45467995,45475179,7184
"3443","ENSG00000175592","ENSG00000175592","FOSL1","11",65892049,65900573,8524
"3444","ENSG00000075426","ENSG00000075426","FOSL2","2",28392448,28417317,24869
"3445","ENSG00000129514","ENSG00000129514","FOXA1","14",37589552,37596059,6507
"3446","ENSG00000125798","ENSG00000125798","FOXA2","20",22580998,22585455,4457
"3447","ENSG00000171956","ENSG00000171956","FOXB1","15",60004234,60061730,57496
"3448","ENSG00000054598","ENSG00000054598","FOXC1","6",1609915,1613897,3982
"3449","ENSG00000176692","ENSG00000176692","FOXC2","16",86566829,86569728,2899
"3450","ENSG00000251493","ENSG00000251493","FOXD1","5",73444827,73448777,3950
"3451","ENSG00000186564","ENSG00000186564","FOXD2","1",47438044,47440691,2647
"3452","ENSG00000184492","ENSG00000184492","FOXD4L1","2",113498665,113501150,2485
"3453","ENSG00000178919","ENSG00000178919","FOXE1","9",97853226,97856717,3491
"3454","ENSG00000186790","ENSG00000186790","FOXE3","1",47416285,47418052,1767
"3455","ENSG00000103241","ENSG00000103241","FOXF1","16",86510527,86515422,4895
"3456","ENSG00000137273","ENSG00000137273","FOXF2","6",1389576,1395603,6027
"3457","ENSG00000176165","ENSG00000176165","FOXG1","14",28764329,28770277,5948
"3458","ENSG00000160973","ENSG00000160973","FOXH1","8",144473412,144475849,2437
"3459","ENSG00000168269","ENSG00000168269","FOXI1","5",170105897,170109734,3837
"3460","ENSG00000065970","ENSG00000065970","FOXJ2","12",8032716,8055517,22801
"3461","ENSG00000198815","ENSG00000198815","FOXJ3","1",42176539,42335877,159338
"3462","ENSG00000141568","ENSG00000141568","FOXK2","17",82519713,82644662,124949
"3463","ENSG00000183770","ENSG00000183770","FOXL2","3",138944224,138947137,2913
"3464","ENSG00000111206","ENSG00000111206","FOXM1","12",2857680,2877174,19494
"3465","ENSG00000109101","ENSG00000109101","FOXN1","17",28506243,28538900,32657
"3466","ENSG00000170802","ENSG00000170802","FOXN2","2",48314637,48379295,64658
"3467","ENSG00000053254","ENSG00000053254","FOXN3","14",89124871,89619149,494278
"3468","ENSG00000150907","ENSG00000150907","FOXO1","13",40555667,40666641,110974
"3469","ENSG00000118689","ENSG00000118689","FOXO3","6",108559835,108684774,124939
"3470","ENSG00000184481","ENSG00000184481","FOXO4","X",71095851,71103532,7681
"3471","ENSG00000100350","ENSG00000100350","FOXRED2","22",36487190,36507221,20031
"3472","ENSG00000136877","ENSG00000136877","FPGS","9",127794597,127814327,19730
"3473","ENSG00000254685","ENSG00000254685","FPGT","1",74198238,74234086,35848
"3474","ENSG00000171051","ENSG00000171051","FPR1","19",51745172,51804115,58943
"3475","ENSG00000171049","ENSG00000171049","FPR2","19",51752026,51770531,18505
"3476","ENSG00000187474","ENSG00000187474","FPR3","19",51795157,51826190,31033
"3477","ENSG00000138759","ENSG00000138759","FRAS1","4",78057323,78544269,486946
"3478","ENSG00000165879","ENSG00000165879","FRAT1","10",97319271,97321915,2644
"3479","ENSG00000181274","ENSG00000181274","FRAT2","10",97332497,97334729,2232
"3480","ENSG00000275145","ENSG00000275145","FRG1","HSCHR4_6_CTG12",278318,300735,22417
"3481","ENSG00000111816","ENSG00000111816","FRK","6",115931149,116060891,129742
"3482","ENSG00000151474","ENSG00000151474","FRMD4A","10",13643706,14462142,818436
"3483","ENSG00000114541","ENSG00000114541","FRMD4B","3",69168782,69542583,373801
"3484","ENSG00000126391","ENSG00000126391","FRMD8","11",65386621,65413525,26904
"3485","ENSG00000070601","ENSG00000070601","FRMPD1","9",37650954,37746904,95950
"3486","ENSG00000169933","ENSG00000169933","FRMPD4","X",11822423,12724523,902100
"3487","ENSG00000260230","ENSG00000260230","FRRS1L","9",109130293,109167249,36956
"3488","ENSG00000166225","ENSG00000166225","FRS2","12",69470349,69579793,109444
"3489","ENSG00000137218","ENSG00000137218","FRS3","6",41770176,41786542,16366
"3490","ENSG00000073910","ENSG00000073910","FRY","13",31846713,32299125,452412
"3491","ENSG00000075539","ENSG00000075539","FRYL","4",48497357,48780322,282965
"3492","ENSG00000162998","ENSG00000162998","FRZB","2",182833275,182866637,33362
"3493","ENSG00000075618","ENSG00000075618","FSCN1","7",5592816,5606655,13839
"3494","ENSG00000186765","ENSG00000186765","FSCN2","17",81528377,81537130,8753
"3495","ENSG00000106328","ENSG00000106328","FSCN3","7",127591409,127602144,10735
"3496","ENSG00000105255","ENSG00000105255","FSD1","19",4304598,4323843,19245
"3497","ENSG00000170820","ENSG00000170820","FSHR","2",48962157,49154527,192370
"3498","ENSG00000134363","ENSG00000134363","FST","5",53480626,53487134,6508
"3499","ENSG00000163430","ENSG00000163430","FSTL1","3",120392293,120451016,58723
"3500","ENSG00000070404","ENSG00000070404","FSTL3","19",676392,683392,7000
"3501","ENSG00000053108","ENSG00000053108","FSTL4","5",133196455,133612541,416086
"3502","ENSG00000160282","ENSG00000160282","FTCD","21",46136160,46155579,19419
"3503","ENSG00000167996","ENSG00000167996","FTH1","11",61959718,61967634,7916
"3504","ENSG00000087086","ENSG00000087086","FTL","19",48965309,48966879,1570
"3505","ENSG00000140718","ENSG00000140718","FTO","16",53701692,54158512,456820
"3506","ENSG00000068438","ENSG00000068438","FTSJ1","X",48476021,48486364,10343
"3507","ENSG00000108592","ENSG00000108592","FTSJ3","17",63819433,63830012,10579
"3508","ENSG00000162613","ENSG00000162613","FUBP1","1",77944055,77979110,35055
"3509","ENSG00000107164","ENSG00000107164","FUBP3","9",130578965,130638352,59387
"3510","ENSG00000179163","ENSG00000179163","FUCA1","1",23845077,23868290,23213
"3511","ENSG00000140564","ENSG00000140564","FURIN","15",90868588,90883564,14976
"3512","ENSG00000089280","ENSG00000089280","FUS","16",31180138,31196963,16825
"3513","ENSG00000174951","ENSG00000174951","FUT1","19",48748011,48755390,7379
"3514","ENSG00000176920","ENSG00000176920","FUT2","19",48695971,48705951,9980
"3515","ENSG00000171124","ENSG00000171124","FUT3","19",5842888,5851471,8583
"3516","ENSG00000196371","ENSG00000196371","FUT4","11",94543921,94549895,5974
"3517","ENSG00000156413","ENSG00000156413","FUT6","19",5830408,5839722,9314
"3518","ENSG00000180549","ENSG00000180549","FUT7","9",137030174,137032088,1914
"3519","ENSG00000033170","ENSG00000033170","FUT8","14",65410592,65744121,333529
"3520","ENSG00000172461","ENSG00000172461","FUT9","6",96015974,96215612,199638
"3521","ENSG00000010361","ENSG00000010361","FUZ","19",49806866,49817376,10510
"3522","ENSG00000165060","ENSG00000165060","FXN","9",69035751,69079076,43325
"3523","ENSG00000114416","ENSG00000114416","FXR1","3",180868141,180982753,114612
"3524","ENSG00000129245","ENSG00000129245","FXR2","17",7591230,7614897,23667
"3525","ENSG00000266964","ENSG00000266964","FXYD1","19",35138824,35143109,4285
"3526","ENSG00000137731","ENSG00000137731","FXYD2","11",117800844,117828698,27854
"3527","ENSG00000089356","ENSG00000089356","FXYD3","19",35115823,35124324,8501
"3528","ENSG00000089327","ENSG00000089327","FXYD5","19",35154730,35169881,15151
"3529","ENSG00000137726","ENSG00000137726","FXYD6","11",117836976,117877486,40510
"3530","ENSG00000221946","ENSG00000221946","FXYD7","19",35143250,35154302,11052
"3531","ENSG00000163820","ENSG00000163820","FYCO1","3",45917903,45995824,77921
"3532","ENSG00000010810","ENSG00000010810","FYN","6",111660332,111873452,213120
"3533","ENSG00000157240","ENSG00000157240","FZD1","7",91264433,91271326,6893
"3534","ENSG00000111432","ENSG00000111432","FZD10","12",130162459,130165740,3281
"3535","ENSG00000180340","ENSG00000180340","FZD2","17",44557484,44561262,3778
"3536","ENSG00000104290","ENSG00000104290","FZD3","8",28494205,28574267,80062
"3537","ENSG00000174804","ENSG00000174804","FZD4","11",86945679,86955395,9716
"3538","ENSG00000163251","ENSG00000163251","FZD5","2",207762598,207769906,7308
"3539","ENSG00000164930","ENSG00000164930","FZD6","8",103298433,103332866,34433
"3540","ENSG00000155760","ENSG00000155760","FZD7","2",202033855,202038441,4586
"3541","ENSG00000177283","ENSG00000177283","FZD8","10",35638247,35642296,4049
"3542","ENSG00000188763","ENSG00000188763","FZD9","7",73433778,73436120,2342
"3543","ENSG00000105325","ENSG00000105325","FZR1","19",3506311,3538334,32023
"3544","ENSG00000123689","ENSG00000123689","G0S2","1",209675412,209676390,978
"3545","ENSG00000145907","ENSG00000145907","G3BP1","5",151771045,151812911,41866
"3546","ENSG00000138757","ENSG00000138757","G3BP2","4",75641849,75724589,82740
"3547","ENSG00000278373","ENSG00000278373","G6PC2","HSCHR2_1_CTG7_2",87867,96622,8755
"3548","ENSG00000141349","ENSG00000141349","G6PC3","17",44070620,44082151,11531
"3549","ENSG00000160211","ENSG00000160211","G6PD","X",154517825,154547572,29747
"3550","ENSG00000171298","ENSG00000171298","GAA","17",80101533,80119881,18348
"3551","ENSG00000109458","ENSG00000109458","GAB1","4",143336876,143474565,137689
"3552","ENSG00000033327","ENSG00000033327","GAB2","11",78215293,78418348,203055
"3553","ENSG00000170296","ENSG00000170296","GABARAP","17",7240008,7242449,2441
"3554","ENSG00000139112","ENSG00000139112","GABARAPL1","12",10212458,10223128,10670
"3555","ENSG00000034713","ENSG00000034713","GABARAPL2","16",75566375,75577881,11506
"3556","ENSG00000237112","ENSG00000237112","GABBR1","HSCHR6_MHC_DBB_CTG1",821155,898710,77555
"3557","ENSG00000136928","ENSG00000136928","GABBR2","9",98288109,98708935,420826
"3558","ENSG00000154727","ENSG00000154727","GABPA","21",25734570,25772460,37890
"3559","ENSG00000104064","ENSG00000104064","GABPB1","15",50275389,50355408,80019
"3560","ENSG00000022355","ENSG00000022355","GABRA1","5",161847063,161899981,52918
"3561","ENSG00000151834","ENSG00000151834","GABRA2","4",46243548,46475230,231682
"3562","ENSG00000011677","ENSG00000011677","GABRA3","X",152166234,152451315,285081
"3563","ENSG00000109158","ENSG00000109158","GABRA4","4",46918900,46993581,74681
"3564","ENSG00000186297","ENSG00000186297","GABRA5","15",26866911,26949208,82297
"3565","ENSG00000145863","ENSG00000145863","GABRA6","5",161547063,161702593,155530
"3566","ENSG00000163288","ENSG00000163288","GABRB1","4",46993723,47426447,432724
"3567","ENSG00000145864","ENSG00000145864","GABRB2","5",161288429,161549044,260615
"3568","ENSG00000166206","ENSG00000166206","GABRB3","15",26543552,26939539,395987
"3569","ENSG00000187730","ENSG00000187730","GABRD","1",2019329,2030758,11429
"3570","ENSG00000102287","ENSG00000102287","GABRE","X",151953124,151974680,21556
"3571","ENSG00000113327","ENSG00000113327","GABRG2","5",162000057,162162977,162920
"3572","ENSG00000182256","ENSG00000182256","GABRG3","15",26971181,27541984,570803
"3573","ENSG00000094755","ENSG00000094755","GABRP","5",170763350,170814047,50697
"3574","ENSG00000268089","ENSG00000268089","GABRQ","X",152637895,152657542,19647
"3575","ENSG00000146276","ENSG00000146276","GABRR1","6",89177504,89231278,53774
"3576","ENSG00000128683","ENSG00000128683","GAD1","2",170813213,170861151,47938
"3577","ENSG00000136750","ENSG00000136750","GAD2","10",26216665,26304558,87893
"3578","ENSG00000116717","ENSG00000116717","GADD45A","1",67685201,67688334,3133
"3579","ENSG00000099860","ENSG00000099860","GADD45B","19",2476122,2478259,2137
"3580","ENSG00000130222","ENSG00000130222","GADD45G","9",89605012,89606555,1543
"3581","ENSG00000205777","ENSG00000205777","GAGE1","X",49599020,49608538,9518
"3582","ENSG00000236362","ENSG00000236362","GAGE12F","X",49551278,49568218,16940
"3583","ENSG00000178950","ENSG00000178950","GAK","4",849276,932373,83097
"3584","ENSG00000069482","ENSG00000069482","GAL","11",68683779,68691175,7396
"3585","ENSG00000128242","ENSG00000128242","GAL3ST1","22",30554635,30574665,20030
"3586","ENSG00000197093","ENSG00000197093","GAL3ST4","7",100159244,100168617,9373
"3587","ENSG00000054983","ENSG00000054983","GALC","14",87837820,87993665,155845
"3588","ENSG00000117308","ENSG00000117308","GALE","1",23795599,23800781,5182
"3589","ENSG00000108479","ENSG00000108479","GALK1","17",75751594,75765236,13642
"3590","ENSG00000156958","ENSG00000156958","GALK2","15",49155656,49367869,212213
"3591","ENSG00000141012","ENSG00000141012","GALNS","16",88813734,88856970,43236
"3592","ENSG00000141429","ENSG00000141429","GALNT1","18",35581117,35711834,130717
"3593","ENSG00000164574","ENSG00000164574","GALNT10","5",154190730,154420984,230254
"3594","ENSG00000178234","ENSG00000178234","GALNT11","7",152025674,152122340,96666
"3595","ENSG00000119514","ENSG00000119514","GALNT12","9",98807670,98850081,42411
"3596","ENSG00000158089","ENSG00000158089","GALNT14","2",30910467,31155202,244735
"3597","ENSG00000143641","ENSG00000143641","GALNT2","1",230057990,230282122,224132
"3598","ENSG00000257594","ENSG00000257594","GALNT4","12",89519412,89524796,5384
"3599","ENSG00000139629","ENSG00000139629","GALNT6","12",51351247,51392867,41620
"3600","ENSG00000109586","ENSG00000109586","GALNT7","4",173168811,173323967,155156
"3601","ENSG00000130035","ENSG00000130035","GALNT8","12",4720400,4851927,131527
"3602","ENSG00000166573","ENSG00000166573","GALR1","18",77249848,77277900,28052
"3603","ENSG00000182687","ENSG00000182687","GALR2","17",76074781,76077537,2756
"3604","ENSG00000128310","ENSG00000128310","GALR3","22",37823382,37825485,2103
"3605","ENSG00000213930","ENSG00000213930","GALT","9",34638133,34651035,12902
"3606","ENSG00000130005","ENSG00000130005","GAMT","19",1397026,1401570,4544
"3607","ENSG00000261609","ENSG00000261609","GAN","16",81314944,81390809,75865
"3608","ENSG00000089597","ENSG00000089597","GANAB","11",62624826,62646726,21900
"3609","ENSG00000172020","ENSG00000172020","GAP43","3",115623510,115721490,97980
"3610","ENSG00000111640","ENSG00000111640","GAPDH","12",6534512,6538374,3862
"3611","ENSG00000105679","ENSG00000105679","GAPDHS","19",35533455,35545319,11864
"3612","ENSG00000165219","ENSG00000165219","GAPVD1","9",125261794,125367207,105413
"3613","ENSG00000109534","ENSG00000109534","GAR1","4",109815510,109824740,9230
"3614","ENSG00000141441","ENSG00000141441","GAREM1","18",32124877,32470882,346005
"3615","ENSG00000136895","ENSG00000136895","GARNL3","9",127224265,127393660,169395
"3616","ENSG00000262473","ENSG00000262473","GART","HSCHR21_4_CTG1_1",102653,115588,12935
"3617","ENSG00000180447","ENSG00000180447","GAS1","9",86944362,86947506,3144
"3618","ENSG00000148935","ENSG00000148935","GAS2","11",22625509,22813001,187492
"3619","ENSG00000185340","ENSG00000185340","GAS2L1","22",29306618,29312787,6169
"3620","ENSG00000183087","ENSG00000183087","GAS6","13",113820549,113864076,43527
"3621","ENSG00000007237","ENSG00000007237","GAS7","17",9910606,10198606,288000
"3622","ENSG00000141013","ENSG00000141013","GAS8","16",90019629,90044975,25346
"3623","ENSG00000102145","ENSG00000102145","GATA1","X",48786540,48794311,7771
"3624","ENSG00000179348","ENSG00000179348","GATA2","3",128479427,128493201,13774
"3625","ENSG00000107485","ENSG00000107485","GATA3","10",8045378,8075198,29820
"3626","ENSG00000136574","ENSG00000136574","GATA4","8",11676959,11760002,83043
"3627","ENSG00000141448","ENSG00000141448","GATA6","18",22169589,22202528,32939
"3628","ENSG00000157259","ENSG00000157259","GATAD1","7",92447482,92460075,12593
"3629","ENSG00000167491","ENSG00000167491","GATAD2A","19",19385826,19508932,123106
"3630","ENSG00000059691","ENSG00000059691","GATB","4",151670504,151761007,90503
"3631","ENSG00000257218","ENSG00000257218","GATC","12",120446444,120463749,17305
"3632","ENSG00000171766","ENSG00000171766","GATM","15",45361124,45402327,41203
"3633","ENSG00000249948","ENSG00000249948","GBA3","4",22692914,22819575,126661
"3634","ENSG00000114480","ENSG00000114480","GBE1","3",81489703,81761645,271942
"3635","ENSG00000107862","ENSG00000107862","GBF1","10",102245371,102382899,137528
"3636","ENSG00000117228","ENSG00000117228","GBP1","1",89051882,89065360,13478
"3637","ENSG00000162645","ENSG00000162645","GBP2","1",89106132,89150456,44324
"3638","ENSG00000164900","ENSG00000164900","GBX1","7",151148009,151174745,26736
"3639","ENSG00000168505","ENSG00000168505","GBX2","2",236165236,236168386,3150
"3640","ENSG00000145321","ENSG00000145321","GC","4",71741696,71804041,62345
"3641","ENSG00000115271","ENSG00000115271","GCA","2",162318840,162371595,52755
"3642","ENSG00000100116","ENSG00000100116","GCAT","22",37807905,37817176,9271
"3643","ENSG00000179562","ENSG00000179562","GCC1","7",127580628,127593611,12983
"3644","ENSG00000135968","ENSG00000135968","GCC2","2",108449107,108509415,60308
"3645","ENSG00000105607","ENSG00000105607","GCDH","19",12891128,12915126,23998
"3646","ENSG00000115263","ENSG00000115263","GCG","2",162142882,162152404,9522
"3647","ENSG00000215644","ENSG00000215644","GCGR","17",81804132,81814008,9876
"3648","ENSG00000131979","ENSG00000131979","GCH1","14",54842008,54902826,60818
"3649","ENSG00000137880","ENSG00000137880","GCHFR","15",40764068,40767708,3640
"3650","ENSG00000084734","ENSG00000084734","GCKR","2",27496839,27523684,26845
"3651","ENSG00000001084","ENSG00000001084","GCLC","6",53497341,53616970,119629
"3652","ENSG00000023909","ENSG00000023909","GCLM","1",93885199,93909456,24257
"3653","ENSG00000137270","ENSG00000137270","GCM1","6",53126961,53148841,21880
"3654","ENSG00000124827","ENSG00000124827","GCM2","6",10873223,10882041,8818
"3655","ENSG00000089154","ENSG00000089154","GCN1","12",120127202,120194715,67513
"3656","ENSG00000187210","ENSG00000187210","GCNT1","9",76419850,76651203,231353
"3657","ENSG00000111846","ENSG00000111846","GCNT2","6",10492223,10629368,137145
"3658","ENSG00000140297","ENSG00000140297","GCNT3","15",59594875,59640239,45364
"3659","ENSG00000176928","ENSG00000176928","GCNT4","5",75025346,75052558,27212
"3660","ENSG00000137878","ENSG00000137878","GCOM1","15",57591908,57714745,122837
"3661","ENSG00000140905","ENSG00000140905","GCSH","16",81081945,81096395,14450
"3662","ENSG00000104381","ENSG00000104381","GDAP1","8",74320613,74518007,197394
"3663","ENSG00000124194","ENSG00000124194","GDAP1L1","20",44247099,44280947,33848
"3664","ENSG00000196505","ENSG00000196505","GDAP2","1",117863485,117929621,66136
"3665","ENSG00000006007","ENSG00000006007","GDE1","16",19501693,19522123,20430
"3666","ENSG00000266524","ENSG00000266524","GDF10","10",47300197,47313577,13380
"3667","ENSG00000135414","ENSG00000135414","GDF11","12",55743122,55757264,14142
"3668","ENSG00000130513","ENSG00000130513","GDF15","19",18374731,18389176,14445
"3669","ENSG00000263761","ENSG00000263761","GDF2","10",47322454,47327588,5134
"3670","ENSG00000184344","ENSG00000184344","GDF3","12",7689784,7695775,5991
"3671","ENSG00000125965","ENSG00000125965","GDF5","20",35433347,35454746,21399
"3672","ENSG00000164404","ENSG00000164404","GDF9","5",132861181,132866884,5703
"3673","ENSG00000203879","ENSG00000203879","GDI1","X",154436913,154443467,6554
"3674","ENSG00000057608","ENSG00000057608","GDI2","10",5765223,5842132,76909
"3675","ENSG00000130055","ENSG00000130055","GDPD2","X",70423031,70433390,10359
"3676","ENSG00000102886","ENSG00000102886","GDPD3","16",30104810,30113537,8727
"3677","ENSG00000158555","ENSG00000158555","GDPD5","11",75434640,75525941,91301
"3678","ENSG00000164949","ENSG00000164949","GEM","8",94249253,94262350,13097
"3679","ENSG00000092208","ENSG00000092208","GEMIN2","14",39114285,39136973,22688
"3680","ENSG00000179409","ENSG00000179409","GEMIN4","17",744421,753999,9578
"3681","ENSG00000152147","ENSG00000152147","GEMIN6","2",38751534,38785002,33468
"3682","ENSG00000142252","ENSG00000142252","GEMIN7","19",45079195,45091518,12323
"3683","ENSG00000046647","ENSG00000046647","GEMIN8","X",14006726,14029893,23167
"3684","ENSG00000131095","ENSG00000131095","GFAP","17",44903159,44916937,13778
"3685","ENSG00000127554","ENSG00000127554","GFER","16",1984193,1987749,3556
"3686","ENSG00000162676","ENSG00000162676","GFI1","1",92473043,92486925,13882
"3687","ENSG00000165702","ENSG00000165702","GFI1B","9",132944000,132991687,47687
"3688","ENSG00000168827","ENSG00000168827","GFM1","3",158644527,158695581,51054
"3689","ENSG00000145990","ENSG00000145990","GFOD1","6",13357830,13487662,129832
"3690","ENSG00000141098","ENSG00000141098","GFOD2","16",67674531,67719339,44808
"3691","ENSG00000198380","ENSG00000198380","GFPT1","2",69319780,69387250,67470
"3692","ENSG00000131459","ENSG00000131459","GFPT2","5",180300698,180353336,52638
"3693","ENSG00000151892","ENSG00000151892","GFRA1","10",116056925,116276803,219878
"3694","ENSG00000168546","ENSG00000168546","GFRA2","8",21690398,21812357,121959
"3695","ENSG00000146013","ENSG00000146013","GFRA3","5",138252380,138274621,22241
"3696","ENSG00000100083","ENSG00000100083","GGA1","22",37608474,37633564,25090
"3697","ENSG00000103365","ENSG00000103365","GGA2","16",23463542,23521995,58453
"3698","ENSG00000125447","ENSG00000125447","GGA3","17",75236599,75262363,25764
"3699","ENSG00000006625","ENSG00000006625","GGCT","7",30496621,30504841,8220
"3700","ENSG00000115486","ENSG00000115486","GGCX","2",85544720,85561532,16812
"3701","ENSG00000137563","ENSG00000137563","GGH","8",63014881,63039407,24526
"3702","ENSG00000278311","ENSG00000278311","GGNBP2","17",36544912,36589848,44936
"3703","ENSG00000152904","ENSG00000152904","GGPS1","1",235327350,235344532,17182
"3704","ENSG00000100031","ENSG00000100031","GGT1","22",24594811,24629005,34194
"3705","ENSG00000099998","ENSG00000099998","GGT5","22",24219654,24245108,25454
"3706","ENSG00000259384","ENSG00000259384","GH1","17",63917200,63918839,1639
"3707","ENSG00000165678","ENSG00000165678","GHITM","10",84139482,84154841,15359
"3708","ENSG00000112964","ENSG00000112964","GHR","5",42423439,42721878,298439
"3709","ENSG00000141034","ENSG00000141034","GID4","17",18039408,18068405,28997
"3710","ENSG00000101193","ENSG00000101193","GID8","20",62938147,62948475,10328
"3711","ENSG00000204120","ENSG00000204120","GIGYF2","2",232697299,232860605,163306
"3712","ENSG00000133574","ENSG00000133574","GIMAP4","7",150567369,150573953,6584
"3713","ENSG00000196329","ENSG00000196329","GIMAP5","7",150722253,150750033,27780
"3714","ENSG00000133561","ENSG00000133561","GIMAP6","7",150625375,150632648,7273
"3715","ENSG00000145723","ENSG00000145723","GIN1","5",103086000,103120138,34138
"3716","ENSG00000101003","ENSG00000101003","GINS1","20",25391008,25452700,61692
"3717","ENSG00000131153","ENSG00000131153","GINS2","16",85676198,85690073,13875
"3718","ENSG00000181938","ENSG00000181938","GINS3","16",58295080,58406147,111067
"3719","ENSG00000147536","ENSG00000147536","GINS4","8",41529218,41545030,15812
"3720","ENSG00000159224","ENSG00000159224","GIP","17",48958554,48968596,10042
"3721","ENSG00000123159","ENSG00000123159","GIPC1","19",14477760,14496149,18389
"3722","ENSG00000137960","ENSG00000137960","GIPC2","1",77979542,78138444,158902
"3723","ENSG00000108262","ENSG00000108262","GIT1","17",29573475,29594054,20579
"3724","ENSG00000139436","ENSG00000139436","GIT2","12",109929804,109996389,66585
"3725","ENSG00000152661","ENSG00000152661","GJA1","6",121435595,121449727,14132
"3726","ENSG00000187513","ENSG00000187513","GJA4","1",34792999,34795747,2748
"3727","ENSG00000265107","ENSG00000265107","GJA5","1",147756199,147773362,17163
"3728","ENSG00000131233","ENSG00000131233","GJA9","1",38874069,38881587,7518
"3729","ENSG00000169562","ENSG00000169562","GJB1","X",71212811,71225516,12705
"3730","ENSG00000188910","ENSG00000188910","GJB3","1",34781214,34786369,5155
"3731","ENSG00000189433","ENSG00000189433","GJB4","1",34759740,34762327,2587
"3732","ENSG00000189280","ENSG00000189280","GJB5","1",34755047,34758512,3465
"3733","ENSG00000182963","ENSG00000182963","GJC1","17",44798448,44830816,32368
"3734","ENSG00000198835","ENSG00000198835","GJC2","1",228149930,228159826,9896
"3735","ENSG00000159248","ENSG00000159248","GJD2","15",34751032,34754998,3966
"3736","ENSG00000198814","ENSG00000198814","GK","X",30653359,30731462,78103
"3737","ENSG00000102393","ENSG00000102393","GLA","X",101393273,101408012,14739
"3738","ENSG00000170266","ENSG00000170266","GLB1","3",32996609,33097202,100593
"3739","ENSG00000163521","ENSG00000163521","GLB1L","2",219236598,219245478,8880
"3740","ENSG00000149328","ENSG00000149328","GLB1L2","11",134331988,134378341,46353
"3741","ENSG00000138604","ENSG00000138604","GLCE","15",69160584,69272217,111633
"3742","ENSG00000178445","ENSG00000178445","GLDC","9",6532467,6645729,113262
"3743","ENSG00000119392","ENSG00000119392","GLE1","9",128504655,128543874,39219
"3744","ENSG00000090863","ENSG00000090863","GLG1","16",74447427,74607144,159717
"3745","ENSG00000111087","ENSG00000111087","GLI1","12",57459785,57472268,12483
"3746","ENSG00000074047","ENSG00000074047","GLI2","2",120735623,120992653,257030
"3747","ENSG00000106571","ENSG00000106571","GLI3","7",41960949,42264100,303151
"3748","ENSG00000139278","ENSG00000139278","GLIPR1","12",75480753,75503863,23110
"3749","ENSG00000174842","ENSG00000174842","GLMN","1",92246402,92298987,52585
"3750","ENSG00000124767","ENSG00000124767","GLO1","6",38675925,38703145,27220
"3751","ENSG00000167699","ENSG00000167699","GLOD4","17",757097,782294,25197
"3752","ENSG00000112164","ENSG00000112164","GLP1R","6",39048781,39091303,42522
"3753","ENSG00000065325","ENSG00000065325","GLP2R","17",9822206,9892099,69893
"3754","ENSG00000145888","ENSG00000145888","GLRA1","5",151822513,151924851,102338
"3755","ENSG00000101958","ENSG00000101958","GLRA2","X",14529298,14731812,202514
"3756","ENSG00000145451","ENSG00000145451","GLRA3","4",174636920,174829247,192327
"3757","ENSG00000109738","ENSG00000109738","GLRB","4",157076125,157172090,95965
"3758","ENSG00000173221","ENSG00000173221","GLRX","5",95751319,95822726,71407
"3759","ENSG00000023572","ENSG00000023572","GLRX2","1",193090866,193106114,15248
"3760","ENSG00000108010","ENSG00000108010","GLRX3","10",130136391,130184521,48130
"3761","ENSG00000182512","ENSG00000182512","GLRX5","14",95533503,95544724,11221
"3762","ENSG00000135423","ENSG00000135423","GLS2","12",56470944,56488414,17470
"3763","ENSG00000016864","ENSG00000016864","GLT8D1","3",52694486,52706032,11546
"3764","ENSG00000120820","ENSG00000120820","GLT8D2","12",103988987,104064183,75196
"3765","ENSG00000139433","ENSG00000139433","GLTP","12",109850945,109880541,29596
"3766","ENSG00000148672","ENSG00000148672","GLUD1","10",87050202,87094843,44641
"3767","ENSG00000182890","ENSG00000182890","GLUD2","X",121047610,121050094,2484
"3768","ENSG00000135821","ENSG00000135821","GLUL","1",182378098,182392206,14108
"3769","ENSG00000149124","ENSG00000149124","GLYAT","11",58640426,58731974,91548
"3770","ENSG00000140632","ENSG00000140632","GLYR1","16",4803203,4847288,44085
"3771","ENSG00000196743","ENSG00000196743","GM2A","5",151212150,151270440,58290
"3772","ENSG00000087338","ENSG00000087338","GMCL1","2",69829660,69881384,51724
"3773","ENSG00000112699","ENSG00000112699","GMDS","6",1623806,2245605,621799
"3774","ENSG00000162419","ENSG00000162419","GMEB1","1",28668778,28719353,50575
"3775","ENSG00000101216","ENSG00000101216","GMEB2","20",63587602,63627101,39499
"3776","ENSG00000197045","ENSG00000197045","GMFB","14",54474484,54489025,14541
"3777","ENSG00000130755","ENSG00000130755","GMFG","19",39328353,39342372,14019
"3778","ENSG00000089639","ENSG00000089639","GMIP","19",19629476,19643657,14181
"3779","ENSG00000112312","ENSG00000112312","GMNN","6",24774931,24786099,11168
"3780","ENSG00000144591","ENSG00000144591","GMPPA","2",219498865,219513898,15033
"3781","ENSG00000173540","ENSG00000173540","GMPPB","3",49716844,49723973,7129
"3782","ENSG00000137198","ENSG00000137198","GMPR","6",16238587,16295549,56962
"3783","ENSG00000100938","ENSG00000100938","GMPR2","14",24232422,24239242,6820
"3784","ENSG00000163655","ENSG00000163655","GMPS","3",155870650,155944020,73370
"3785","ENSG00000088256","ENSG00000088256","GNA11","19",3094362,3123999,29637
"3786","ENSG00000146535","ENSG00000146535","GNA12","7",2721822,2870786,148964
"3787","ENSG00000120063","ENSG00000120063","GNA13","17",65009289,65056740,47451
"3788","ENSG00000156049","ENSG00000156049","GNA14","9",77423079,77648322,225243
"3789","ENSG00000060558","ENSG00000060558","GNA15","19",3136033,3163749,27716
"3790","ENSG00000127955","ENSG00000127955","GNAI1","7",79768028,80226181,458153
"3791","ENSG00000114353","ENSG00000114353","GNAI2","3",50226292,50259362,33070
"3792","ENSG00000065135","ENSG00000065135","GNAI3","1",109548615,109600195,51580
"3793","ENSG00000141404","ENSG00000141404","GNAL","18",11689264,11885685,196421
"3794","ENSG00000087258","ENSG00000087258","GNAO1","16",56189660,56357444,167784
"3795","ENSG00000156052","ENSG00000156052","GNAQ","9",77716097,78031811,315714
"3796","ENSG00000087460","ENSG00000087460","GNAS","20",58839718,58911192,71474
"3797","ENSG00000114349","ENSG00000114349","GNAT1","3",50191610,50197696,6086
"3798","ENSG00000134183","ENSG00000134183","GNAT2","1",109603091,109619929,16838
"3799","ENSG00000128266","ENSG00000128266","GNAZ","22",23070519,23125032,54513
"3800","ENSG00000185838","ENSG00000185838","GNB1L","22",19783223,19854939,71716
"3801","ENSG00000172354","ENSG00000172354","GNB2","7",100673567,100679174,5607
"3802","ENSG00000111664","ENSG00000111664","GNB3","12",6839954,6847393,7439
"3803","ENSG00000069966","ENSG00000069966","GNB5","15",52115100,52191392,76292
"3804","ENSG00000159921","ENSG00000159921","GNE","9",36214441,36277042,62601
"3805","ENSG00000242616","ENSG00000242616","GNG10","9",111661605,111670226,8621
"3806","ENSG00000127920","ENSG00000127920","GNG11","7",93921735,93928610,6875
"3807","ENSG00000172380","ENSG00000172380","GNG12","1",67701475,67833467,131992
"3808","ENSG00000127588","ENSG00000127588","GNG13","16",798041,800734,2693
"3809","ENSG00000162188","ENSG00000162188","GNG3","11",62707676,62709201,1525
"3810","ENSG00000168243","ENSG00000168243","GNG4","1",235547685,235650754,103069
"3811","ENSG00000174021","ENSG00000174021","GNG5","1",84498323,84506581,8258
"3812","ENSG00000176533","ENSG00000176533","GNG7","19",2511219,2702694,191475
"3813","ENSG00000127928","ENSG00000127928","GNGT1","7",93591573,93911265,319692
"3814","ENSG00000235986","ENSG00000235986","GNL1","HSCHR6_MHC_COX_CTG1",2021096,2036894,15798
"3815","ENSG00000134697","ENSG00000134697","GNL2","1",37566816,37595937,29121
"3816","ENSG00000163938","ENSG00000163938","GNL3","3",52681156,52694497,13341
"3817","ENSG00000115523","ENSG00000115523","GNLY","2",85685175,85698852,13677
"3818","ENSG00000124713","ENSG00000124713","GNMT","6",42960754,42963880,3126
"3819","ENSG00000116906","ENSG00000116906","GNPAT","1",231241207,231277973,36766
"3820","ENSG00000113552","ENSG00000113552","GNPDA1","5",141991749,142013041,21292
"3821","ENSG00000111670","ENSG00000111670","GNPTAB","12",101745499,101830959,85460
"3822","ENSG00000147437","ENSG00000147437","GNRH1","8",25419258,25424654,5396
"3823","ENSG00000135677","ENSG00000135677","GNS","12",64713445,64759431,45986
"3824","ENSG00000136935","ENSG00000136935","GOLGA1","9",124878275,124948492,70217
"3825","ENSG00000167110","ENSG00000167110","GOLGA2","9",128255829,128276026,20197
"3826","ENSG00000090615","ENSG00000090615","GOLGA3","12",132768902,132829143,60241
"3827","ENSG00000144674","ENSG00000144674","GOLGA4","3",37243191,37366879,123688
"3828","ENSG00000066455","ENSG00000066455","GOLGA5","14",92794305,92839947,45642
"3829","ENSG00000159289","ENSG00000159289","GOLGA6A","15",74069857,74082550,12693
"3830","ENSG00000147533","ENSG00000147533","GOLGA7","8",41488200,41511095,22895
"3831","ENSG00000175265","ENSG00000175265","GOLGA8A","15",34378935,34437808,58873
"3832","ENSG00000277090","ENSG00000277090","GOLGA8G","HSCHR15_4_CTG8",795406,808766,13360
"3833","ENSG00000173230","ENSG00000173230","GOLGB1","3",121663199,121749966,86767
"3834","ENSG00000173905","ENSG00000173905","GOLIM4","3",168008689,168095924,87235
"3835","ENSG00000135052","ENSG00000135052","GOLM1","9",86026146,86100173,74027
"3836","ENSG00000113384","ENSG00000113384","GOLPH3","5",32124716,32174319,49603
"3837","ENSG00000143457","ENSG00000143457","GOLPH3L","1",150646230,150697154,50924
"3838","ENSG00000111711","ENSG00000111711","GOLT1B","12",21501781,21518408,16627
"3839","ENSG00000116580","ENSG00000116580","GON4L","1",155749659,155859400,109741
"3840","ENSG00000114745","ENSG00000114745","GORASP1","3",39095222,39108369,13147
"3841","ENSG00000115806","ENSG00000115806","GORASP2","2",170928464,170967130,38666
"3842","ENSG00000108587","ENSG00000108587","GOSR1","17",30477362,30527592,50230
"3843","ENSG00000108433","ENSG00000108433","GOSR2","17",46923075,46975524,52449
"3844","ENSG00000120053","ENSG00000120053","GOT1","10",99396870,99430624,33754
"3845","ENSG00000125166","ENSG00000125166","GOT2","16",58707131,58734342,27211
"3846","ENSG00000185245","ENSG00000185245","GP1BA","17",4932277,4935023,2746
"3847","ENSG00000203618","ENSG00000203618","GP1BB","22",19723539,19724771,1232
"3848","ENSG00000169347","ENSG00000169347","GP2","16",20309574,20327808,18234
"3849","ENSG00000143167","ENSG00000143167","GPA33","1",167052836,167166479,113643
"3850","ENSG00000197858","ENSG00000197858","GPAA1","8",144082337,144093149,10812
"3851","ENSG00000133114","ENSG00000133114","GPALPP1","13",44989529,45037669,48140
"3852","ENSG00000076650","ENSG00000076650","GPATCH1","19",33080899,33130542,49643
"3853","ENSG00000092978","ENSG00000092978","GPATCH2","1",217426992,217631090,204098
"3854","ENSG00000089916","ENSG00000089916","GPATCH2L","14",76151916,76254342,102426
"3855","ENSG00000198746","ENSG00000198746","GPATCH3","1",26890488,26900467,9979
"3856","ENSG00000160818","ENSG00000160818","GPATCH4","1",156594301,156601496,7195
"3857","ENSG00000186566","ENSG00000186566","GPATCH8","17",44395281,44503430,108149
"3858","ENSG00000159592","ENSG00000159592","GPBP1L1","1",45627304,45688113,60809
"3859","ENSG00000063660","ENSG00000063660","GPC1","2",240435663,240468076,32413
"3860","ENSG00000147257","ENSG00000147257","GPC3","X",133535745,133987100,451355
"3861","ENSG00000076716","ENSG00000076716","GPC4","X",133300103,133415489,115386
"3862","ENSG00000179399","ENSG00000179399","GPC5","13",91398621,92873682,1475061
"3863","ENSG00000167588","ENSG00000167588","GPD1","12",50103982,50111313,7331
"3864","ENSG00000152642","ENSG00000152642","GPD1L","3",32105689,32168709,63020
"3865","ENSG00000115159","ENSG00000115159","GPD2","2",156435290,156613735,178445
"3866","ENSG00000164850","ENSG00000164850","GPER1","7",1082208,1093815,11607
"3867","ENSG00000171723","ENSG00000171723","GPHN","14",66507407,67181803,674396
"3868","ENSG00000105220","ENSG00000105220","GPI","19",34359480,34402413,42933
"3869","ENSG00000068394","ENSG00000068394","GPKOW","X",49113407,49123735,10328
"3870","ENSG00000112293","ENSG00000112293","GPLD1","6",24424565,24495205,70640
"3871","ENSG00000150625","ENSG00000150625","GPM6A","4",175632934,176002664,369730
"3872","ENSG00000198522","ENSG00000198522","GPN1","2",27628247,27651511,23264
"3873","ENSG00000142751","ENSG00000142751","GPN2","1",26876132,26890283,14151
"3874","ENSG00000111231","ENSG00000111231","GPN3","12",110452486,110469268,16782
"3875","ENSG00000136235","ENSG00000136235","GPNMB","7",23235967,23275108,39141
"3876","ENSG00000148358","ENSG00000148358","GPR107","9",130053426,130140169,86743
"3877","ENSG00000132975","ENSG00000132975","GPR12","13",26755200,26760786,5586
"3878","ENSG00000183484","ENSG00000183484","GPR132","14",105049395,105065445,16050
"3879","ENSG00000181619","ENSG00000181619","GPR135","14",59429022,59465380,36358
"3880","ENSG00000173264","ENSG00000173264","GPR137","11",64270062,64289494,19432
"3881","ENSG00000077585","ENSG00000077585","GPR137B","1",236142505,236221865,79360
"3882","ENSG00000101850","ENSG00000101850","GPR143","X",9725346,9786297,60951
"3883","ENSG00000154165","ENSG00000154165","GPR15","3",98531978,98534681,2703
"3884","ENSG00000158292","ENSG00000158292","GPR153","1",6247353,6261098,13745
"3885","ENSG00000180758","ENSG00000180758","GPR157","1",9100305,9129102,28797
"3886","ENSG00000143147","ENSG00000143147","GPR161","1",168079542,168137667,58125
"3887","ENSG00000250510","ENSG00000250510","GPR162","12",6821624,6829972,8348
"3888","ENSG00000144230","ENSG00000144230","GPR17","2",127645864,127652639,6775
"3889","ENSG00000174946","ENSG00000174946","GPR171","3",151197832,151203216,5384
"3890","ENSG00000184194","ENSG00000184194","GPR173","X",53048789,53080615,31826
"3891","ENSG00000166073","ENSG00000166073","GPR176","15",39799008,39920936,121928
"3892","ENSG00000125245","ENSG00000125245","GPR18","13",99254732,99261744,7012
"3893","ENSG00000166856","ENSG00000166856","GPR182","12",56994492,56998447,3955
"3894","ENSG00000169508","ENSG00000169508","GPR183","13",99294539,99307399,12860
"3895","ENSG00000183150","ENSG00000183150","GPR19","12",12660890,12696207,35317
"3896","ENSG00000275181","ENSG00000275181","GPR20","HSCHR8_5_CTG7",23054,33821,10767
"3897","ENSG00000188394","ENSG00000188394","GPR21","9",123033667,123035665,1998
"3898","ENSG00000172209","ENSG00000172209","GPR22","7",107470018,107475684,5666
"3899","ENSG00000170837","ENSG00000170837","GPR27","3",71753855,71756496,2641
"3900","ENSG00000181773","ENSG00000181773","GPR3","1",27392622,27395814,3192
"3901","ENSG00000178623","ENSG00000178623","GPR35","2",240605430,240633159,27729
"3902","ENSG00000170775","ENSG00000170775","GPR37","7",124743885,124765792,21907
"3903","ENSG00000170075","ENSG00000170075","GPR37L1","1",202122886,202133592,10706
"3904","ENSG00000177464","ENSG00000177464","GPR4","19",45589764,45602212,12448
"3905","ENSG00000102195","ENSG00000102195","GPR50","X",151176584,151181465,4881
"3906","ENSG00000203737","ENSG00000203737","GPR52","1",174447964,174449545,1581
"3907","ENSG00000112218","ENSG00000112218","GPR63","6",96794125,96837477,43352
"3908","ENSG00000140030","ENSG00000140030","GPR65","14",88005135,88014811,9676
"3909","ENSG00000119714","ENSG00000119714","GPR68","14",91232532,91253925,21393
"3910","ENSG00000119737","ENSG00000119737","GPR75","2",53852912,53859967,7055
"3911","ENSG00000164604","ENSG00000164604","GPR85","7",113078331,113087778,9447
"3912","ENSG00000138271","ENSG00000138271","GPR87","3",151294086,151316820,22734
"3913","ENSG00000181656","ENSG00000181656","GPR88","1",100538139,100542021,3882
"3914","ENSG00000117262","ENSG00000117262","GPR89A","1",145607988,145670650,62662
"3915","ENSG00000188092","ENSG00000188092","GPR89B","1",147928393,147993592,65199
"3916","ENSG00000198932","ENSG00000198932","GPRASP1","X",102651092,102659083,7991
"3917","ENSG00000013588","ENSG00000013588","GPRC5A","12",12890782,12917937,27155
"3918","ENSG00000167191","ENSG00000167191","GPRC5B","16",19856691,19886167,29476
"3919","ENSG00000170412","ENSG00000170412","GPRC5C","17",74424851,74451653,26802
"3920","ENSG00000169727","ENSG00000169727","GPS1","17",82050691,82057470,6779
"3921","ENSG00000132522","ENSG00000132522","GPS2","17",7311324,7315564,4240
"3922","ENSG00000121957","ENSG00000121957","GPSM2","1",108875350,108934545,59195
"3923","ENSG00000237052","ENSG00000237052","GPSM3","HSCHR6_MHC_APD_CTG1",3523365,3528122,4757
"3924","ENSG00000167701","ENSG00000167701","GPT","8",144502973,144507174,4201
"3925","ENSG00000233276","ENSG00000233276","GPX1","3",49357174,49358605,1431
"3926","ENSG00000176153","ENSG00000176153","GPX2","14",64939152,64942746,3594
"3927","ENSG00000211445","ENSG00000211445","GPX3","5",151020591,151028988,8397
"3928","ENSG00000167468","ENSG00000167468","GPX4","19",1103982,1106791,2809
"3929","ENSG00000116157","ENSG00000116157","GPX7","1",52602371,52609051,6680
"3930","ENSG00000023171","ENSG00000023171","GRAMD1B","11",123358428,123627774,269346
"3931","ENSG00000178075","ENSG00000178075","GRAMD1C","3",113828182,113947174,118992
"3932","ENSG00000075240","ENSG00000075240","GRAMD4","22",46576012,46679790,103778
"3933","ENSG00000154016","ENSG00000154016","GRAP","17",19020656,19047011,26355
"3934","ENSG00000100351","ENSG00000100351","GRAP2","22",39901084,39973721,72637
"3935","ENSG00000189152","ENSG00000189152","GRAPL","17",19127535,19162274,34739
"3936","ENSG00000106070","ENSG00000106070","GRB10","7",50590063,50793462,203399
"3937","ENSG00000115290","ENSG00000115290","GRB14","2",164492417,164621482,129065
"3938","ENSG00000177885","ENSG00000177885","GRB2","17",75318076,75405709,87633
"3939","ENSG00000141738","ENSG00000141738","GRB7","17",39737927,39747291,9364
"3940","ENSG00000196208","ENSG00000196208","GREB1","2",11482341,11642788,160447
"3941","ENSG00000141449","ENSG00000141449","GREB1L","18",21242232,21526112,283880
"3942","ENSG00000276886","ENSG00000276886","GREM1","HSCHR15_4_CTG8",4932598,4949251,16653
"3943","ENSG00000180875","ENSG00000180875","GREM2","1",240489573,240612155,122582
"3944","ENSG00000083307","ENSG00000083307","GRHL2","8",101492439,101669726,177287
"3945","ENSG00000137106","ENSG00000137106","GRHPR","9",37422666,37436990,14324
"3946","ENSG00000155511","ENSG00000155511","GRIA1","5",153489615,153813869,324254
"3947","ENSG00000120251","ENSG00000120251","GRIA2","4",157204182,157387146,182964
"3948","ENSG00000125675","ENSG00000125675","GRIA3","X",123184153,123490915,306762
"3949","ENSG00000152578","ENSG00000152578","GRIA4","11",105609535,105982090,372555
"3950","ENSG00000152208","ENSG00000152208","GRID2","4",92303966,93810157,1506191
"3951","ENSG00000171189","ENSG00000171189","GRIK1","21",29536933,29940033,403100
"3952","ENSG00000164418","ENSG00000164418","GRIK2","6",100962701,102081622,1118921
"3953","ENSG00000163873","ENSG00000163873","GRIK3","1",36795527,37034515,238988
"3954","ENSG00000149403","ENSG00000149403","GRIK4","11",120511746,120988906,477160
"3955","ENSG00000105737","ENSG00000105737","GRIK5","19",41998321,42070206,71885
"3956","ENSG00000176884","ENSG00000176884","GRIN1","9",137138346,137168756,30410
"3957","ENSG00000183454","ENSG00000183454","GRIN2A","16",9753404,10182928,429524
"3958","ENSG00000273079","ENSG00000273079","GRIN2B","12",13437942,13982002,544060
"3959","ENSG00000161509","ENSG00000161509","GRIN2C","17",74842023,74861504,19481
"3960","ENSG00000105464","ENSG00000105464","GRIN2D","19",48393668,48444931,51263
"3961","ENSG00000178719","ENSG00000178719","GRINA","8",143990056,143993415,3359
"3962","ENSG00000155974","ENSG00000155974","GRIP1","12",66347431,67069162,721731
"3963","ENSG00000144596","ENSG00000144596","GRIP2","3",14489107,14556075,66968
"3964","ENSG00000173020","ENSG00000173020","GRK2","11",67266473,67286556,20083
"3965","ENSG00000100077","ENSG00000100077","GRK3","22",25564675,25729294,164619
"3966","ENSG00000125388","ENSG00000125388","GRK4","4",2963571,3040760,77189
"3967","ENSG00000198873","ENSG00000198873","GRK5","10",119207571,119459745,252174
"3968","ENSG00000198055","ENSG00000198055","GRK6","5",177403204,177442901,39697
"3969","ENSG00000152822","ENSG00000152822","GRM1","6",146027646,146437601,409955
"3970","ENSG00000198822","ENSG00000198822","GRM3","7",86643909,86864879,220970
"3971","ENSG00000124493","ENSG00000124493","GRM4","6",34018643,34155622,136979
"3972","ENSG00000168959","ENSG00000168959","GRM5","11",88504576,89065982,561406
"3973","ENSG00000196277","ENSG00000196277","GRM7","3",6770001,7741533,971532
"3974","ENSG00000179603","ENSG00000179603","GRM8","7",126438598,127253093,814495
"3975","ENSG00000030582","ENSG00000030582","GRN","17",44345246,44353106,7860
"3976","ENSG00000134443","ENSG00000134443","GRP","18",59220158,59230774,10616
"3977","ENSG00000109519","ENSG00000109519","GRPEL1","4",7058671,7068085,9414
"3978","ENSG00000126010","ENSG00000126010","GRPR","X",16123565,16153518,29953
"3979","ENSG00000132463","ENSG00000132463","GRSF1","4",70815783,70839897,24114
"3980","ENSG00000139835","ENSG00000139835","GRTP1","13",113324163,113364148,39985
"3981","ENSG00000105447","ENSG00000105447","GRWD1","19",48445841,48457022,11181
"3982","ENSG00000186088","ENSG00000186088","GSAP","7",77310751,77416349,105598
"3983","ENSG00000073605","ENSG00000073605","GSDMB","17",39904595,39919854,15259
"3984","ENSG00000278718","ENSG00000278718","GSDMD","HSCHR8_3_CTG7",43247,53102,9855
"3985","ENSG00000131149","ENSG00000131149","GSE1","16",85169525,85676204,506679
"3986","ENSG00000111305","ENSG00000111305","GSG1","12",13083532,13103683,20151
"3987","ENSG00000105723","ENSG00000105723","GSK3A","19",42226225,42242625,16400
"3988","ENSG00000082701","ENSG00000082701","GSK3B","3",119821321,120094994,273673
"3989","ENSG00000148180","ENSG00000148180","GSN","9",121207794,121332843,125049
"3990","ENSG00000103342","ENSG00000103342","GSPT1","16",11868128,11916082,47954
"3991","ENSG00000189369","ENSG00000189369","GSPT2","X",51743442,51746232,2790
"3992","ENSG00000104687","ENSG00000104687","GSR","8",30678066,30727846,49780
"3993","ENSG00000100983","ENSG00000100983","GSS","20",34928432,34956027,27595
"3994","ENSG00000243955","ENSG00000243955","GSTA1","6",52791371,52803860,12489
"3995","ENSG00000174156","ENSG00000174156","GSTA3","6",52896639,52909698,13059
"3996","ENSG00000170899","ENSG00000170899","GSTA4","6",52977948,52995304,17356
"3997","ENSG00000138780","ENSG00000138780","GSTCD","4",105708778,105847725,138947
"3998","ENSG00000197448","ENSG00000197448","GSTK1","7",143244093,143270854,26761
"3999","ENSG00000134184","ENSG00000134184","GSTM1","1",109687814,109709039,21225
"4000","ENSG00000134202","ENSG00000134202","GSTM3","1",109733932,109741038,7106
"4001","ENSG00000168765","ENSG00000168765","GSTM4","1",109656099,109665496,9397
"4002","ENSG00000134201","ENSG00000134201","GSTM5","1",109711780,109775428,63648
"4003","ENSG00000148834","ENSG00000148834","GSTO1","10",104235356,104267459,32103
"4004","ENSG00000084207","ENSG00000084207","GSTP1","11",67583742,67586656,2914
"4005","ENSG00000277656","ENSG00000277656","GSTT1","HSCHR22_1_CTG7",270314,278855,8541
"4006","ENSG00000277897","ENSG00000277897","GSTT2","HSCHR22_1_CTG7",216424,220281,3857
"4007","ENSG00000100577","ENSG00000100577","GSTZ1","14",77320996,77331597,10601
"4008","ENSG00000121964","ENSG00000121964","GTDC1","2",143938068,144332568,394500
"4009","ENSG00000165417","ENSG00000165417","GTF2A1","14",81175452,81221377,45925
"4010","ENSG00000242441","ENSG00000242441","GTF2A1L","2",48617798,48733148,115350
"4011","ENSG00000140307","ENSG00000140307","GTF2A2","15",59638062,59657541,19479
"4012","ENSG00000137947","ENSG00000137947","GTF2B","1",88852633,88891944,39311
"4013","ENSG00000153767","ENSG00000153767","GTF2E1","3",120742637,120783069,40432
"4014","ENSG00000197265","ENSG00000197265","GTF2E2","8",30578318,30658236,79918
"4015","ENSG00000125651","ENSG00000125651","GTF2F1","19",6379572,6393981,14409
"4016","ENSG00000188342","ENSG00000188342","GTF2F2","13",45120510,45284893,164383
"4017","ENSG00000110768","ENSG00000110768","GTF2H1","11",18322295,18367045,44750
"4018","ENSG00000276910","ENSG00000276910","GTF2H2","HSCHR5_1_CTG1_1",581052,616068,35016
"4019","ENSG00000183474","ENSG00000183474","GTF2H2C","5",69560191,69595221,35030
"4020","ENSG00000111358","ENSG00000111358","GTF2H3","12",123633739,123662604,28865
"4021","ENSG00000236895","ENSG00000236895","GTF2H4","HSCHR6_MHC_COX_CTG1",2387930,2393852,5922
"4022","ENSG00000263001","ENSG00000263001","GTF2I","7",74650231,74760692,110461
"4023","ENSG00000233369","ENSG00000233369","GTF2IP4","7",73175415,73205441,30026
"4024","ENSG00000006704","ENSG00000006704","GTF2IRD1","7",74453790,74602605,148815
"4025","ENSG00000196275","ENSG00000196275","GTF2IRD2","7",74796151,74851605,55454
"4026","ENSG00000174428","ENSG00000174428","GTF2IRD2B","7",75092573,75149817,57244
"4027","ENSG00000122034","ENSG00000122034","GTF3A","13",27424619,27435823,11204
"4028","ENSG00000077235","ENSG00000077235","GTF3C1","16",27459555,27549913,90358
"4029","ENSG00000115207","ENSG00000115207","GTF3C2","2",27325849,27356999,31150
"4030","ENSG00000119041","ENSG00000119041","GTF3C3","2",196763035,196799725,36690
"4031","ENSG00000125484","ENSG00000125484","GTF3C4","9",132670035,132694953,24918
"4032","ENSG00000148308","ENSG00000148308","GTF3C5","9",133030675,133058503,27828
"4033","ENSG00000100226","ENSG00000100226","GTPBP1","22",38705742,38738299,32557
"4034","ENSG00000105793","ENSG00000105793","GTPBP10","7",90335223,90391453,56230
"4035","ENSG00000172432","ENSG00000172432","GTPBP2","6",43605316,43629264,23948
"4036","ENSG00000130299","ENSG00000130299","GTPBP3","19",17334920,17342731,7811
"4037","ENSG00000107937","ENSG00000107937","GTPBP4","10",988434,1019932,31498
"4038","ENSG00000178605","ENSG00000178605","GTPBP6","X",304529,318796,14267
"4039","ENSG00000163607","ENSG00000163607","GTPBP8","3",112990984,113015060,24076
"4040","ENSG00000048545","ENSG00000048545","GUCA1A","6",42173364,42181338,7974
"4041","ENSG00000197273","ENSG00000197273","GUCA2A","1",42162690,42164745,2055
"4042","ENSG00000044012","ENSG00000044012","GUCA2B","1",42153410,42155820,2410
"4043","ENSG00000152402","ENSG00000152402","GUCY1A2","11",106674019,107018476,344457
"4044","ENSG00000123201","ENSG00000123201","GUCY1B2","13",51006991,51062894,55903
"4045","ENSG00000070019","ENSG00000070019","GUCY2C","12",14612632,14696599,83967
"4046","ENSG00000151806","ENSG00000151806","GUF1","4",44678420,44700928,22508
"4047","ENSG00000143774","ENSG00000143774","GUK1","1",228139962,228148984,9022
"4048","ENSG00000144366","ENSG00000144366","GULP1","2",188291669,188595931,304262
"4049","ENSG00000169919","ENSG00000169919","GUSB","7",65960684,65982215,21531
"4050","ENSG00000163754","ENSG00000163754","GYG1","3",148991408,149031775,40367
"4051","ENSG00000056998","ENSG00000056998","GYG2","X",2828822,2882818,53996
"4052","ENSG00000170180","ENSG00000170180","GYPA","4",144109303,144140751,31448
"4053","ENSG00000250361","ENSG00000250361","GYPB","4",143996104,144019380,23276
"4054","ENSG00000136732","ENSG00000136732","GYPC","2",126656133,126696667,40534
"4055","ENSG00000197465","ENSG00000197465","GYPE","4",143870864,143905563,34699
"4056","ENSG00000104812","ENSG00000104812","GYS1","19",48968130,48993310,25180
"4057","ENSG00000111713","ENSG00000111713","GYS2","12",21536107,21604847,68740
"4058","ENSG00000145649","ENSG00000145649","GZMA","5",55102646,55110252,7606
"4059","ENSG00000100453","ENSG00000100453","GZMB","14",24630954,24634267,3313
"4060","ENSG00000100450","ENSG00000100450","GZMH","14",24606480,24609699,3219
"4061","ENSG00000113088","ENSG00000113088","GZMK","5",55024256,55034570,10314
"4062","ENSG00000197540","ENSG00000197540","GZMM","19",544034,549924,5890
"4063","ENSG00000049239","ENSG00000049239","H6PD","1",9234774,9271337,36563
"4064","ENSG00000162882","ENSG00000162882","HAAO","2",42767089,42792593,25504
"4065","ENSG00000148702","ENSG00000148702","HABP2","10",113550837,113589602,38765
"4066","ENSG00000130956","ENSG00000130956","HABP4","9",96450169,96491336,41167
"4067","ENSG00000165996","ENSG00000165996","HACD1","10",17589032,17617374,28342
"4068","ENSG00000074696","ENSG00000074696","HACD3","15",65530418,65578349,47931
"4069","ENSG00000138796","ENSG00000138796","HADH","4",107989714,108035241,45527
"4070","ENSG00000084754","ENSG00000084754","HADHA","2",26190635,26244672,54037
"4071","ENSG00000138029","ENSG00000138029","HADHB","2",26243170,26290465,47295
"4072","ENSG00000063854","ENSG00000063854","HAGH","16",1795620,1827157,31537
"4073","ENSG00000084110","ENSG00000084110","HAL","12",95972662,95996365,23703
"4074","ENSG00000105697","ENSG00000105697","HAMP","19",35280716,35285143,4427
"4075","ENSG00000113196","ENSG00000113196","HAND1","5",154474972,154478227,3255
"4076","ENSG00000164107","ENSG00000164107","HAND2","4",173524969,173530229,5260
"4077","ENSG00000101323","ENSG00000101323","HAO1","20",7882985,7940458,57473
"4078","ENSG00000116882","ENSG00000116882","HAO2","1",119368779,119394130,25351
"4079","ENSG00000173805","ENSG00000173805","HAP1","17",41717742,41734644,16902
"4080","ENSG00000145681","ENSG00000145681","HAPLN1","5",83637805,83720855,83050
"4081","ENSG00000132702","ENSG00000132702","HAPLN2","1",156619331,156625725,6394
"4082","ENSG00000112855","ENSG00000112855","HARS2","5",140691430,140699305,7875
"4083","ENSG00000105509","ENSG00000105509","HAS1","19",51713112,51723991,10879
"4084","ENSG00000170961","ENSG00000170961","HAS2","8",121612116,121641440,29324
"4085","ENSG00000128708","ENSG00000128708","HAT1","2",171922448,171983686,61238
"4086","ENSG00000137814","ENSG00000137814","HAUS2","15",42548828,42569994,21166
"4087","ENSG00000214367","ENSG00000214367","HAUS3","4",2227464,2242133,14669
"4088","ENSG00000092036","ENSG00000092036","HAUS4","14",22946228,22957161,10933
"4089","ENSG00000249115","ENSG00000249115","HAUS5","19",35612735,35625355,12620
"4090","ENSG00000147874","ENSG00000147874","HAUS6","9",19053141,19102904,49763
"4091","ENSG00000213397","ENSG00000213397","HAUS7","X",153447668,153495516,47848
"4092","ENSG00000113249","ENSG00000113249","HAVCR1","5",157026742,157069396,42654
"4093","ENSG00000143575","ENSG00000143575","HAX1","1",154272355,154275875,3520
"4094","ENSG00000206172","ENSG00000206172","HBA1","16",176680,177522,842
"4095","ENSG00000188536","ENSG00000188536","HBA2","16",172876,173710,834
"4096","ENSG00000244734","ENSG00000244734","HBB","11",5225464,5229395,3931
"4097","ENSG00000223609","ENSG00000223609","HBD","11",5232678,5243657,10979
"4098","ENSG00000213931","ENSG00000213931","HBE1","11",5268345,5505652,237307
"4099","ENSG00000113070","ENSG00000113070","HBEGF","5",140332843,140346603,13760
"4100","ENSG00000213934","ENSG00000213934","HBG1","11",5248269,5249857,1588
"4101","ENSG00000196565","ENSG00000196565","HBG2","11",5253188,5505605,252417
"4102","ENSG00000105856","ENSG00000105856","HBP1","7",107168961,107202522,33561
"4103","ENSG00000086506","ENSG00000086506","HBQ1","16",180459,181179,720
"4104","ENSG00000112339","ENSG00000112339","HBS1L","6",134960378,135103056,142678
"4105","ENSG00000130656","ENSG00000130656","HBZ","16",142728,154503,11775
"4106","ENSG00000255398","ENSG00000255398","HCAR3","12",122714756,122716811,2055
"4107","ENSG00000004961","ENSG00000004961","HCCS","X",11111301,11123086,11785
"4108","ENSG00000172534","ENSG00000172534","HCFC1","X",153947557,153971818,24261
"4109","ENSG00000103145","ENSG00000103145","HCFC1R1","16",3022625,3024286,1661
"4110","ENSG00000111727","ENSG00000111727","HCFC2","12",104064531,104106524,41993
"4111","ENSG00000101336","ENSG00000101336","HCK","20",32052197,32101856,49659
"4112","ENSG00000180353","ENSG00000180353","HCLS1","3",121631399,121660927,29528
"4113","ENSG00000099822","ENSG00000099822","HCN2","19",589881,617159,27278
"4114","ENSG00000138622","ENSG00000138622","HCN4","15",73319859,73368958,49099
"4115","ENSG00000121764","ENSG00000121764","HCRTR1","1",31617686,31632518,14832
"4116","ENSG00000137252","ENSG00000137252","HCRTR2","6",55106460,55282617,176157
"4117","ENSG00000116478","ENSG00000116478","HDAC1","1",32292083,32333635,41552
"4118","ENSG00000163517","ENSG00000163517","HDAC11","3",13479724,13506424,26700
"4119","ENSG00000196591","ENSG00000196591","HDAC2","6",113933028,114011308,78280
"4120","ENSG00000171720","ENSG00000171720","HDAC3","5",141620876,141636849,15973
"4121","ENSG00000068024","ENSG00000068024","HDAC4","2",239048168,239401654,353486
"4122","ENSG00000108840","ENSG00000108840","HDAC5","17",44076746,44123702,46956
"4123","ENSG00000094631","ENSG00000094631","HDAC6","X",48801377,48824982,23605
"4124","ENSG00000061273","ENSG00000061273","HDAC7","12",47782722,47833132,50410
"4125","ENSG00000048052","ENSG00000048052","HDAC9","7",18086949,19002416,915467
"4126","ENSG00000140287","ENSG00000140287","HDC","15",50241947,50265965,24018
"4127","ENSG00000111906","ENSG00000111906","HDDC2","6",125219962,125302078,82116
"4128","ENSG00000143321","ENSG00000143321","HDGF","1",156742109,156766925,24816
"4129","ENSG00000119431","ENSG00000119431","HDHD3","9",113373419,113376986,3567
"4130","ENSG00000115677","ENSG00000115677","HDLBP","2",241227264,241317061,89797
"4131","ENSG00000119285","ENSG00000119285","HEATR1","1",236549005,236604516,55511
"4132","ENSG00000155393","ENSG00000155393","HEATR3","16",50065967,50107272,41305
"4133","ENSG00000068097","ENSG00000068097","HEATR6","17",60041008,60078922,37914
"4134","ENSG00000013583","ENSG00000013583","HEBP1","12",12974870,13000265,25395
"4135","ENSG00000051620","ENSG00000051620","HEBP2","6",138403531,138422197,18666
"4136","ENSG00000112406","ENSG00000112406","HECA","6",139135080,139180802,45722
"4137","ENSG00000126107","ENSG00000126107","HECTD3","1",45002540,45011324,8784
"4138","ENSG00000173064","ENSG00000173064","HECTD4","12",112160188,112382439,222251
"4139","ENSG00000002746","ENSG00000002746","HECW1","7",43112629,43566001,453372
"4140","ENSG00000173706","ENSG00000173706","HEG1","3",124965710,125055997,90287
"4141","ENSG00000119969","ENSG00000119969","HELLS","10",94545329,94613905,68576
"4142","ENSG00000198265","ENSG00000198265","HELZ","17",67070444,67245989,175545
"4143","ENSG00000114735","ENSG00000114735","HEMK1","3",50569152,50596168,27016
"4144","ENSG00000089472","ENSG00000089472","HEPH","X",66162671,66268867,106196
"4145","ENSG00000103657","ENSG00000103657","HERC1","15",63608618,63833948,225330
"4146","ENSG00000138641","ENSG00000138641","HERC3","4",88592434,88708541,116107
"4147","ENSG00000148634","ENSG00000148634","HERC4","10",67921899,68075301,153402
"4148","ENSG00000138646","ENSG00000138646","HERC5","4",88457119,88506163,49044
"4149","ENSG00000138642","ENSG00000138642","HERC6","4",88378739,88443097,64358
"4150","ENSG00000051108","ENSG00000051108","HERPUD1","16",56932142,56944864,12722
"4151","ENSG00000163666","ENSG00000163666","HESX1","3",57197838,57227606,29768
"4152","ENSG00000213614","ENSG00000213614","HEXA","15",72340924,72376420,35496
"4153","ENSG00000049860","ENSG00000049860","HEXB","5",74640023,74722647,82624
"4154","ENSG00000186834","ENSG00000186834","HEXIM1","17",45148475,45152099,3624
"4155","ENSG00000164683","ENSG00000164683","HEY1","8",79762371,79767857,5486
"4156","ENSG00000135547","ENSG00000135547","HEY2","6",125747664,125761269,13605
"4157","ENSG00000163909","ENSG00000163909","HEYL","1",39623435,39639643,16208
"4158","ENSG00000010704","ENSG00000010704","HFE","6",26087226,26098343,11117
"4159","ENSG00000113924","ENSG00000113924","HGD","3",120628172,120682269,54097
"4160","ENSG00000019991","ENSG00000019991","HGF","7",81699010,81770438,71428
"4161","ENSG00000109758","ENSG00000109758","HGFAC","4",3441968,3449486,7518
"4162","ENSG00000235173","ENSG00000235173","HGH1","8",144137774,144140851,3077
"4163","ENSG00000185359","ENSG00000185359","HGS","17",81683326,81703138,19812
"4164","ENSG00000165102","ENSG00000165102","HGSNAT","8",43140464,43202855,62391
"4165","ENSG00000280680","ENSG00000280680","HHAT","HG1832_PATCH",107994,459395,351401
"4166","ENSG00000152804","ENSG00000152804","HHEX","10",92689955,92695647,5692
"4167","ENSG00000132297","ENSG00000132297","HHLA1","8",132061480,132111159,49679
"4168","ENSG00000114455","ENSG00000114455","HHLA2","3",108296529,108378285,81756
"4169","ENSG00000198130","ENSG00000198130","HIBCH","2",190189735,190344193,154458
"4170","ENSG00000177374","ENSG00000177374","HIC1","17",2054154,2063241,9087
"4171","ENSG00000169635","ENSG00000169635","HIC2","22",21417371,21451463,34092
"4172","ENSG00000100644","ENSG00000100644","HIF1A","14",61695513,61748259,52746
"4173","ENSG00000166135","ENSG00000166135","HIF1AN","10",100529072,100559998,30926
"4174","ENSG00000124440","ENSG00000124440","HIF3A","19",46297042,46343433,46391
"4175","ENSG00000131097","ENSG00000131097","HIGD1B","17",44846353,44850476,4123
"4176","ENSG00000149196","ENSG00000149196","HIKESHI","11",86302211,86345943,43732
"4177","ENSG00000135245","ENSG00000135245","HILPDA","7",128455849,128458418,2569
"4178","ENSG00000172273","ENSG00000172273","HINFP","11",119121580,119136059,14479
"4179","ENSG00000169567","ENSG00000169567","HINT1","5",131155383,131224468,69085
"4180","ENSG00000127946","ENSG00000127946","HIP1","7",75533298,75738962,205664
"4181","ENSG00000130787","ENSG00000130787","HIP1R","12",122834453,122862961,28508
"4182","ENSG00000163349","ENSG00000163349","HIPK1","1",113929324,113977869,48545
"4183","ENSG00000064393","ENSG00000064393","HIPK2","7",139561570,139777998,216428
"4184","ENSG00000110422","ENSG00000110422","HIPK3","11",33256672,33357023,100351
"4185","ENSG00000100084","ENSG00000100084","HIRA","22",19330698,19447450,116752
"4186","ENSG00000149929","ENSG00000149929","HIRIP3","16",29992330,29996074,3744
"4187","ENSG00000095951","ENSG00000095951","HIVEP1","6",12008762,12164999,156237
"4188","ENSG00000010818","ENSG00000010818","HIVEP2","6",142751469,142956698,205229
"4189","ENSG00000127124","ENSG00000127124","HIVEP3","1",41506365,42035925,529560
"4190","ENSG00000123485","ENSG00000123485","HJURP","2",233833416,233854566,21150
"4191","ENSG00000156515","ENSG00000156515","HK1","10",69269984,69401884,131900
"4192","ENSG00000159399","ENSG00000159399","HK2","2",74834127,74893359,59232
"4193","ENSG00000160883","ENSG00000160883","HK3","5",176880869,176899346,18477
"4194","ENSG00000156510","ENSG00000156510","HKDC1","10",69220332,69267552,47220
"4195","ENSG00000235657","ENSG00000235657","HLA-A","HSCHR6_MHC_DBB_CTG1",1144955,1265390,120435
"4196","ENSG00000243719","ENSG00000243719","HLA-DMA","HSCHR6_MHC_COX_CTG1",4360810,4382925,22115
"4197","ENSG00000242574","ENSG00000242574","HLA-DMB","6",32934629,32941028,6399
"4198","ENSG00000235744","ENSG00000235744","HLA-DOA","HSCHR6_MHC_DBB_CTG1",4247719,4253152,5433
"4199","ENSG00000243612","ENSG00000243612","HLA-DOB","HSCHR6_MHC_APD_CTG1",4117787,4122072,4285
"4200","ENSG00000236177","ENSG00000236177","HLA-DPA1","HSCHR6_MHC_SSTO_CTG1",4513552,4529758,16206
"4201","ENSG00000237710","ENSG00000237710","HLA-DPB1","HSCHR6_MHC_DBB_CTG1",4319457,4330724,11267
"4202","ENSG00000206305","ENSG00000206305","HLA-DQA1","HSCHR6_MHC_QBL_CTG1",3836385,3842664,6279
"4203","ENSG00000237541","ENSG00000237541","HLA-DQA2","6",32741391,32747198,5807
"4204","ENSG00000233209","ENSG00000233209","HLA-DQB1","HSCHR6_MHC_DBB_CTG1",3900296,3910237,9941
"4205","ENSG00000277263","ENSG00000277263","HLA-DRA","HSCHR6_8_CTG1",9689,14891,5202
"4206","ENSG00000236884","ENSG00000236884","HLA-DRB1","HSCHR6_MHC_DBB_CTG1",3814543,3848645,34102
"4207","ENSG00000198502","ENSG00000198502","HLA-DRB5","6",32517353,32530287,12934
"4208","ENSG00000236632","ENSG00000236632","HLA-E","HSCHR6_MHC_MANN_CTG1",1799702,1804440,4738
"4209","ENSG00000237508","ENSG00000237508","HLA-F","HSCHR6_MHC_MANN_CTG1",985437,1001192,15755
"4210","ENSG00000276051","ENSG00000276051","HLA-G","HSCHR6_MHC_APD_CTG1",1092579,1096751,4172
"4211","ENSG00000159267","ENSG00000159267","HLCS","21",36748626,36990236,241610
"4212","ENSG00000108924","ENSG00000108924","HLF","17",55264960,55325187,60227
"4213","ENSG00000071794","ENSG00000071794","HLTF","3",149030127,149086554,56427
"4214","ENSG00000136630","ENSG00000136630","HLX","1",220879431,220885059,5628
"4215","ENSG00000147421","ENSG00000147421","HMBOX1","8",28890395,29064764,174369
"4216","ENSG00000256269","ENSG00000256269","HMBS","11",119084866,119093834,8968
"4217","ENSG00000183624","ENSG00000183624","HMCES","3",129278828,129306186,27358
"4218","ENSG00000140382","ENSG00000140382","HMG20A","15",77420412,77485607,65195
"4219","ENSG00000064961","ENSG00000064961","HMG20B","19",3572777,3579088,6311
"4220","ENSG00000137309","ENSG00000137309","HMGA1","6",34236873,34246231,9358
"4221","ENSG00000149948","ENSG00000149948","HMGA2","12",65824460,65966291,141831
"4222","ENSG00000189403","ENSG00000189403","HMGB1","13",30456704,30617597,160893
"4223","ENSG00000164104","ENSG00000164104","HMGB2","4",173331376,173334432,3056
"4224","ENSG00000029993","ENSG00000029993","HMGB3","X",150980509,150990771,10262
"4225","ENSG00000117305","ENSG00000117305","HMGCL","1",23801885,23838620,36735
"4226","ENSG00000113161","ENSG00000113161","HMGCR","5",75336329,75364001,27672
"4227","ENSG00000112972","ENSG00000112972","HMGCS1","5",43287470,43313512,26042
"4228","ENSG00000134240","ENSG00000134240","HMGCS2","1",119748002,119768905,20903
"4229","ENSG00000205581","ENSG00000205581","HMGN1","21",39342315,39349647,7332
"4230","ENSG00000198830","ENSG00000198830","HMGN2","1",26472440,26476642,4202
"4231","ENSG00000118418","ENSG00000118418","HMGN3","6",79201245,79234689,33444
"4232","ENSG00000198157","ENSG00000198157","HMGN5","X",81113699,81201913,88214
"4233","ENSG00000113716","ENSG00000113716","HMGXB3","5",150000046,150053142,53096
"4234","ENSG00000100281","ENSG00000100281","HMGXB4","22",35257452,35295807,38355
"4235","ENSG00000072571","ENSG00000072571","HMMR","5",163460203,163491941,31738
"4236","ENSG00000100292","ENSG00000100292","HMOX1","22",35380361,35394214,13853
"4237","ENSG00000277424","ENSG00000277424","HMOX2","HSCHR16_3_CTG1",177013,212670,35657
"4238","ENSG00000215612","ENSG00000215612","HMX1","4",8846076,8871839,25763
"4239","ENSG00000135100","ENSG00000135100","HNF1A","12",120978543,121002512,23969
"4240","ENSG00000276194","ENSG00000276194","HNF1B","HSCHR17_7_CTG4",1925499,1984303,58804
"4241","ENSG00000101076","ENSG00000101076","HNF4A","20",44355699,44432845,77146
"4242","ENSG00000164749","ENSG00000164749","HNF4G","8",75407914,75566834,158920
"4243","ENSG00000150540","ENSG00000150540","HNMT","2",137964020,138016364,52344
"4244","ENSG00000177733","ENSG00000177733","HNRNPA0","5",137745651,137754363,8712
"4245","ENSG00000135486","ENSG00000135486","HNRNPA1","12",54280193,54287088,6895
"4246","ENSG00000139675","ENSG00000139675","HNRNPA1L2","13",52642431,52643773,1342
"4247","ENSG00000122566","ENSG00000122566","HNRNPA2B1","7",26171151,26201529,30378
"4248","ENSG00000170144","ENSG00000170144","HNRNPA3","2",177212694,177223959,11265
"4249","ENSG00000197451","ENSG00000197451","HNRNPAB","5",178204533,178211163,6630
"4250","ENSG00000092199","ENSG00000092199","HNRNPC","14",21209136,21269494,60358
"4251","ENSG00000138668","ENSG00000138668","HNRNPD","4",82352498,82374503,22005
"4252","ENSG00000152795","ENSG00000152795","HNRNPDL","4",82422565,82430462,7897
"4253","ENSG00000169813","ENSG00000169813","HNRNPF","10",43385617,43409186,23569
"4254","ENSG00000169045","ENSG00000169045","HNRNPH1","5",179614178,179634784,20606
"4255","ENSG00000126945","ENSG00000126945","HNRNPH2","X",101408222,101414133,5911
"4256","ENSG00000096746","ENSG00000096746","HNRNPH3","10",68331174,68343193,12019
"4257","ENSG00000165119","ENSG00000165119","HNRNPK","9",83968083,83980631,12548
"4258","ENSG00000104824","ENSG00000104824","HNRNPL","19",38836370,38852347,15977
"4259","ENSG00000099783","ENSG00000099783","HNRNPM","19",8444767,8489114,44347
"4260","ENSG00000125944","ENSG00000125944","HNRNPR","1",23303771,23344336,40565
"4261","ENSG00000153187","ENSG00000153187","HNRNPU","1",244840638,244864560,23922
"4262","ENSG00000105323","ENSG00000105323","HNRNPUL1","19",41262496,41307787,45291
"4263","ENSG00000214753","ENSG00000214753","HNRNPUL2","11",62712630,62727457,14827
"4264","ENSG00000152413","ENSG00000152413","HOMER1","5",79372636,79514134,141498
"4265","ENSG00000103942","ENSG00000103942","HOMER2","15",82836946,82986153,149207
"4266","ENSG00000051128","ENSG00000051128","HOMER3","19",18929201,18941261,12060
"4267","ENSG00000134709","ENSG00000134709","HOOK1","1",59814786,59876322,61536
"4268","ENSG00000095066","ENSG00000095066","HOOK2","19",12763003,12872740,109737
"4269","ENSG00000171476","ENSG00000171476","HOPX","4",56647989,56681877,33888
"4270","ENSG00000105991","ENSG00000105991","HOXA1","7",27092993,27096000,3007
"4271","ENSG00000253293","ENSG00000253293","HOXA10","7",27170605,27180261,9656
"4272","ENSG00000005073","ENSG00000005073","HOXA11","7",27181157,27185232,4075
"4273","ENSG00000105996","ENSG00000105996","HOXA2","7",27100354,27102686,2332
"4274","ENSG00000105997","ENSG00000105997","HOXA3","7",27106184,27152583,46399
"4275","ENSG00000197576","ENSG00000197576","HOXA4","7",27128507,27130780,2273
"4276","ENSG00000106004","ENSG00000106004","HOXA5","7",27141052,27143681,2629
"4277","ENSG00000122592","ENSG00000122592","HOXA7","7",27153716,27157936,4220
"4278","ENSG00000078399","ENSG00000078399","HOXA9","7",27162438,27175180,12742
"4279","ENSG00000120094","ENSG00000120094","HOXB1","17",48528526,48531011,2485
"4280","ENSG00000159184","ENSG00000159184","HOXB13","17",48724763,48728750,3987
"4281","ENSG00000173917","ENSG00000173917","HOXB2","17",48540894,48545109,4215
"4282","ENSG00000120093","ENSG00000120093","HOXB3","17",48548870,48604912,56042
"4283","ENSG00000120075","ENSG00000120075","HOXB5","17",48591257,48593779,2522
"4284","ENSG00000108511","ENSG00000108511","HOXB6","17",48595751,48604992,9241
"4285","ENSG00000260027","ENSG00000260027","HOXB7","17",48607232,48633572,26340
"4286","ENSG00000120068","ENSG00000120068","HOXB8","17",48611377,48615292,3915
"4287","ENSG00000180818","ENSG00000180818","HOXC10","12",53985065,53990279,5214
"4288","ENSG00000123364","ENSG00000123364","HOXC13","12",53938831,53946544,7713
"4289","ENSG00000198353","ENSG00000198353","HOXC4","12",54016931,54056030,39099
"4290","ENSG00000172789","ENSG00000172789","HOXC5","12",54033050,54035361,2311
"4291","ENSG00000197757","ENSG00000197757","HOXC6","12",53990624,54030823,40199
"4292","ENSG00000128645","ENSG00000128645","HOXD1","2",176188668,176190907,2239
"4293","ENSG00000128710","ENSG00000128710","HOXD10","2",176108790,176119937,11147
"4294","ENSG00000128713","ENSG00000128713","HOXD11","2",176104216,176109754,5538
"4295","ENSG00000128714","ENSG00000128714","HOXD13","2",176092721,176095944,3223
"4296","ENSG00000128652","ENSG00000128652","HOXD3","2",176136612,176173102,36490
"4297","ENSG00000170166","ENSG00000170166","HOXD4","2",176151550,176153226,1676
"4298","ENSG00000128709","ENSG00000128709","HOXD9","2",176122719,176124937,2218
"4299","ENSG00000257017","ENSG00000257017","HP","16",72054505,72061055,6550
"4300","ENSG00000127483","ENSG00000127483","HP1BP3","1",20740266,20787323,47057
"4301","ENSG00000121905","ENSG00000121905","HPCA","1",32885994,32898441,12447
"4302","ENSG00000115756","ENSG00000115756","HPCAL1","2",10302889,10427617,124728
"4303","ENSG00000116983","ENSG00000116983","HPCAL4","1",39678648,39691485,12837
"4304","ENSG00000158104","ENSG00000158104","HPD","12",121839527,121863596,24069
"4305","ENSG00000056050","ENSG00000056050","HPF1","4",169729470,169757944,28474
"4306","ENSG00000164120","ENSG00000164120","HPGD","4",174490175,174523154,32979
"4307","ENSG00000163106","ENSG00000163106","HPGDS","4",94298535,94342876,44341
"4308","ENSG00000105707","ENSG00000105707","HPN","19",35040506,35066573,26067
"4309","ENSG00000261701","ENSG00000261701","HPR","16",72063148,72077246,14098
"4310","ENSG00000165704","ENSG00000165704","HPRT1","X",134460165,134520513,60348
"4311","ENSG00000107521","ENSG00000107521","HPS1","10",98410939,98446963,36024
"4312","ENSG00000100099","ENSG00000100099","HPS4","22",26443107,26483931,40824
"4313","ENSG00000110756","ENSG00000110756","HPS5","11",18278668,18322198,43530
"4314","ENSG00000166189","ENSG00000166189","HPS6","10",102065349,102068036,2687
"4315","ENSG00000173083","ENSG00000173083","HPSE","4",83292461,83335153,42692
"4316","ENSG00000110169","ENSG00000110169","HPX","11",6431049,6442617,11568
"4317","ENSG00000168453","ENSG00000168453","HR","8",22114419,22133384,18965
"4318","ENSG00000276536","ENSG00000276536","HRAS","HSCHR11_1_CTG8",61883,66928,5045
"4319","ENSG00000130528","ENSG00000130528","HRC","19",49151198,49155396,4198
"4320","ENSG00000113905","ENSG00000113905","HRG","3",186660216,186678234,18018
"4321","ENSG00000196639","ENSG00000196639","HRH1","3",11137093,11263557,126464
"4322","ENSG00000113749","ENSG00000113749","HRH2","5",175658030,175710756,52726
"4323","ENSG00000101180","ENSG00000101180","HRH3","20",62214960,62220278,5318
"4324","ENSG00000134489","ENSG00000134489","HRH4","18",24460637,24479961,19324
"4325","ENSG00000118960","ENSG00000118960","HS1BP3","2",20560448,20651130,90682
"4326","ENSG00000153936","ENSG00000153936","HS2ST1","1",86914635,87109982,195347
"4327","ENSG00000002587","ENSG00000002587","HS3ST1","4",11393150,11429564,36414
"4328","ENSG00000122254","ENSG00000122254","HS3ST2","16",22814162,22916338,102176
"4329","ENSG00000153976","ENSG00000153976","HS3ST3A1","17",13494032,13601929,107897
"4330","ENSG00000125430","ENSG00000125430","HS3ST3B1","17",14301081,14349404,48323
"4331","ENSG00000136720","ENSG00000136720","HS6ST1","2",128236716,128318868,82152
"4332","ENSG00000230989","ENSG00000230989","HSBP1","16",83719311,83819737,100426
"4333","ENSG00000117594","ENSG00000117594","HSD11B1","1",209686178,209734949,48771
"4334","ENSG00000176387","ENSG00000176387","HSD11B2","16",67430652,67437553,6901
"4335","ENSG00000108786","ENSG00000108786","HSD17B1","17",42552922,42555214,2292
"4336","ENSG00000072506","ENSG00000072506","HSD17B10","X",53431258,53434370,3112
"4337","ENSG00000198189","ENSG00000198189","HSD17B11","4",87336515,87391188,54673
"4338","ENSG00000149084","ENSG00000149084","HSD17B12","11",43680680,43856617,175937
"4339","ENSG00000087076","ENSG00000087076","HSD17B14","19",48813018,48836510,23492
"4340","ENSG00000086696","ENSG00000086696","HSD17B2","16",82035004,82098534,63530
"4341","ENSG00000130948","ENSG00000130948","HSD17B3","9",96235306,96302176,66870
"4342","ENSG00000133835","ENSG00000133835","HSD17B4","5",119452465,119637199,184734
"4343","ENSG00000025423","ENSG00000025423","HSD17B6","12",56752161,56787790,35629
"4344","ENSG00000132196","ENSG00000132196","HSD17B7","1",162790702,162812823,22121
"4345","ENSG00000232357","ENSG00000232357","HSD17B8","HSCHR6_MHC_MCF_CTG1",4640595,4642784,2189
"4346","ENSG00000203857","ENSG00000203857","HSD3B1","1",119507198,119515054,7856
"4347","ENSG00000203859","ENSG00000203859","HSD3B2","1",119414931,119423035,8104
"4348","ENSG00000119471","ENSG00000119471","HSDL2","9",112380080,112472405,92325
"4349","ENSG00000185122","ENSG00000185122","HSF1","8",144291591,144314720,23129
"4350","ENSG00000025156","ENSG00000025156","HSF2","6",122399551,122433119,33568
"4351","ENSG00000160207","ENSG00000160207","HSF2BP","21",43529186,43659488,130302
"4352","ENSG00000102878","ENSG00000102878","HSF4","16",67164681,67169945,5264
"4353","ENSG00000171116","ENSG00000171116","HSFX1","X",149774068,149776867,2799
"4354","ENSG00000080824","ENSG00000080824","HSP90AA1","14",102080742,102139699,58957
"4355","ENSG00000096384","ENSG00000096384","HSP90AB1","6",44246166,44253888,7722
"4356","ENSG00000166598","ENSG00000166598","HSP90B1","12",103930107,103953931,23824
"4357","ENSG00000165868","ENSG00000165868","HSPA12A","10",116671192,116850251,179059
"4358","ENSG00000155304","ENSG00000155304","HSPA13","21",14371115,14383484,12369
"4359","ENSG00000187522","ENSG00000187522","HSPA14","10",14838306,14871741,33435
"4360","ENSG00000237724","ENSG00000237724","HSPA1A","HSCHR6_MHC_COX_CTG1",3292715,3295197,2482
"4361","ENSG00000232804","ENSG00000232804","HSPA1B","HSCHR6_MHC_APD_CTG1",3160360,3162874,2514
"4362","ENSG00000236251","ENSG00000236251","HSPA1L","HSCHR6_MHC_COX_CTG1",3286871,3292316,5445
"4363","ENSG00000126803","ENSG00000126803","HSPA2","14",64535905,64546173,10268
"4364","ENSG00000170606","ENSG00000170606","HSPA4","5",133052013,133106449,54436
"4365","ENSG00000164070","ENSG00000164070","HSPA4L","4",127781821,127840733,58912
"4366","ENSG00000044574","ENSG00000044574","HSPA5","9",125234853,125241382,6529
"4367","ENSG00000173110","ENSG00000173110","HSPA6","1",161524540,161526894,2354
"4368","ENSG00000109971","ENSG00000109971","HSPA8","11",123057489,123063230,5741
"4369","ENSG00000113013","ENSG00000113013","HSPA9","5",138553756,138575675,21919
"4370","ENSG00000106211","ENSG00000106211","HSPB1","7",76302673,76304295,1622
"4371","ENSG00000170276","ENSG00000170276","HSPB2","11",111912734,111914093,1359
"4372","ENSG00000169271","ENSG00000169271","HSPB3","5",54455699,54456377,678
"4373","ENSG00000004776","ENSG00000004776","HSPB6","19",35754566,35758079,3513
"4374","ENSG00000173641","ENSG00000173641","HSPB7","1",16014028,16019594,5566
"4375","ENSG00000152137","ENSG00000152137","HSPB8","12",119171555,119224855,53300
"4376","ENSG00000169087","ENSG00000169087","HSPBAP1","3",122739999,122793831,53832
"4377","ENSG00000133265","ENSG00000133265","HSPBP1","19",55262223,55280381,18158
"4378","ENSG00000144381","ENSG00000144381","HSPD1","2",197486584,197516737,30153
"4379","ENSG00000115541","ENSG00000115541","HSPE1","2",197500140,197503449,3309
"4380","ENSG00000142798","ENSG00000142798","HSPG2","1",21822244,21937310,115066
"4381","ENSG00000120694","ENSG00000120694","HSPH1","13",31134973,31162388,27415
"4382","ENSG00000109854","ENSG00000109854","HTATIP2","11",20363685,20383782,20097
"4383","ENSG00000102241","ENSG00000102241","HTATSF1","X",136497079,136512346,15267
"4384","ENSG00000205649","ENSG00000205649","HTN3","4",70028455,70036538,8083
"4385","ENSG00000135312","ENSG00000135312","HTR1B","6",77460924,77463491,2567
"4386","ENSG00000179546","ENSG00000179546","HTR1D","1",23191895,23217502,25607
"4387","ENSG00000168830","ENSG00000168830","HTR1E","6",86937528,87016679,79151
"4388","ENSG00000179097","ENSG00000179097","HTR1F","3",87792706,87993839,201133
"4389","ENSG00000102468","ENSG00000102468","HTR2A","13",46831546,46897076,65530
"4390","ENSG00000135914","ENSG00000135914","HTR2B","2",231108230,231125042,16812
"4391","ENSG00000147246","ENSG00000147246","HTR2C","X",114584078,114910061,325983
"4392","ENSG00000166736","ENSG00000166736","HTR3A","11",113975075,113990313,15238
"4393","ENSG00000149305","ENSG00000149305","HTR3B","11",113904796,113949079,44283
"4394","ENSG00000157219","ENSG00000157219","HTR5A","7",155070324,155087392,17068
"4395","ENSG00000158748","ENSG00000158748","HTR6","1",19664875,19680966,16091
"4396","ENSG00000148680","ENSG00000148680","HTR7","10",90740823,90858039,117216
"4397","ENSG00000166033","ENSG00000166033","HTRA1","10",122458551,122514907,56356
"4398","ENSG00000115317","ENSG00000115317","HTRA2","2",74529596,74533350,3754
"4399","ENSG00000197386","ENSG00000197386","HTT","4",3041363,3243957,202594
"4400","ENSG00000136273","ENSG00000136273","HUS1","7",47963288,47979615,16327
"4401","ENSG00000086758","ENSG00000086758","HUWE1","X",53532096,53686752,154656
"4402","ENSG00000114378","ENSG00000114378","HYAL1","3",50299890,50312381,12491
"4403","ENSG00000068001","ENSG00000068001","HYAL2","3",50317790,50322782,4992
"4404","ENSG00000186792","ENSG00000186792","HYAL3","3",50292831,50299405,6574
"4405","ENSG00000106302","ENSG00000106302","HYAL4","7",123828983,123877481,48498
"4406","ENSG00000157423","ENSG00000157423","HYDIN","16",70802084,71230722,428638
"4407","ENSG00000178922","ENSG00000178922","HYI","1",43450989,43453989,3000
"4408","ENSG00000280682","ENSG00000280682","HYOU1","HG2217_PATCH",65787,78826,13039
"4409","ENSG00000242028","ENSG00000242028","HYPK","15",43796142,43804427,8285
"4410","ENSG00000067704","ENSG00000067704","IARS2","1",220094132,220148041,53909
"4411","ENSG00000005700","ENSG00000005700","IBTK","6",82169986,82247754,77768
"4412","ENSG00000003147","ENSG00000003147","ICA1","7",8113184,8262687,149503
"4413","ENSG00000090339","ENSG00000090339","ICAM1","19",10271093,10286615,15522
"4414","ENSG00000108622","ENSG00000108622","ICAM2","17",64002594,64020634,18040
"4415","ENSG00000076662","ENSG00000076662","ICAM3","19",10333776,10339661,5885
"4416","ENSG00000105371","ENSG00000105371","ICAM4","19",10286955,10288522,1567
"4417","ENSG00000105376","ENSG00000105376","ICAM5","19",10289952,10296778,6826
"4418","ENSG00000164151","ENSG00000164151","ICE1","5",5420664,5490220,69556
"4419","ENSG00000128915","ENSG00000128915","ICE2","15",60419609,60479160,59551
"4420","ENSG00000116237","ENSG00000116237","ICMT","1",6221193,6235972,14779
"4421","ENSG00000163600","ENSG00000163600","ICOS","2",203936763,203961577,24814
"4422","ENSG00000160223","ENSG00000160223","ICOSLG","21",44215382,44241446,26064
"4423","ENSG00000125968","ENSG00000125968","ID1","20",31605283,31606515,1232
"4424","ENSG00000115738","ENSG00000115738","ID2","2",8678845,8684461,5616
"4425","ENSG00000117318","ENSG00000117318","ID3","1",23557926,23559501,1575
"4426","ENSG00000172201","ENSG00000172201","ID4","6",19837370,19842197,4827
"4427","ENSG00000119912","ENSG00000119912","IDE","10",92451684,92574096,122412
"4428","ENSG00000138413","ENSG00000138413","IDH1","2",208236229,208266074,29845
"4429","ENSG00000182054","ENSG00000182054","IDH2","15",90083045,90102477,19432
"4430","ENSG00000166411","ENSG00000166411","IDH3A","15",78131498,78171945,40447
"4431","ENSG00000101365","ENSG00000101365","IDH3B","20",2658395,2664219,5824
"4432","ENSG00000067829","ENSG00000067829","IDH3G","X",153785766,153794512,8746
"4433","ENSG00000067064","ENSG00000067064","IDI1","10",1039152,1049119,9967
"4434","ENSG00000131203","ENSG00000131203","IDO1","8",39902275,39928790,26515
"4435","ENSG00000010404","ENSG00000010404","IDS","X",149476988,149521096,44108
"4436","ENSG00000127415","ENSG00000127415","IDUA","4",986997,1004564,17567
"4437","ENSG00000160888","ENSG00000160888","IER2","19",13150411,13154911,4500
"4438","ENSG00000237155","ENSG00000237155","IER3","HSCHR6_MHC_COX_CTG1",2222939,2224294,1355
"4439","ENSG00000134049","ENSG00000134049","IER3IP1","18",47152834,47176364,23530
"4440","ENSG00000162783","ENSG00000162783","IER5","1",181088700,181092900,4200
"4441","ENSG00000010295","ENSG00000010295","IFFO1","12",6538961,6556073,17112
"4442","ENSG00000163565","ENSG00000163565","IFI16","1",158999968,159055155,55187
"4443","ENSG00000275214","ENSG00000275214","IFI27","HSCHR14_7_CTG1",1219398,1231260,11862
"4444","ENSG00000216490","ENSG00000216490","IFI30","19",18173162,18178117,4955
"4445","ENSG00000068079","ENSG00000068079","IFI35","17",43006740,43014456,7716
"4446","ENSG00000137965","ENSG00000137965","IFI44","1",78649796,78664078,14282
"4447","ENSG00000137959","ENSG00000137959","IFI44L","1",78619902,78646145,26243
"4448","ENSG00000126709","ENSG00000126709","IFI6","1",27666064,27672212,6148
"4449","ENSG00000115267","ENSG00000115267","IFIH1","2",162267074,162318684,51610
"4450","ENSG00000185745","ENSG00000185745","IFIT1","10",89392546,89406487,13941
"4451","ENSG00000119917","ENSG00000119917","IFIT3","10",89327307,89377473,50166
"4452","ENSG00000152778","ENSG00000152778","IFIT5","10",89414568,89421605,7037
"4453","ENSG00000185885","ENSG00000185885","IFITM1","11",310041,315272,5231
"4454","ENSG00000185201","ENSG00000185201","IFITM2","11",303655,309397,5742
"4455","ENSG00000142089","ENSG00000142089","IFITM3","11",319676,329475,9799
"4456","ENSG00000142166","ENSG00000142166","IFNAR1","21",33324387,33359864,35477
"4457","ENSG00000159110","ENSG00000159110","IFNAR2","21",33205282,33265675,60393
"4458","ENSG00000171855","ENSG00000171855","IFNB1","9",21077104,21077942,838
"4459","ENSG00000111537","ENSG00000111537","IFNG","12",68154768,68159740,4972
"4460","ENSG00000027697","ENSG00000027697","IFNGR1","6",137197483,137219449,21966
"4461","ENSG00000262795","ENSG00000262795","IFNGR2","HSCHR21_4_CTG1_1",5408,83477,78069
"4462","ENSG00000177047","ENSG00000177047","IFNW1","9",21140632,21141832,1200
"4463","ENSG00000006652","ENSG00000006652","IFRD1","7",112422887,112481017,58130
"4464","ENSG00000214706","ENSG00000214706","IFRD2","3",50287732,50292918,5186
"4465","ENSG00000163913","ENSG00000163913","IFT122","3",129429607,129520510,90903
"4466","ENSG00000187535","ENSG00000187535","IFT140","16",1510427,1612072,101645
"4467","ENSG00000109083","ENSG00000109083","IFT20","17",28328325,28335489,7164
"4468","ENSG00000128581","ENSG00000128581","IFT22","7",101310914,101321823,10909
"4469","ENSG00000100360","ENSG00000100360","IFT27","22",36758202,36776256,18054
"4470","ENSG00000118096","ENSG00000118096","IFT46","11",118544528,118572970,28442
"4471","ENSG00000101052","ENSG00000101052","IFT52","20",43590937,43647299,56362
"4472","ENSG00000114446","ENSG00000114446","IFT57","3",108160812,108222435,61623
"4473","ENSG00000096872","ENSG00000096872","IFT74","9",26947039,27066134,119095
"4474","ENSG00000122970","ENSG00000122970","IFT81","12",110124335,110218793,94458
"4475","ENSG00000032742","ENSG00000032742","IFT88","13",20567138,20691444,124306
"4476","ENSG00000089289","ENSG00000089289","IGBP1","X",70133447,70166324,32877
"4477","ENSG00000017427","ENSG00000017427","IGF1","12",102395874,102481744,85870
"4478","ENSG00000140443","ENSG00000140443","IGF1R","15",98648539,98964530,315991
"4479","ENSG00000167244","ENSG00000167244","IGF2","11",2129112,2158391,29279
"4480","ENSG00000073792","ENSG00000073792","IGF2BP2","3",185643130,185825042,181912
"4481","ENSG00000136231","ENSG00000136231","IGF2BP3","7",23310209,23470491,160282
"4482","ENSG00000197081","ENSG00000197081","IGF2R","6",159969082,160113507,144425
"4483","ENSG00000099769","ENSG00000099769","IGFALS","16",1790413,1794971,4558
"4484","ENSG00000146678","ENSG00000146678","IGFBP1","7",45888360,45893660,5300
"4485","ENSG00000115457","ENSG00000115457","IGFBP2","2",216632828,216664436,31608
"4486","ENSG00000146674","ENSG00000146674","IGFBP3","7",45912245,45921874,9629
"4487","ENSG00000141753","ENSG00000141753","IGFBP4","17",40443450,40457725,14275
"4488","ENSG00000115461","ENSG00000115461","IGFBP5","2",216672105,216695549,23444
"4489","ENSG00000167779","ENSG00000167779","IGFBP6","12",53097436,53102345,4909
"4490","ENSG00000163453","ENSG00000163453","IGFBP7","4",57030773,57110385,79612
"4491","ENSG00000126246","ENSG00000126246","IGFLR1","19",35738801,35742453,3652
"4492","ENSG00000132740","ENSG00000132740","IGHMBP2","11",68903863,68940602,36739
"4493","ENSG00000147255","ENSG00000147255","IGSF1","X",131273506,131578899,305393
"4494","ENSG00000143061","ENSG00000143061","IGSF3","1",116574399,116667755,93356
"4495","ENSG00000140749","ENSG00000140749","IGSF6","16",21639550,21652608,13058
"4496","ENSG00000113141","ENSG00000113141","IK","5",140647058,140662480,15422
"4497","ENSG00000104365","ENSG00000104365","IKBKB","8",42271302,42332460,61158
"4498","ENSG00000263528","ENSG00000263528","IKBKE","1",206470476,206496889,26413
"4499","ENSG00000269335","ENSG00000269335","IKBKG","X",154541199,154565046,23847
"4500","ENSG00000185811","ENSG00000185811","IKZF1","7",50304068,50405101,101033
"4501","ENSG00000030419","ENSG00000030419","IKZF2","2",212999691,213152427,152736
"4502","ENSG00000123411","ENSG00000123411","IKZF4","12",56007659,56038435,30776
"4503","ENSG00000136634","ENSG00000136634","IL10","1",206767602,206774541,6939
"4504","ENSG00000110324","ENSG00000110324","IL10RA","11",117986370,118003037,16667
"4505","ENSG00000243646","ENSG00000243646","IL10RB","21",33266367,33311420,45053
"4506","ENSG00000095752","ENSG00000095752","IL11","19",55364382,55370463,6081
"4507","ENSG00000137070","ENSG00000137070","IL11RA","9",34652162,34661902,9740
"4508","ENSG00000113302","ENSG00000113302","IL12B","5",159314780,159330863,16083
"4509","ENSG00000096996","ENSG00000096996","IL12RB1","19",18058995,18098944,39949
"4510","ENSG00000169194","ENSG00000169194","IL13","5",132656263,132661110,4847
"4511","ENSG00000131724","ENSG00000131724","IL13RA1","X",118727133,118794535,67402
"4512","ENSG00000123496","ENSG00000123496","IL13RA2","X",115003975,115019977,16002
"4513","ENSG00000164136","ENSG00000164136","IL15","4",141636583,141733987,97404
"4514","ENSG00000134470","ENSG00000134470","IL15RA","10",5943639,5978187,34548
"4515","ENSG00000172349","ENSG00000172349","IL16","15",81159575,81314058,154483
"4516","ENSG00000177663","ENSG00000177663","IL17RA","22",17084954,17115693,30739
"4517","ENSG00000056736","ENSG00000056736","IL17RB","3",53846568,53865794,19226
"4518","ENSG00000163702","ENSG00000163702","IL17RC","3",9917074,9933630,16556
"4519","ENSG00000150782","ENSG00000150782","IL18","11",112143253,112164096,20843
"4520","ENSG00000137496","ENSG00000137496","IL18BP","11",71998613,72007315,8702
"4521","ENSG00000115604","ENSG00000115604","IL18R1","2",102311529,102398777,87248
"4522","ENSG00000115607","ENSG00000115607","IL18RAP","2",102418689,102452565,33876
"4523","ENSG00000142224","ENSG00000142224","IL19","1",206770764,206842981,72217
"4524","ENSG00000115008","ENSG00000115008","IL1A","2",112773925,112784493,10568
"4525","ENSG00000125538","ENSG00000125538","IL1B","2",112829751,112836816,7065
"4526","ENSG00000115594","ENSG00000115594","IL1R1","2",102064544,102179874,115330
"4527","ENSG00000115590","ENSG00000115590","IL1R2","2",101991960,102028544,36584
"4528","ENSG00000196083","ENSG00000196083","IL1RAP","3",190514051,190659750,145699
"4529","ENSG00000115602","ENSG00000115602","IL1RL1","2",102311502,102352037,40535
"4530","ENSG00000115598","ENSG00000115598","IL1RL2","2",102187006,102240002,52996
"4531","ENSG00000136689","ENSG00000136689","IL1RN","2",113099315,113134016,34701
"4532","ENSG00000016402","ENSG00000016402","IL20RA","6",136999971,137045180,45209
"4533","ENSG00000103522","ENSG00000103522","IL21R","16",27402174,27452042,49868
"4534","ENSG00000127318","ENSG00000127318","IL22","12",68248242,68253604,5362
"4535","ENSG00000142677","ENSG00000142677","IL22RA1","1",24119771,24143140,23369
"4536","ENSG00000110944","ENSG00000110944","IL23A","12",56334174,56340410,6236
"4537","ENSG00000162892","ENSG00000162892","IL24","1",206897443,206904139,6696
"4538","ENSG00000104998","ENSG00000104998","IL27RA","19",14031762,14053218,21456
"4539","ENSG00000134460","ENSG00000134460","IL2RA","10",6010689,6062370,51681
"4540","ENSG00000100385","ENSG00000100385","IL2RB","22",37118666,37175118,56452
"4541","ENSG00000147168","ENSG00000147168","IL2RG","X",71107404,71112108,4704
"4542","ENSG00000008517","ENSG00000008517","IL32","16",3065297,3082192,16895
"4543","ENSG00000137033","ENSG00000137033","IL33","9",6215786,6257983,42197
"4544","ENSG00000136688","ENSG00000136688","IL36G","2",112973203,112985658,12455
"4545","ENSG00000136695","ENSG00000136695","IL36RN","2",113058638,113065382,6744
"4546","ENSG00000125571","ENSG00000125571","IL37","2",112911165,112918882,7717
"4547","ENSG00000185291","ENSG00000185291","IL3RA","X",1336616,1382689,46073
"4548","ENSG00000113520","ENSG00000113520","IL4","5",132673986,132682678,8692
"4549","ENSG00000077238","ENSG00000077238","IL4R","16",27313668,27364778,51110
"4550","ENSG00000113525","ENSG00000113525","IL5","5",132541445,132556838,15393
"4551","ENSG00000091181","ENSG00000091181","IL5RA","3",3066324,3126613,60289
"4552","ENSG00000136244","ENSG00000136244","IL6","7",22725884,22732002,6118
"4553","ENSG00000160712","ENSG00000160712","IL6R","1",154405193,154469450,64257
"4554","ENSG00000134352","ENSG00000134352","IL6ST","5",55935095,55995022,59927
"4555","ENSG00000104432","ENSG00000104432","IL7","8",78675743,78805523,129780
"4556","ENSG00000168685","ENSG00000168685","IL7R","5",35852695,35879603,26908
"4557","ENSG00000124334","ENSG00000124334","IL9R","X",155997696,156010817,13121
"4558","ENSG00000143621","ENSG00000143621","ILF2","1",153661788,153671028,9240
"4559","ENSG00000129351","ENSG00000129351","ILF3","19",10654304,10692400,38096
"4560","ENSG00000166333","ENSG00000166333","ILK","11",6603708,6610874,7166
"4561","ENSG00000132323","ENSG00000132323","ILKAP","2",238170402,238203708,33306
"4562","ENSG00000105135","ENSG00000105135","ILVBL","19",15114984,15125786,10802
"4563","ENSG00000132305","ENSG00000132305","IMMT","2",86143932,86195472,51540
"4564","ENSG00000177971","ENSG00000177971","IMP3","15",75639085,75648706,9621
"4565","ENSG00000136718","ENSG00000136718","IMP4","2",130342877,130347967,5090
"4566","ENSG00000133731","ENSG00000133731","IMPA1","8",81656914,81686331,29417
"4567","ENSG00000141401","ENSG00000141401","IMPA2","18",11981025,12030877,49852
"4568","ENSG00000154059","ENSG00000154059","IMPACT","18",24426634,24453531,26897
"4569","ENSG00000106348","ENSG00000106348","IMPDH1","7",128392277,128409986,17709
"4570","ENSG00000178035","ENSG00000178035","IMPDH2","3",49024325,49029447,5122
"4571","ENSG00000081148","ENSG00000081148","IMPG2","3",101222546,101320575,98029
"4572","ENSG00000148798","ENSG00000148798","INA","10",103277138,103290346,13208
"4573","ENSG00000149503","ENSG00000149503","INCENP","11",62123998,62153169,29171
"4574","ENSG00000203485","ENSG00000203485","INF2","14",104681146,104722535,41389
"4575","ENSG00000153487","ENSG00000153487","ING1","13",110712736,110723339,10603
"4576","ENSG00000168556","ENSG00000168556","ING2","4",183505058,183512429,7371
"4577","ENSG00000071243","ENSG00000071243","ING3","7",120950763,120977216,26453
"4578","ENSG00000111653","ENSG00000111653","ING4","12",6650301,6663142,12841
"4579","ENSG00000123999","ENSG00000123999","INHA","2",219569162,219575711,6549
"4580","ENSG00000122641","ENSG00000122641","INHBA","7",41667168,41705834,38666
"4581","ENSG00000175189","ENSG00000175189","INHBC","12",57434784,57452062,17278
"4582","ENSG00000139269","ENSG00000139269","INHBE","12",57452323,57459280,6957
"4583","ENSG00000115274","ENSG00000115274","INO80B","2",74455087,74457944,2857
"4584","ENSG00000114933","ENSG00000114933","INO80D","2",205993721,206086303,92582
"4585","ENSG00000151689","ENSG00000151689","INPP1","2",190343570,190371665,28095
"4586","ENSG00000040933","ENSG00000040933","INPP4A","2",98444854,98594392,149538
"4587","ENSG00000109452","ENSG00000109452","INPP4B","4",142023160,142847432,824272
"4588","ENSG00000068383","ENSG00000068383","INPP5A","10",132537787,132783480,245693
"4589","ENSG00000204084","ENSG00000204084","INPP5B","1",37860697,37947053,86356
"4590","ENSG00000281614","ENSG00000281614","INPP5D","HG2232_PATCH",5305,153241,147936
"4591","ENSG00000148384","ENSG00000148384","INPP5E","9",136428619,136439845,11226
"4592","ENSG00000198825","ENSG00000198825","INPP5F","10",119726042,119829147,103105
"4593","ENSG00000185133","ENSG00000185133","INPP5J","22",31122731,31134697,11966
"4594","ENSG00000132376","ENSG00000132376","INPP5K","17",1494577,1516742,22165
"4595","ENSG00000165458","ENSG00000165458","INPPL1","11",72223701,72239147,15446
"4596","ENSG00000254647","ENSG00000254647","INS","11",2159779,2161221,1442
"4597","ENSG00000186480","ENSG00000186480","INSIG1","7",155297776,155310235,12459
"4598","ENSG00000125629","ENSG00000125629","INSIG2","2",118088452,118110997,22545
"4599","ENSG00000248099","ENSG00000248099","INSL3","19",17816512,17821574,5062
"4600","ENSG00000120211","ENSG00000120211","INSL4","9",5231419,5235304,3885
"4601","ENSG00000120210","ENSG00000120210","INSL6","9",5123880,5185647,61767
"4602","ENSG00000173404","ENSG00000173404","INSM1","20",20368104,20370949,2845
"4603","ENSG00000171105","ENSG00000171105","INSR","19",7112255,7294414,182159
"4604","ENSG00000027644","ENSG00000027644","INSRR","1",156840063,156859117,19054
"4605","ENSG00000164880","ENSG00000164880","INTS1","7",1470277,1504389,34112
"4606","ENSG00000138785","ENSG00000138785","INTS12","4",105682627,105895986,213359
"4607","ENSG00000262826","ENSG00000262826","INTS3","HSCHR1_1_CTG31",44768,91509,46741
"4608","ENSG00000102786","ENSG00000102786","INTS6","13",51354077,51454264,100187
"4609","ENSG00000143493","ENSG00000143493","INTS7","1",211940399,212035557,95158
"4610","ENSG00000164941","ENSG00000164941","INTS8","8",94813311,94881746,68435
"4611","ENSG00000104299","ENSG00000104299","INTS9","8",28767661,28890242,122581
"4612","ENSG00000119509","ENSG00000119509","INVS","9",100099243,100302175,202932
"4613","ENSG00000176095","ENSG00000176095","IP6K1","3",49724294,49786542,62248
"4614","ENSG00000068745","ENSG00000068745","IP6K2","3",48688003,48740353,52350
"4615","ENSG00000074706","ENSG00000074706","IPCEF1","6",154154496,154356803,202307
"4616","ENSG00000117408","ENSG00000117408","IPO13","1",43946950,43968022,21072
"4617","ENSG00000196497","ENSG00000196497","IPO4","14",24180219,24188869,8650
"4618","ENSG00000065150","ENSG00000065150","IPO5","13",97953658,98024296,70638
"4619","ENSG00000205339","ENSG00000205339","IPO7","11",9384652,9448127,63475
"4620","ENSG00000133704","ENSG00000133704","IPO8","12",30628988,30695869,66881
"4621","ENSG00000198700","ENSG00000198700","IPO9","1",201829149,201884291,55142
"4622","ENSG00000197429","ENSG00000197429","IPP","1",45694324,45750653,56329
"4623","ENSG00000127080","ENSG00000127080","IPPK","9",92613183,92670131,56948
"4624","ENSG00000132321","ENSG00000132321","IQCA1","2",236324147,236507535,183388
"4625","ENSG00000173226","ENSG00000173226","IQCB1","3",121769761,121835079,65318
"4626","ENSG00000160051","ENSG00000160051","IQCC","1",32205671,32208682,3011
"4627","ENSG00000106012","ENSG00000106012","IQCE","7",2558972,2614733,55761
"4628","ENSG00000114473","ENSG00000114473","IQCG","3",197889077,197960142,71065
"4629","ENSG00000103599","ENSG00000103599","IQCH","15",67254786,67502260,247474
"4630","ENSG00000140575","ENSG00000140575","IQGAP1","15",90388242,90502239,113997
"4631","ENSG00000145703","ENSG00000145703","IQGAP2","5",76403285,76708132,304847
"4632","ENSG00000144711","ENSG00000144711","IQSEC1","3",12897043,13283281,386238
"4633","ENSG00000262607","ENSG00000262607","IQSEC3","HSCHR12_1_CTG1",60780,165481,104701
"4634","ENSG00000184216","ENSG00000184216","IRAK1","X",154010506,154019902,9396
"4635","ENSG00000090376","ENSG00000090376","IRAK3","12",66189195,66254622,65427
"4636","ENSG00000198001","ENSG00000198001","IRAK4","12",43758944,43798307,39363
"4637","ENSG00000136381","ENSG00000136381","IREB2","15",78437431,78501453,64022
"4638","ENSG00000125347","ENSG00000125347","IRF1","5",132440440,132508719,68279
"4639","ENSG00000168310","ENSG00000168310","IRF2","4",184385702,184474558,88856
"4640","ENSG00000170604","ENSG00000170604","IRF2BP1","19",45883608,45886141,2533
"4641","ENSG00000126456","ENSG00000126456","IRF3","19",49659569,49665875,6306
"4642","ENSG00000137265","ENSG00000137265","IRF4","6",391739,411443,19704
"4643","ENSG00000128604","ENSG00000128604","IRF5","7",128937457,128950038,12581
"4644","ENSG00000117595","ENSG00000117595","IRF6","1",209785617,209806175,20558
"4645","ENSG00000276561","ENSG00000276561","IRF7","HSCHR11_1_CTG8",142446,145898,3452
"4646","ENSG00000140968","ENSG00000140968","IRF8","16",85899116,85922606,23490
"4647","ENSG00000213928","ENSG00000213928","IRF9","14",24161234,24168043,6809
"4648","ENSG00000169047","ENSG00000169047","IRS1","2",226731312,226799820,68508
"4649","ENSG00000133124","ENSG00000133124","IRS4","X",108719946,108736563,16617
"4650","ENSG00000113430","ENSG00000113430","IRX4","5",1877413,1887236,9823
"4651","ENSG00000176842","ENSG00000176842","IRX5","16",54930865,54934485,3620
"4652","ENSG00000135070","ENSG00000135070","ISCA1","9",86264546,86283102,18556
"4653","ENSG00000136003","ENSG00000136003","ISCU","12",108562582,108569368,6786
"4654","ENSG00000187608","ENSG00000187608","ISG15","1",1001138,1014540,13402
"4655","ENSG00000143319","ENSG00000143319","ISG20L2","1",156721891,156728766,6875
"4656","ENSG00000016082","ENSG00000016082","ISL1","5",51383448,51394730,11282
"4657","ENSG00000129009","ENSG00000129009","ISLR","15",74173710,74176872,3162
"4658","ENSG00000066583","ENSG00000066583","ISOC1","5",129094749,129114028,19279
"4659","ENSG00000063241","ENSG00000063241","ISOC2","19",55452985,55462343,9358
"4660","ENSG00000182149","ENSG00000182149","IST1","16",71845996,71931199,85203
"4661","ENSG00000105655","ENSG00000105655","ISYNA1","19",18434388,18438167,3779
"4662","ENSG00000078747","ENSG00000078747","ITCH","20",34363235,34511773,148538
"4663","ENSG00000129636","ENSG00000129636","ITFG1","16",47154387,47464149,309762
"4664","ENSG00000111203","ENSG00000111203","ITFG2","12",2812622,2859791,47169
"4665","ENSG00000213949","ENSG00000213949","ITGA1","5",52787916,52959209,171293
"4666","ENSG00000143127","ENSG00000143127","ITGA10","1",145891208,145910111,18903
"4667","ENSG00000164171","ENSG00000164171","ITGA2","5",52989340,53094779,105439
"4668","ENSG00000005961","ENSG00000005961","ITGA2B","17",44372180,44389649,17469
"4669","ENSG00000005884","ENSG00000005884","ITGA3","17",50055968,50090481,34513
"4670","ENSG00000115232","ENSG00000115232","ITGA4","2",181457202,181538940,81738
"4671","ENSG00000161638","ENSG00000161638","ITGA5","12",54395261,54419266,24005
"4672","ENSG00000091409","ENSG00000091409","ITGA6","2",172234216,172506459,272243
"4673","ENSG00000135424","ENSG00000135424","ITGA7","12",55684568,55716404,31836
"4674","ENSG00000077943","ENSG00000077943","ITGA8","10",15513954,15719922,205968
"4675","ENSG00000144668","ENSG00000144668","ITGA9","3",37452115,37823507,371392
"4676","ENSG00000083457","ENSG00000083457","ITGAE","17",3714628,3801188,86560
"4677","ENSG00000005844","ENSG00000005844","ITGAL","16",30472658,30523567,50909
"4678","ENSG00000169896","ENSG00000169896","ITGAM","16",31259967,31332892,72925
"4679","ENSG00000138448","ENSG00000138448","ITGAV","2",186590010,186680901,90891
"4680","ENSG00000140678","ENSG00000140678","ITGAX","16",31355134,31382999,27865
"4681","ENSG00000150093","ENSG00000150093","ITGB1","10",32887273,33005792,118519
"4682","ENSG00000119185","ENSG00000119185","ITGB1BP1","2",9403475,9423528,20053
"4683","ENSG00000147166","ENSG00000147166","ITGB1BP2","X",71301750,71305371,3621
"4684","ENSG00000160255","ENSG00000160255","ITGB2","21",44885953,44931989,46036
"4685","ENSG00000259207","ENSG00000259207","ITGB3","17",47253827,47313743,59916
"4686","ENSG00000142856","ENSG00000142856","ITGB3BP","1",63440770,63593721,152951
"4687","ENSG00000132470","ENSG00000132470","ITGB4","17",75721328,75757818,36490
"4688","ENSG00000082781","ENSG00000082781","ITGB5","3",124761948,124901418,139470
"4689","ENSG00000115221","ENSG00000115221","ITGB6","2",160099667,160271888,172221
"4690","ENSG00000139626","ENSG00000139626","ITGB7","12",53191323,53207282,15959
"4691","ENSG00000105855","ENSG00000105855","ITGB8","7",20330702,20415754,85052
"4692","ENSG00000198542","ENSG00000198542","ITGBL1","13",101452593,101720856,268263
"4693","ENSG00000055957","ENSG00000055957","ITIH1","3",52777595,52792068,14473
"4694","ENSG00000151655","ENSG00000151655","ITIH2","10",7703316,7749520,46204
"4695","ENSG00000162267","ENSG00000162267","ITIH3","3",52794768,52808799,14031
"4696","ENSG00000055955","ENSG00000055955","ITIH4","3",52812962,52830688,17726
"4697","ENSG00000123243","ENSG00000123243","ITIH5","10",7559270,7666998,107728
"4698","ENSG00000113263","ENSG00000113263","ITK","5",157142933,157255185,112252
"4699","ENSG00000078596","ENSG00000078596","ITM2A","X",79360384,79367667,7283
"4700","ENSG00000136156","ENSG00000136156","ITM2B","13",48232612,48270357,37745
"4701","ENSG00000135916","ENSG00000135916","ITM2C","2",230864639,230879248,14609
"4702","ENSG00000125877","ENSG00000125877","ITPA","20",3208868,3223870,15002
"4703","ENSG00000274958","ENSG00000274958","ITPK1","HSCHR14_7_CTG1",51476,230882,179406
"4704","ENSG00000137825","ENSG00000137825","ITPKA","15",41493393,41503551,10158
"4705","ENSG00000143772","ENSG00000143772","ITPKB","1",226631690,226739323,107633
"4706","ENSG00000086544","ENSG00000086544","ITPKC","19",40717112,40740860,23748
"4707","ENSG00000150995","ENSG00000150995","ITPR1","3",4493345,4847506,354161
"4708","ENSG00000123104","ENSG00000123104","ITPR2","12",26335352,26833194,497842
"4709","ENSG00000096433","ENSG00000096433","ITPR3","6",33620365,33696574,76209
"4710","ENSG00000205726","ENSG00000205726","ITSN1","21",33642400,33899861,257461
"4711","ENSG00000198399","ENSG00000198399","ITSN2","2",24202864,24360536,157672
"4712","ENSG00000128928","ENSG00000128928","IVD","15",40405485,40435947,30462
"4713","ENSG00000116679","ENSG00000116679","IVNS1ABP","1",185296388,185317273,20885
"4714","ENSG00000099840","ENSG00000099840","IZUMO4","19",2096429,2099593,3164
"4715","ENSG00000077684","ENSG00000077684","JADE1","4",128809700,128875224,65524
"4716","ENSG00000043143","ENSG00000043143","JADE2","5",134524312,134583230,58918
"4717","ENSG00000102221","ENSG00000102221","JADE3","X",46912276,47061242,148966
"4718","ENSG00000101384","ENSG00000101384","JAG1","20",10637684,10673999,36315
"4719","ENSG00000184916","ENSG00000184916","JAG2","14",105140982,105168824,27842
"4720","ENSG00000162434","ENSG00000162434","JAK1","1",64833223,65067754,234531
"4721","ENSG00000096968","ENSG00000096968","JAK2","9",4984390,5129948,145558
"4722","ENSG00000105639","ENSG00000105639","JAK3","19",17824780,17848071,23291
"4723","ENSG00000176049","ENSG00000176049","JAKMIP2","5",147585438,147782775,197337
"4724","ENSG00000154721","ENSG00000154721","JAM2","21",25639258,25717562,78304
"4725","ENSG00000166086","ENSG00000166086","JAM3","11",134069071,134152001,82930
"4726","ENSG00000008083","ENSG00000008083","JARID2","6",15246069,15522042,275973
"4727","ENSG00000132465","ENSG00000132465","JCHAIN","4",70655541,70681817,26276
"4728","ENSG00000171988","ENSG00000171988","JMJD1C","10",63167221,63521850,354629
"4729","ENSG00000081692","ENSG00000081692","JMJD4","1",227730425,227735411,4986
"4730","ENSG00000070495","ENSG00000070495","JMJD6","17",76712832,76726799,13967
"4731","ENSG00000168970","ENSG00000168970","JMJD7-PLA2G4B","15",41828095,41848155,20060
"4732","ENSG00000100221","ENSG00000100221","JOSD1","22",38685543,38701556,16013
"4733","ENSG00000149596","ENSG00000149596","JPH2","20",44106590,44187188,80598
"4734","ENSG00000154118","ENSG00000154118","JPH3","16",87601835,87698156,96321
"4735","ENSG00000234616","ENSG00000234616","JRK","8",142657460,142681968,24508
"4736","ENSG00000183340","ENSG00000183340","JRKL","11",96389989,96507574,117585
"4737","ENSG00000143543","ENSG00000143543","JTB","1",153974269,153977674,3405
"4738","ENSG00000177606","ENSG00000177606","JUN","1",58776845,58784048,7203
"4739","ENSG00000130522","ENSG00000130522","JUND","19",18279694,18281622,1928
"4740","ENSG00000173801","ENSG00000173801","JUP","17",41754604,41786931,32327
"4741","ENSG00000160145","ENSG00000160145","KALRN","3",124033369,124726325,692956
"4742","ENSG00000107104","ENSG00000107104","KANK1","9",470291,746105,275814
"4743","ENSG00000197256","ENSG00000197256","KANK2","19",11164270,11197791,33521
"4744","ENSG00000186994","ENSG00000186994","KANK3","19",8322584,8343262,20678
"4745","ENSG00000144445","ENSG00000144445","KANSL1L","2",210021421,210171409,149988
"4746","ENSG00000139620","ENSG00000139620","KANSL2","12",48653211,48682238,29027
"4747","ENSG00000114982","ENSG00000114982","KANSL3","2",96593170,96642787,49617
"4748","ENSG00000108773","ENSG00000108773","KAT2A","17",42113111,42121367,8256
"4749","ENSG00000114166","ENSG00000114166","KAT2B","3",20040446,20154404,113958
"4750","ENSG00000172977","ENSG00000172977","KAT5","11",65711996,65719604,7608
"4751","ENSG00000083168","ENSG00000083168","KAT6A","8",41929479,42051994,122515
"4752","ENSG00000281813","ENSG00000281813","KAT6B","HG2191_PATCH",29603,237300,207697
"4753","ENSG00000136504","ENSG00000136504","KAT7","17",49788624,49835026,46402
"4754","ENSG00000103510","ENSG00000103510","KAT8","16",31114489,31131393,16904
"4755","ENSG00000186625","ENSG00000186625","KATNA1","6",149594873,149648972,54099
"4756","ENSG00000140854","ENSG00000140854","KATNB1","16",57735739,57757244,21505
"4757","ENSG00000134152","ENSG00000134152","KATNBL1","15",34140674,34210096,69422
"4758","ENSG00000107821","ENSG00000107821","KAZALD1","10",101061989,101068131,6142
"4759","ENSG00000189337","ENSG00000189337","KAZN","1",13892792,15118043,1225251
"4760","ENSG00000273645","ENSG00000273645","KBTBD11","HSCHR8_8_CTG1",157254,190312,33058
"4761","ENSG00000170852","ENSG00000170852","KBTBD2","7",32868172,32894131,25959
"4762","ENSG00000123444","ENSG00000123444","KBTBD4","11",47572197,47578976,6779
"4763","ENSG00000176407","ENSG00000176407","KCMF1","2",84971093,85059472,88379
"4764","ENSG00000111262","ENSG00000111262","KCNA1","12",4909905,4918256,8351
"4765","ENSG00000177301","ENSG00000177301","KCNA2","1",110519837,110631474,111637
"4766","ENSG00000177272","ENSG00000177272","KCNA3","1",110653560,110674940,21380
"4767","ENSG00000182255","ENSG00000182255","KCNA4","11",30009730,30017030,7300
"4768","ENSG00000130037","ENSG00000130037","KCNA5","12",5043879,5046788,2909
"4769","ENSG00000151079","ENSG00000151079","KCNA6","12",4809334,4813318,3984
"4770","ENSG00000169282","ENSG00000169282","KCNAB1","3",156037701,156538756,501055
"4771","ENSG00000069424","ENSG00000069424","KCNAB2","1",5990927,6101193,110266
"4772","ENSG00000170049","ENSG00000170049","KCNAB3","17",7921859,7929856,7997
"4773","ENSG00000158445","ENSG00000158445","KCNB1","20",49293394,49484297,190903
"4774","ENSG00000129159","ENSG00000129159","KCNC1","11",17734774,17856804,122030
"4775","ENSG00000166006","ENSG00000166006","KCNC2","12",75040077,75209839,169762
"4776","ENSG00000102057","ENSG00000102057","KCND1","X",48961378,48971844,10466
"4777","ENSG00000184408","ENSG00000184408","KCND2","7",120273175,120750337,477162
"4778","ENSG00000171385","ENSG00000171385","KCND3","1",111770662,111989668,219006
"4779","ENSG00000152049","ENSG00000152049","KCNE4","2",223052190,223198399,146209
"4780","ENSG00000176076","ENSG00000176076","KCNE5","X",109623700,109625172,1472
"4781","ENSG00000162975","ENSG00000162975","KCNF1","2",10911934,10914225,2291
"4782","ENSG00000026559","ENSG00000026559","KCNG1","20",51003656,51023107,19451
"4783","ENSG00000178342","ENSG00000178342","KCNG2","18",79797938,79900184,102246
"4784","ENSG00000143473","ENSG00000143473","KCNH1","1",210676823,211134165,457342
"4785","ENSG00000055118","ENSG00000055118","KCNH2","7",150944961,150978321,33360
"4786","ENSG00000089558","ENSG00000089558","KCNH4","17",42156891,42181142,24251
"4787","ENSG00000173826","ENSG00000173826","KCNH6","17",63523334,63548977,25643
"4788","ENSG00000182132","ENSG00000182132","KCNIP1","5",170353487,170736632,383145
"4789","ENSG00000120049","ENSG00000120049","KCNIP2","10",101825974,101843920,17946
"4790","ENSG00000151704","ENSG00000151704","KCNJ1","11",128836315,128867373,31058
"4791","ENSG00000177807","ENSG00000177807","KCNJ10","1",159998651,160070483,71832
"4792","ENSG00000184185","ENSG00000184185","KCNJ12","17",21376357,21419870,43513
"4793","ENSG00000115474","ENSG00000115474","KCNJ13","2",232765802,232776565,10763
"4794","ENSG00000182324","ENSG00000182324","KCNJ14","19",48455574,48466980,11406
"4795","ENSG00000157551","ENSG00000157551","KCNJ15","21",38155549,38307357,151808
"4796","ENSG00000153822","ENSG00000153822","KCNJ16","17",70053429,70135608,82179
"4797","ENSG00000123700","ENSG00000123700","KCNJ2","17",70168673,70180044,11371
"4798","ENSG00000162989","ENSG00000162989","KCNJ3","2",154697855,154858354,160499
"4799","ENSG00000168135","ENSG00000168135","KCNJ4","22",38426327,38455199,28872
"4800","ENSG00000120457","ENSG00000120457","KCNJ5","11",128891356,128921163,29807
"4801","ENSG00000121361","ENSG00000121361","KCNJ8","12",21764955,21775600,10645
"4802","ENSG00000162728","ENSG00000162728","KCNJ9","1",160081538,160090563,9025
"4803","ENSG00000135750","ENSG00000135750","KCNK1","1",233614106,233672514,58408
"4804","ENSG00000184261","ENSG00000184261","KCNK12","2",47509290,47570985,61695
"4805","ENSG00000152315","ENSG00000152315","KCNK13","14",90061994,90185853,123859
"4806","ENSG00000124249","ENSG00000124249","KCNK15","20",44745865,44752313,6448
"4807","ENSG00000082482","ENSG00000082482","KCNK2","1",215005775,215237090,231315
"4808","ENSG00000171303","ENSG00000171303","KCNK3","2",26692722,26733420,40698
"4809","ENSG00000182450","ENSG00000182450","KCNK4","11",64291302,64300031,8729
"4810","ENSG00000164626","ENSG00000164626","KCNK5","6",39188971,39229475,40504
"4811","ENSG00000173338","ENSG00000173338","KCNK7","11",65592836,65595996,3160
"4812","ENSG00000156113","ENSG00000156113","KCNMA1","10",76869601,77638369,768768
"4813","ENSG00000145936","ENSG00000145936","KCNMB1","5",170374671,170389634,14963
"4814","ENSG00000197584","ENSG00000197584","KCNMB2","3",178272932,178844429,571497
"4815","ENSG00000171121","ENSG00000171121","KCNMB3","3",179236691,179267002,30311
"4816","ENSG00000135643","ENSG00000135643","KCNMB4","12",70366290,70434292,68002
"4817","ENSG00000105642","ENSG00000105642","KCNN1","19",17951293,18000085,48792
"4818","ENSG00000080709","ENSG00000080709","KCNN2","5",114055926,114496500,440574
"4819","ENSG00000143603","ENSG00000143603","KCNN3","1",154697455,154870281,172826
"4820","ENSG00000104783","ENSG00000104783","KCNN4","19",43766533,43780976,14443
"4821","ENSG00000282076","ENSG00000282076","KCNQ1","HSCHR11_1_CTG7",1031,81275,80244
"4822","ENSG00000281151","ENSG00000281151","KCNQ2","HSCHR20_1_CTG4",183,51430,51247
"4823","ENSG00000184156","ENSG00000184156","KCNQ3","8",132120861,132481095,360234
"4824","ENSG00000117013","ENSG00000117013","KCNQ4","1",40783787,40840452,56665
"4825","ENSG00000124134","ENSG00000124134","KCNS1","20",45091214,45101127,9913
"4826","ENSG00000170745","ENSG00000170745","KCNS3","2",17877847,18361616,483769
"4827","ENSG00000164794","ENSG00000164794","KCNV1","8",109963636,109975771,12135
"4828","ENSG00000168263","ENSG00000168263","KCNV2","9",2717510,2730037,12527
"4829","ENSG00000178695","ENSG00000178695","KCTD12","13",76880175,76886405,6230
"4830","ENSG00000174943","ENSG00000174943","KCTD13","16",29905012,29926236,21224
"4831","ENSG00000151364","ENSG00000151364","KCTD14","11",78015715,78046191,30476
"4832","ENSG00000153885","ENSG00000153885","KCTD15","19",33795933,33815763,19830
"4833","ENSG00000100379","ENSG00000100379","KCTD17","22",37051739,37063390,11651
"4834","ENSG00000180901","ENSG00000180901","KCTD2","17",75032575,75065889,33314
"4835","ENSG00000112078","ENSG00000112078","KCTD20","6",36442767,36491143,48376
"4836","ENSG00000136636","ENSG00000136636","KCTD3","1",215567304,215621807,54503
"4837","ENSG00000167977","ENSG00000167977","KCTD5","16",2682523,2709030,26507
"4838","ENSG00000104756","ENSG00000104756","KCTD9","8",25427847,25458476,30629
"4839","ENSG00000105438","ENSG00000105438","KDELR1","19",48382575,48391551,8976
"4840","ENSG00000136240","ENSG00000136240","KDELR2","7",6445953,6484190,38237
"4841","ENSG00000100196","ENSG00000100196","KDELR3","22",38468078,38483447,15369
"4842","ENSG00000004487","ENSG00000004487","KDM1A","1",23019443,23083689,64246
"4843","ENSG00000173120","ENSG00000173120","KDM2A","11",67119263,67258082,138819
"4844","ENSG00000115548","ENSG00000115548","KDM3A","2",86440647,86492716,52069
"4845","ENSG00000120733","ENSG00000120733","KDM3B","5",138352685,138437028,84343
"4846","ENSG00000066135","ENSG00000066135","KDM4A","1",43650149,43705518,55369
"4847","ENSG00000127663","ENSG00000127663","KDM4B","19",4969113,5153598,184485
"4848","ENSG00000107077","ENSG00000107077","KDM4C","9",6720863,7175648,454785
"4849","ENSG00000186280","ENSG00000186280","KDM4D","11",94973709,94999519,25810
"4850","ENSG00000073614","ENSG00000073614","KDM5A","12",280057,389320,109263
"4851","ENSG00000117139","ENSG00000117139","KDM5B","1",202724495,202808487,83992
"4852","ENSG00000126012","ENSG00000126012","KDM5C","X",53176283,53225422,49139
"4853","ENSG00000012817","ENSG00000012817","KDM5D","Y",19703865,19744939,41074
"4854","ENSG00000147050","ENSG00000147050","KDM6A","X",44873188,45112779,239591
"4855","ENSG00000132510","ENSG00000132510","KDM6B","17",7834217,7854796,20579
"4856","ENSG00000155666","ENSG00000155666","KDM8","16",27203508,27221768,18260
"4857","ENSG00000128052","ENSG00000128052","KDR","4",55078481,55125595,47114
"4858","ENSG00000119537","ENSG00000119537","KDSR","18",63327726,63367228,39502
"4859","ENSG00000079999","ENSG00000079999","KEAP1","19",10486125,10503558,17433
"4860","ENSG00000276615","ENSG00000276615","KEL","HSCHR7_2_CTG6",964181,985748,21567
"4861","ENSG00000135314","ENSG00000135314","KHDC1","6",73241314,73310365,69051
"4862","ENSG00000121774","ENSG00000121774","KHDRBS1","1",32013868,32060850,46982
"4863","ENSG00000131773","ENSG00000131773","KHDRBS3","8",135457456,135656722,199266
"4864","ENSG00000138030","ENSG00000138030","KHK","2",27086772,27100762,13990
"4865","ENSG00000100441","ENSG00000100441","KHNYN","14",24429286,24441843,12557
"4866","ENSG00000088247","ENSG00000088247","KHSRP","19",6413102,6424811,11709
"4867","ENSG00000235750","ENSG00000235750","KIAA0040","1",175156986,175192999,36013
"4868","ENSG00000170871","ENSG00000170871","KIAA0232","4",6781375,6884170,102795
"4869","ENSG00000137261","ENSG00000137261","KIAA0319","6",24544104,24646191,102087
"4870","ENSG00000142687","ENSG00000142687","KIAA0319L","1",35393883,35557950,164067
"4871","ENSG00000189367","ENSG00000189367","KIAA0408","6",127438406,127459389,20983
"4872","ENSG00000135709","ENSG00000135709","KIAA0513","16",85027782,85094230,66448
"4873","ENSG00000100578","ENSG00000100578","KIAA0586","14",58427385,58551297,123912
"4874","ENSG00000198920","ENSG00000198920","KIAA0753","17",6578147,6640711,62564
"4875","ENSG00000100364","ENSG00000100364","KIAA0930","22",45192244,45240894,48650
"4876","ENSG00000122778","ENSG00000122778","KIAA1549","7",138831381,138981389,150008
"4877","ENSG00000110427","ENSG00000110427","KIAA1549L","11",33376108,33674102,297994
"4878","ENSG00000134313","ENSG00000134313","KIDINS220","2",8721081,8837630,116549
"4879","ENSG00000138160","ENSG00000138160","KIF11","10",92574105,92655395,81290
"4880","ENSG00000137177","ENSG00000137177","KIF13A","6",17759183,17987635,228452
"4881","ENSG00000197892","ENSG00000197892","KIF13B","8",29067278,29263124,195846
"4882","ENSG00000118193","ENSG00000118193","KIF14","1",200551497,200620751,69254
"4883","ENSG00000280610","ENSG00000280610","KIF15","HG2066_PATCH",287071,398726,111655
"4884","ENSG00000089177","ENSG00000089177","KIF16B","20",16272104,16573448,301344
"4885","ENSG00000117245","ENSG00000117245","KIF17","1",20664014,20718017,54003
"4886","ENSG00000121621","ENSG00000121621","KIF18A","11",28020619,28108156,87537
"4887","ENSG00000130294","ENSG00000130294","KIF1A","2",240713761,240824293,110532
"4888","ENSG00000054523","ENSG00000054523","KIF1B","1",10210570,10381603,171033
"4889","ENSG00000129250","ENSG00000129250","KIF1C","17",4997950,5028401,30451
"4890","ENSG00000112984","ENSG00000112984","KIF20A","5",138178719,138187723,9004
"4891","ENSG00000138182","ENSG00000138182","KIF20B","10",89701590,89774939,73349
"4892","ENSG00000116852","ENSG00000116852","KIF21B","1",200969390,201023714,54324
"4893","ENSG00000079616","ENSG00000079616","KIF22","16",29790727,29805385,14658
"4894","ENSG00000137807","ENSG00000137807","KIF23","15",69414246,69448427,34181
"4895","ENSG00000186638","ENSG00000186638","KIF24","9",34252380,34329268,76888
"4896","ENSG00000125337","ENSG00000125337","KIF25","6",167996241,168045091,48850
"4897","ENSG00000281216","ENSG00000281216","KIF26B","HSCHR1_1_CTG32_1",47982,407457,359475
"4898","ENSG00000068796","ENSG00000068796","KIF2A","5",62306162,62391025,84863
"4899","ENSG00000142945","ENSG00000142945","KIF2C","1",44739818,44767767,27949
"4900","ENSG00000131437","ENSG00000131437","KIF3A","5",132692628,132737638,45010
"4901","ENSG00000101350","ENSG00000101350","KIF3B","20",32277651,32335011,57360
"4902","ENSG00000084731","ENSG00000084731","KIF3C","2",25926598,25982749,56151
"4903","ENSG00000090889","ENSG00000090889","KIF4A","X",70290104,70420886,130782
"4904","ENSG00000155980","ENSG00000155980","KIF5A","12",57546026,57586633,40607
"4905","ENSG00000170759","ENSG00000170759","KIF5B","10",32009015,32056425,47410
"4906","ENSG00000276734","ENSG00000276734","KIF5C","HSCHR2_2_CTG7_2",3216,96131,92915
"4907","ENSG00000075945","ENSG00000075945","KIFAP3","1",169921326,170085208,163882
"4908","ENSG00000237649","ENSG00000237649","KIFC1","6",33391823,33409896,18073
"4909","ENSG00000140859","ENSG00000140859","KIFC3","16",57758217,57863053,104836
"4910","ENSG00000151657","ENSG00000151657","KIN","10",7750962,7787993,37031
"4911","ENSG00000278074","ENSG00000278074","KIR2DL4","HSCHR19KIR_RSH_A_HAP_CTG3_1",54778,65492,10714
"4912","ENSG00000278850","ENSG00000278850","KIR3DL2","HSCHR19KIR_FH13_A_HAP_CTG3_1",2199,18974,16775
"4913","ENSG00000170498","ENSG00000170498","KISS1","1",204190341,204196491,6150
"4914","ENSG00000157404","ENSG00000157404","KIT","4",54657267,54740783,83516
"4915","ENSG00000088970","ENSG00000088970","KIZ","20",21125983,21246622,120639
"4916","ENSG00000133116","ENSG00000133116","KL","13",33016423,33066143,49720
"4917","ENSG00000126214","ENSG00000126214","KLC1","14",103561896,103714249,152353
"4918","ENSG00000174996","ENSG00000174996","KLC2","11",66257294,66267860,10566
"4919","ENSG00000105610","ENSG00000105610","KLF1","19",12884422,12887201,2779
"4920","ENSG00000155090","ENSG00000155090","KLF10","8",102648784,102655725,6941
"4921","ENSG00000172059","ENSG00000172059","KLF11","2",10042849,10054836,11987
"4922","ENSG00000118922","ENSG00000118922","KLF12","13",73686089,74134404,448315
"4923","ENSG00000275746","ENSG00000275746","KLF13","HSCHR15_4_CTG8",3612704,3663742,51038
"4924","ENSG00000127528","ENSG00000127528","KLF2","19",16324826,16328685,3859
"4925","ENSG00000109787","ENSG00000109787","KLF3","4",38664197,38701517,37320
"4926","ENSG00000136826","ENSG00000136826","KLF4","9",107484852,107490482,5630
"4927","ENSG00000102554","ENSG00000102554","KLF5","13",73054976,73077541,22565
"4928","ENSG00000067082","ENSG00000067082","KLF6","10",3775996,3785281,9285
"4929","ENSG00000118263","ENSG00000118263","KLF7","2",207074137,207173856,99719
"4930","ENSG00000102349","ENSG00000102349","KLF8","X",56232356,56291531,59175
"4931","ENSG00000119138","ENSG00000119138","KLF9","9",70384604,70414657,30053
"4932","ENSG00000128607","ENSG00000128607","KLHDC10","7",130070534,130135705,65171
"4933","ENSG00000165516","ENSG00000165516","KLHDC2","14",49768130,49786385,18255
"4934","ENSG00000104731","ENSG00000104731","KLHDC4","16",87696485,87765992,69507
"4935","ENSG00000162873","ENSG00000162873","KLHDC8A","1",205336061,205357090,21029
"4936","ENSG00000150361","ENSG00000150361","KLHL1","13",69700594,70108493,407899
"4937","ENSG00000178502","ENSG00000178502","KLHL11","17",41848518,41865423,16905
"4938","ENSG00000117153","ENSG00000117153","KLHL12","1",202891116,202928636,37520
"4939","ENSG00000114648","ENSG00000114648","KLHL18","3",47282917,47346816,63899
"4940","ENSG00000109466","ENSG00000109466","KLHL2","4",165207561,165323156,115595
"4941","ENSG00000076321","ENSG00000076321","KLHL20","1",173714941,173786692,71751
"4942","ENSG00000162413","ENSG00000162413","KLHL21","1",6590724,6614607,23883
"4943","ENSG00000099910","ENSG00000099910","KLHL22","22",20441519,20495844,54325
"4944","ENSG00000213160","ENSG00000213160","KLHL23","2",169694488,169776989,82501
"4945","ENSG00000114796","ENSG00000114796","KLHL24","3",183635610,183684519,48909
"4946","ENSG00000183655","ENSG00000183655","KLHL25","15",85759326,85794925,35599
"4947","ENSG00000167487","ENSG00000167487","KLHL26","19",18637025,18671721,34696
"4948","ENSG00000179454","ENSG00000179454","KLHL28","14",44924324,45042322,117998
"4949","ENSG00000119771","ENSG00000119771","KLHL29","2",23385179,23708611,323432
"4950","ENSG00000146021","ENSG00000146021","KLHL3","5",137617500,137736089,118589
"4951","ENSG00000149243","ENSG00000149243","KLHL35","11",75422394,75433203,10809
"4952","ENSG00000135686","ENSG00000135686","KLHL36","16",84648511,84667686,19175
"4953","ENSG00000102271","ENSG00000102271","KLHL4","X",87517409,87670050,152641
"4954","ENSG00000239474","ENSG00000239474","KLHL41","2",169509702,169526258,16556
"4955","ENSG00000109790","ENSG00000109790","KLHL5","4",39045039,39126857,81818
"4956","ENSG00000122550","ENSG00000122550","KLHL7","7",23105758,23177914,72156
"4957","ENSG00000198642","ENSG00000198642","KLHL9","9",21329665,21335404,5739
"4958","ENSG00000167748","ENSG00000167748","KLK1","19",50819146,50823787,4641
"4959","ENSG00000129451","ENSG00000129451","KLK10","19",51012739,51020175,7436
"4960","ENSG00000167757","ENSG00000167757","KLK11","19",51022216,51028039,5823
"4961","ENSG00000186474","ENSG00000186474","KLK12","19",51029092,51035230,6138
"4962","ENSG00000167759","ENSG00000167759","KLK13","19",51055626,51065114,9488
"4963","ENSG00000129437","ENSG00000129437","KLK14","19",51077495,51084245,6750
"4964","ENSG00000174562","ENSG00000174562","KLK15","19",50825289,50837213,11924
"4965","ENSG00000167751","ENSG00000167751","KLK2","19",50861568,50880567,18999
"4966","ENSG00000142515","ENSG00000142515","KLK3","19",50854915,50860764,5849
"4967","ENSG00000167754","ENSG00000167754","KLK5","19",50943303,50953093,9790
"4968","ENSG00000167755","ENSG00000167755","KLK6","19",50958631,50969673,11042
"4969","ENSG00000169035","ENSG00000169035","KLK7","19",50976468,50984099,7631
"4970","ENSG00000164344","ENSG00000164344","KLKB1","4",186226438,186258471,32033
"4971","ENSG00000111796","ENSG00000111796","KLRB1","12",9594551,9607916,13365
"4972","ENSG00000134545","ENSG00000134545","KLRC1","12",10442264,10454685,12421
"4973","ENSG00000205809","ENSG00000205809","KLRC2","12",10426854,10442300,15446
"4974","ENSG00000205810","ENSG00000205810","KLRC3","12",10412315,10420595,8280
"4975","ENSG00000134539","ENSG00000134539","KLRD1","12",10226058,10329608,103550
"4976","ENSG00000139187","ENSG00000139187","KLRG1","12",8950044,9010760,60716
"4977","ENSG00000213809","ENSG00000213809","KLRK1","12",10372353,10391874,19521
"4978","ENSG00000117009","ENSG00000117009","KMO","1",241532134,241595642,63508
"4979","ENSG00000118058","ENSG00000118058","KMT2A","11",118436456,118526832,90376
"4980","ENSG00000272333","ENSG00000272333","KMT2B","19",35717973,35738880,20907
"4981","ENSG00000167548","ENSG00000167548","KMT2D","12",49018975,49060794,41819
"4982","ENSG00000183955","ENSG00000183955","KMT5A","12",123384132,123409353,25221
"4983","ENSG00000110066","ENSG00000110066","KMT5B","11",68154863,68213852,58989
"4984","ENSG00000113889","ENSG00000113889","KNG1","3",186717348,186744410,27062
"4985","ENSG00000184445","ENSG00000184445","KNTC1","12",122527246,122626396,99150
"4986","ENSG00000114030","ENSG00000114030","KPNA1","3",122421902,122514945,93043
"4987","ENSG00000182481","ENSG00000182481","KPNA2","17",68035636,68047364,11728
"4988","ENSG00000102753","ENSG00000102753","KPNA3","13",49699320,49792682,93362
"4989","ENSG00000186432","ENSG00000186432","KPNA4","3",160495007,160565571,70564
"4990","ENSG00000196911","ENSG00000196911","KPNA5","6",116681187,116741867,60680
"4991","ENSG00000025800","ENSG00000025800","KPNA6","1",32108056,32176563,68507
"4992","ENSG00000108424","ENSG00000108424","KPNB1","17",47649476,47685505,36029
"4993","ENSG00000118162","ENSG00000118162","KPTN","19",47475150,47484265,9115
"4994","ENSG00000133703","ENSG00000133703","KRAS","12",25205246,25250936,45690
"4995","ENSG00000147121","ENSG00000147121","KRBOX4","X",46447292,46497422,50130
"4996","ENSG00000172086","ENSG00000172086","KRCC1","2",88027205,88064252,37047
"4997","ENSG00000131650","ENSG00000131650","KREMEN2","16",2964216,2968380,4164
"4998","ENSG00000129347","ENSG00000129347","KRI1","19",10553085,10566031,12946
"4999","ENSG00000001631","ENSG00000001631","KRIT1","7",92197498,92246166,48668
"5000","ENSG00000111615","ENSG00000111615","KRR1","12",75490863,75511636,20773
"5001","ENSG00000167768","ENSG00000167768","KRT1","12",52674736,52680407,5671
"5002","ENSG00000186395","ENSG00000186395","KRT10","17",40818117,40822614,4497
"5003","ENSG00000263243","ENSG00000263243","KRT12","HSCHR17_4_CTG4",10571,16478,5907
"5004","ENSG00000171401","ENSG00000171401","KRT13","17",41500981,41505705,4724
"5005","ENSG00000186847","ENSG00000186847","KRT14","17",41582279,41586895,4616
"5006","ENSG00000171346","ENSG00000171346","KRT15","17",41513745,41522529,8784
"5007","ENSG00000128422","ENSG00000128422","KRT17","17",41619442,41624842,5400
"5008","ENSG00000111057","ENSG00000111057","KRT18","12",52948871,52952906,4035
"5009","ENSG00000171345","ENSG00000171345","KRT19","17",41523617,41528308,4691
"5010","ENSG00000172867","ENSG00000172867","KRT2","12",52644558,52652211,7653
"5011","ENSG00000263309","ENSG00000263309","KRT23","HSCHR17_4_CTG4",71964,86902,14938
"5012","ENSG00000167916","ENSG00000167916","KRT24","17",40697991,40703752,5761
"5013","ENSG00000262993","ENSG00000262993","KRT31","HSCHR17_1_CTG4",35369,39237,3868
"5014","ENSG00000263012","ENSG00000263012","KRT33B","HSCHR17_1_CTG4",70461,76767,6306
"5015","ENSG00000262045","ENSG00000262045","KRT34","HSCHR17_1_CTG4",57861,62596,4735
"5016","ENSG00000170477","ENSG00000170477","KRT4","12",52806549,52814116,7567
"5017","ENSG00000186081","ENSG00000186081","KRT5","12",52514575,52520530,5955
"5018","ENSG00000205420","ENSG00000205420","KRT6A","12",52487176,52493257,6081
"5019","ENSG00000185479","ENSG00000185479","KRT6B","12",52446651,52452146,5495
"5020","ENSG00000170465","ENSG00000170465","KRT6C","12",52468516,52473805,5289
"5021","ENSG00000135480","ENSG00000135480","KRT7","12",52232520,52252186,19666
"5022","ENSG00000170421","ENSG00000170421","KRT8","12",52897187,52949954,52767
"5023","ENSG00000205426","ENSG00000205426","KRT81","12",52285913,52291534,5621
"5024","ENSG00000170523","ENSG00000170523","KRT83","12",52314301,52321398,7097
"5025","ENSG00000135443","ENSG00000135443","KRT85","12",52360006,52367481,7475
"5026","ENSG00000170442","ENSG00000170442","KRT86","12",52249300,52309163,59863
"5027","ENSG00000171403","ENSG00000171403","KRT9","17",41565836,41572059,6223
"5028","ENSG00000254997","ENSG00000254997","KRTAP5-9","11",71548420,71549608,1188
"5029","ENSG00000141068","ENSG00000141068","KSR1","17",27456448,27626438,169990
"5030","ENSG00000126777","ENSG00000126777","KTN1","14",55559072,55701526,142454
"5031","ENSG00000171097","ENSG00000171097","KYAT1","9",128832942,128882494,49552
"5032","ENSG00000137944","ENSG00000137944","KYAT3","1",88935773,88992953,57180
"5033","ENSG00000115919","ENSG00000115919","KYNU","2",142877657,143055833,178176
"5034","ENSG00000198910","ENSG00000198910","L1CAM","X",153861514,153886173,24659
"5035","ENSG00000240563","ENSG00000240563","L1TD1","1",62194849,62212328,17479
"5036","ENSG00000087299","ENSG00000087299","L2HGDH","14",50237563,50312229,74666
"5037","ENSG00000185513","ENSG00000185513","L3MBTL1","20",43489442,43550954,61512
"5038","ENSG00000147592","ENSG00000147592","LACTB2","8",70635318,70669185,33867
"5039","ENSG00000159166","ENSG00000159166","LAD1","1",201380833,201399915,19082
"5040","ENSG00000089692","ENSG00000089692","LAG3","12",6772512,6778455,5943
"5041","ENSG00000196976","ENSG00000196976","LAGE3","X",154477775,154479281,1506
"5042","ENSG00000274110","ENSG00000274110","LAIR1","HSCHR19LRC_PGF1_CTG3_1",258363,275291,16928
"5043","ENSG00000277335","ENSG00000277335","LAIR2","HSCHR19_4_CTG3_1",480214,493011,12797
"5044","ENSG00000101680","ENSG00000101680","LAMA1","18",6941742,7117797,176055
"5045","ENSG00000196569","ENSG00000196569","LAMA2","6",128883138,129516566,633428
"5046","ENSG00000053747","ENSG00000053747","LAMA3","18",23689453,23956222,266769
"5047","ENSG00000112769","ENSG00000112769","LAMA4","6",112107931,112254939,147008
"5048","ENSG00000130702","ENSG00000130702","LAMA5","20",62307955,62367312,59357
"5049","ENSG00000091136","ENSG00000091136","LAMB1","7",107923799,108003213,79414
"5050","ENSG00000172037","ENSG00000172037","LAMB2","3",49121114,49133118,12004
"5051","ENSG00000196878","ENSG00000196878","LAMB3","1",209614870,209652425,37555
"5052","ENSG00000135862","ENSG00000135862","LAMC1","1",183023420,183145592,122172
"5053","ENSG00000058085","ENSG00000058085","LAMC2","1",183186238,183245127,58889
"5054","ENSG00000185896","ENSG00000185896","LAMP1","13",113297239,113323672,26433
"5055","ENSG00000005893","ENSG00000005893","LAMP2","X",120426148,120469365,43217
"5056","ENSG00000078081","ENSG00000078081","LAMP3","3",183122215,183163839,41624
"5057","ENSG00000125869","ENSG00000125869","LAMP5","20",9514358,9530524,16166
"5058","ENSG00000116586","ENSG00000116586","LAMTOR2","1",156054782,156058506,3724
"5059","ENSG00000109270","ENSG00000109270","LAMTOR3","4",99878336,99894428,16092
"5060","ENSG00000134248","ENSG00000134248","LAMTOR5","1",110401249,110407942,6693
"5061","ENSG00000115365","ENSG00000115365","LANCL1","2",210427131,210477652,50521
"5062","ENSG00000132434","ENSG00000132434","LANCL2","7",55365337,55433737,68400
"5063","ENSG00000002549","ENSG00000002549","LAP3","4",17577198,17607972,30774
"5064","ENSG00000068697","ENSG00000068697","LAPTM4A","2",20032650,20051628,18978
"5065","ENSG00000104341","ENSG00000104341","LAPTM4B","8",97775057,97853013,77956
"5066","ENSG00000162511","ENSG00000162511","LAPTM5","1",30732469,30757774,25305
"5067","ENSG00000133424","ENSG00000133424","LARGE1","22",33162226,33922841,760615
"5068","ENSG00000155506","ENSG00000155506","LARP1","5",154682986,154817605,134619
"5069","ENSG00000161813","ENSG00000161813","LARP4","12",50392383,50480004,87621
"5070","ENSG00000107929","ENSG00000107929","LARP4B","10",806933,931821,124888
"5071","ENSG00000166173","ENSG00000166173","LARP6","15",70829130,70854157,25027
"5072","ENSG00000174720","ENSG00000174720","LARP7","4",112637077,112657696,20619
"5073","ENSG00000011376","ENSG00000011376","LARS2","3",45388561,45554726,166165
"5074","ENSG00000001497","ENSG00000001497","LAS1L","X",65438549,65534810,96261
"5075","ENSG00000002834","ENSG00000002834","LASP1","17",38869859,38921770,51911
"5076","ENSG00000213658","ENSG00000213658","LAT","16",28984826,28990784,5958
"5077","ENSG00000086730","ENSG00000086730","LAT2","7",74199652,74229834,30182
"5078","ENSG00000131023","ENSG00000131023","LATS1","6",149658153,149718105,59952
"5079","ENSG00000122188","ENSG00000122188","LAX1","1",203765177,203776372,11195
"5080","ENSG00000213626","ENSG00000213626","LBH","2",30231534,30323730,92196
"5081","ENSG00000162194","ENSG00000162194","LBHD1","11",62662817,62672267,9450
"5082","ENSG00000129988","ENSG00000129988","LBP","20",38346482,38377013,30531
"5083","ENSG00000143815","ENSG00000143815","LBR","1",225401502,225428925,27423
"5084","ENSG00000138136","ENSG00000138136","LBX1","10",101226994,101229463,2469
"5085","ENSG00000213398","ENSG00000213398","LCAT","16",67939750,67944131,4381
"5086","ENSG00000182866","ENSG00000182866","LCK","1",32251244,32286165,34921
"5087","ENSG00000205629","ENSG00000205629","LCMT1","16",25111731,25178231,66500
"5088","ENSG00000168806","ENSG00000168806","LCMT2","15",43323649,43330582,6933
"5089","ENSG00000148346","ENSG00000148346","LCN2","9",128149071,128153453,4382
"5090","ENSG00000196233","ENSG00000196233","LCOR","10",96832254,96995956,163702
"5091","ENSG00000136167","ENSG00000136167","LCP1","13",46125920,46211871,85951
"5092","ENSG00000043462","ENSG00000043462","LCP2","5",170246233,170297815,51582
"5093","ENSG00000115850","ENSG00000115850","LCT","2",135787850,135837184,49334
"5094","ENSG00000118961","ENSG00000118961","LDAH","2",20684014,20823130,139116
"5095","ENSG00000198728","ENSG00000198728","LDB1","10",102106489,102120368,13879
"5096","ENSG00000169744","ENSG00000169744","LDB2","4",16501541,16898678,397137
"5097","ENSG00000122367","ENSG00000122367","LDB3","10",86666785,86736072,69287
"5098","ENSG00000134333","ENSG00000134333","LDHA","11",18394560,18408425,13865
"5099","ENSG00000111716","ENSG00000111716","LDHB","12",21635342,21757857,122515
"5100","ENSG00000166796","ENSG00000166796","LDHC","11",18412318,18452063,39745
"5101","ENSG00000130164","ENSG00000130164","LDLR","19",11089418,11133820,44402
"5102","ENSG00000168675","ENSG00000168675","LDLRAD4","18",13217498,13652755,435257
"5103","ENSG00000157978","ENSG00000157978","LDLRAP1","1",25543606,25568886,25280
"5104","ENSG00000182195","ENSG00000182195","LDOC1","X",141111605,141177129,65524
"5105","ENSG00000145826","ENSG00000145826","LECT2","5",135922279,135954983,32704
"5106","ENSG00000138795","ENSG00000138795","LEF1","4",108047545,108168956,121411
"5107","ENSG00000243709","ENSG00000243709","LEFTY1","1",225886282,225911382,25100
"5108","ENSG00000143768","ENSG00000143768","LEFTY2","1",225936598,225941383,4785
"5109","ENSG00000174106","ENSG00000174106","LEMD3","12",65169583,65248355,78772
"5110","ENSG00000174697","ENSG00000174697","LEP","7",128241278,128257629,16351
"5111","ENSG00000116678","ENSG00000116678","LEPR","1",65420652,65641559,220907
"5112","ENSG00000213625","ENSG00000213625","LEPROT","1",65420587,65436007,15420
"5113","ENSG00000104660","ENSG00000104660","LEPROTL1","8",30095408,30177208,81800
"5114","ENSG00000168924","ENSG00000168924","LETM1","4",1811479,1856156,44677
"5115","ENSG00000050426","ENSG00000050426","LETMD1","12",51047962,51060424,12462
"5116","ENSG00000106003","ENSG00000106003","LFNG","7",2512529,2529177,16648
"5117","ENSG00000100097","ENSG00000100097","LGALS1","22",37675636,37679802,4166
"5118","ENSG00000006659","ENSG00000006659","LGALS14","19",39704481,39709444,4963
"5119","ENSG00000100079","ENSG00000100079","LGALS2","22",37570248,37582616,12368
"5120","ENSG00000131981","ENSG00000131981","LGALS3","14",55124110,55145423,21313
"5121","ENSG00000108679","ENSG00000108679","LGALS3BP","17",78971238,78979947,8709
"5122","ENSG00000171747","ENSG00000171747","LGALS4","19",38801671,38812945,11274
"5123","ENSG00000205076","ENSG00000205076","LGALS7","19",38770968,38773517,2549
"5124","ENSG00000178934","ENSG00000178934","LGALS7B","19",38789200,38791754,2554
"5125","ENSG00000116977","ENSG00000116977","LGALS8","1",236518000,236552981,34981
"5126","ENSG00000168961","ENSG00000168961","LGALS9","17",27629798,27649560,19762
"5127","ENSG00000119862","ENSG00000119862","LGALSL","2",64453969,64461381,7412
"5128","ENSG00000108231","ENSG00000108231","LGI1","10",93757840,93806272,48432
"5129","ENSG00000153012","ENSG00000153012","LGI2","4",24998847,25030946,32099
"5130","ENSG00000100600","ENSG00000100600","LGMN","14",92703807,92748679,44872
"5131","ENSG00000205213","ENSG00000205213","LGR4","11",27365961,27472790,106829
"5132","ENSG00000139292","ENSG00000139292","LGR5","12",71439798,71586310,146512
"5133","ENSG00000146166","ENSG00000146166","LGSN","6",63275951,63319983,44032
"5134","ENSG00000138039","ENSG00000138039","LHCGR","2",48686774,48755730,68956
"5135","ENSG00000145685","ENSG00000145685","LHFPL2","5",78485215,78770021,284806
"5136","ENSG00000107902","ENSG00000107902","LHPP","10",124461823,124617888,156065
"5137","ENSG00000274577","ENSG00000274577","LHX1","HSCHR17_7_CTG4",1173149,1180977,7828
"5138","ENSG00000106689","ENSG00000106689","LHX2","9",124001670,124033301,31631
"5139","ENSG00000106852","ENSG00000106852","LHX6","9",122202577,122229626,27049
"5140","ENSG00000121897","ENSG00000121897","LIAS","4",39459004,39485109,26105
"5141","ENSG00000128342","ENSG00000128342","LIF","22",30240453,30246759,6306
"5142","ENSG00000113594","ENSG00000113594","LIFR","5",38474668,38608354,133686
"5143","ENSG00000105486","ENSG00000105486","LIG1","19",48115445,48170603,55158
"5144","ENSG00000005156","ENSG00000005156","LIG3","17",34980512,35009743,29231
"5145","ENSG00000174405","ENSG00000174405","LIG4","13",108207439,108218368,10929
"5146","ENSG00000277398","ENSG00000277398","LILRA1","HSCHR19LRC_PGF1_CTG3_1",498460,507265,8805
"5147","ENSG00000278634","ENSG00000278634","LILRA2","HSCHR19LRC_PGF1_CTG3_1",477804,492444,14640
"5148","ENSG00000278046","ENSG00000278046","LILRA3","HSCHR19LRC_PGF2_CTG3_1",268785,281093,12308
"5149","ENSG00000277092","ENSG00000277092","LILRA4","HSCHR19_4_CTG3_1",315570,321535,5965
"5150","ENSG00000278355","ENSG00000278355","LILRA5","HSCHR19LRC_COX2_CTG3_1",288422,294485,6063
"5151","ENSG00000277751","ENSG00000277751","LILRB2","HSCHR19LRC_PGF1_CTG3_1",248805,253362,4557
"5152","ENSG00000277816","ENSG00000277816","LILRB3","HSCHR19LRC_COX1_CTG3_1",191474,197887,6413
"5153","ENSG00000278555","ENSG00000278555","LILRB4","HSCHR19LRC_COX1_CTG3_1",568518,576762,8244
"5154","ENSG00000278437","ENSG00000278437","LILRB5","HSCHR19_4_CTG3_1",225383,232281,6898
"5155","ENSG00000105370","ENSG00000105370","LIM2","19",51379909,51387974,8065
"5156","ENSG00000050405","ENSG00000050405","LIMA1","12",50175788,50283520,107732
"5157","ENSG00000064042","ENSG00000064042","LIMCH1","4",41359607,41700044,340437
"5158","ENSG00000144791","ENSG00000144791","LIMD1","3",45555394,45686341,130947
"5159","ENSG00000136490","ENSG00000136490","LIMD2","17",63695888,63701172,5284
"5160","ENSG00000203896","ENSG00000203896","LIME1","20",63736283,63739103,2820
"5161","ENSG00000106683","ENSG00000106683","LIMK1","7",74082933,74122525,39592
"5162","ENSG00000182541","ENSG00000182541","LIMK2","22",31212239,31280080,67841
"5163","ENSG00000169756","ENSG00000169756","LIMS1","2",108533671,108687246,153575
"5164","ENSG00000072163","ENSG00000072163","LIMS2","2",127638381,127681786,43405
"5165","ENSG00000131914","ENSG00000131914","LIN28A","1",26410817,26429728,18911
"5166","ENSG00000267796","ENSG00000267796","LIN37","19",35748361,35754519,6158
"5167","ENSG00000111052","ENSG00000111052","LIN7A","12",80792520,80937934,145414
"5168","ENSG00000104863","ENSG00000104863","LIN7B","19",49114324,49118460,4136
"5169","ENSG00000148943","ENSG00000148943","LIN7C","11",27494418,27506769,12351
"5170","ENSG00000140471","ENSG00000140471","LINS1","15",100559369,100603230,43861
"5171","ENSG00000107798","ENSG00000107798","LIPA","10",89213569,89414557,200988
"5172","ENSG00000166035","ENSG00000166035","LIPC","15",58410569,58569844,159275
"5173","ENSG00000079435","ENSG00000079435","LIPE","19",42401514,42427388,25874
"5174","ENSG00000101670","ENSG00000101670","LIPG","18",49560699,49599185,38486
"5175","ENSG00000144182","ENSG00000144182","LIPT1","2",99154955,99163157,8202
"5176","ENSG00000189067","ENSG00000189067","LITAF","16",11547722,11636381,88659
"5177","ENSG00000073350","ENSG00000073350","LLGL2","17",75525080,75575209,50129
"5178","ENSG00000139233","ENSG00000139233","LLPH","12",66116555,66130750,14195
"5179","ENSG00000074695","ENSG00000074695","LMAN1","18",59327823,59359265,31442
"5180","ENSG00000140506","ENSG00000140506","LMAN1L","15",74812716,74825757,13041
"5181","ENSG00000169223","ENSG00000169223","LMAN2","5",177315805,177351840,36035
"5182","ENSG00000114988","ENSG00000114988","LMAN2L","2",96705929,96740064,34135
"5183","ENSG00000139636","ENSG00000139636","LMBR1L","12",49097136,49110900,13764
"5184","ENSG00000168216","ENSG00000168216","LMBRD1","6",69672757,69867236,194479
"5185","ENSG00000071282","ENSG00000071282","LMCD1","3",8501807,8574668,72861
"5186","ENSG00000103227","ENSG00000103227","LMF1","16",853634,981318,127684
"5187","ENSG00000160789","ENSG00000160789","LMNA","1",156082572,156140081,57509
"5188","ENSG00000113368","ENSG00000113368","LMNB1","5",126776623,126837020,60397
"5189","ENSG00000176619","ENSG00000176619","LMNB2","19",2427638,2456959,29321
"5190","ENSG00000166407","ENSG00000166407","LMO1","11",8224309,8268716,44407
"5191","ENSG00000135363","ENSG00000135363","LMO2","11",33858576,33892076,33500
"5192","ENSG00000048540","ENSG00000048540","LMO3","12",16548372,16610594,62222
"5193","ENSG00000143013","ENSG00000143013","LMO4","1",87328880,87348923,20043
"5194","ENSG00000136153","ENSG00000136153","LMO7","13",75620434,75859870,239436
"5195","ENSG00000163431","ENSG00000163431","LMOD1","1",201896456,201946548,50092
"5196","ENSG00000164715","ENSG00000164715","LMTK2","7",98106862,98209638,102776
"5197","ENSG00000113441","ENSG00000113441","LNPEP","5",96935394,97037513,102119
"5198","ENSG00000196365","ENSG00000196365","LONP1","19",5691834,5720572,28738
"5199","ENSG00000102910","ENSG00000102910","LONP2","16",48244300,48363122,118822
"5200","ENSG00000154359","ENSG00000154359","LONRF1","8",12721906,12756073,34167
"5201","ENSG00000175556","ENSG00000175556","LONRF3","X",118974614,119018355,43741
"5202","ENSG00000113083","ENSG00000113083","LOX","5",122063195,122078413,15218
"5203","ENSG00000129038","ENSG00000129038","LOXL1","15",73925989,73952137,26148
"5204","ENSG00000134013","ENSG00000134013","LOXL2","8",23296897,23425328,128431
"5205","ENSG00000198670","ENSG00000198670","LPA","6",160531482,160664275,132793
"5206","ENSG00000198121","ENSG00000198121","LPAR1","9",110873263,111038470,165207
"5207","ENSG00000064547","ENSG00000064547","LPAR2","19",19623655,19628930,5275
"5208","ENSG00000171517","ENSG00000171517","LPAR3","1",84811602,84893206,81604
"5209","ENSG00000147145","ENSG00000147145","LPAR4","X",78747709,78758714,11005
"5210","ENSG00000139679","ENSG00000139679","LPAR6","13",48389567,48444704,55137
"5211","ENSG00000275079","ENSG00000275079","LPCAT1","HSCHR5_3_CTG1",8170,53293,45123
"5212","ENSG00000111684","ENSG00000111684","LPCAT3","12",6976185,7018477,42292
"5213","ENSG00000176454","ENSG00000176454","LPCAT4","15",34358633,34367196,8563
"5214","ENSG00000123684","ENSG00000123684","LPGAT1","1",211743457,211830763,87306
"5215","ENSG00000134324","ENSG00000134324","LPIN1","2",11677595,11827409,149814
"5216","ENSG00000101577","ENSG00000101577","LPIN2","18",2885296,3013144,127848
"5217","ENSG00000175445","ENSG00000175445","LPL","8",19901717,19967259,65542
"5218","ENSG00000167419","ENSG00000167419","LPO","17",58218548,58268518,49970
"5219","ENSG00000145012","ENSG00000145012","LPP","3",188153284,188890671,737387
"5220","ENSG00000110031","ENSG00000110031","LPXN","11",58526871,58578220,51349
"5221","ENSG00000121207","ENSG00000121207","LRAT","4",154626945,154753120,126175
"5222","ENSG00000198589","ENSG00000198589","LRBA","4",150264435,151015727,751292
"5223","ENSG00000136141","ENSG00000136141","LRCH1","13",46553168,46753040,199872
"5224","ENSG00000186001","ENSG00000186001","LRCH3","3",197791226,197888436,97210
"5225","ENSG00000077454","ENSG00000077454","LRCH4","7",100574011,100586129,12118
"5226","ENSG00000126243","ENSG00000126243","LRFN3","19",35935358,35946624,11266
"5227","ENSG00000173621","ENSG00000173621","LRFN4","11",66856647,66860475,3828
"5228","ENSG00000121931","ENSG00000121931","LRIF1","1",110947190,110963965,16775
"5229","ENSG00000144749","ENSG00000144749","LRIG1","3",66378797,66501263,122466
"5230","ENSG00000198799","ENSG00000198799","LRIG2","1",113073198,113132260,59062
"5231","ENSG00000123384","ENSG00000123384","LRP1","12",57128483,57213361,84878
"5232","ENSG00000197324","ENSG00000197324","LRP10","14",22871740,22881713,9973
"5233","ENSG00000147650","ENSG00000147650","LRP12","8",104489231,104589258,100027
"5234","ENSG00000168702","ENSG00000168702","LRP1B","2",140231423,142131016,1899593
"5235","ENSG00000081479","ENSG00000081479","LRP2","2",169127109,169362534,235425
"5236","ENSG00000109771","ENSG00000109771","LRP2BP","4",185363872,185395924,32052
"5237","ENSG00000130881","ENSG00000130881","LRP3","19",33177603,33208864,31261
"5238","ENSG00000162337","ENSG00000162337","LRP5","11",68312591,68449275,136684
"5239","ENSG00000281324","ENSG00000281324","LRP6","HG1362_PATCH",85023,236042,151019
"5240","ENSG00000157193","ENSG00000157193","LRP8","1",53242364,53328469,86105
"5241","ENSG00000163956","ENSG00000163956","LRPAP1","4",3503612,3532446,28834
"5242","ENSG00000138095","ENSG00000138095","LRPPRC","2",43886224,43996226,110002
"5243","ENSG00000137269","ENSG00000137269","LRRC1","6",53794497,53924125,129628
"5244","ENSG00000160959","ENSG00000160959","LRRC14","8",144517992,144525172,7180
"5245","ENSG00000172061","ENSG00000172061","LRRC15","3",194355249,194369743,14494
"5246","ENSG00000128606","ENSG00000128606","LRRC17","7",102913000,102945111,32111
"5247","ENSG00000184434","ENSG00000184434","LRRC19","9",26993136,27005672,12536
"5248","ENSG00000163827","ENSG00000163827","LRRC2","3",46515385,46606948,91563
"5249","ENSG00000172731","ENSG00000172731","LRRC20","10",70298970,70382650,83680
"5250","ENSG00000010626","ENSG00000010626","LRRC23","12",6873569,6914241,40672
"5251","ENSG00000160233","ENSG00000160233","LRRC3","21",44455510,44462196,6686
"5252","ENSG00000114248","ENSG00000114248","LRRC31","3",169839172,169869935,30763
"5253","ENSG00000137507","ENSG00000137507","LRRC32","11",76657524,76670747,13223
"5254","ENSG00000159708","ENSG00000159708","LRRC36","16",67326798,67385204,58406
"5255","ENSG00000278742","ENSG00000278742","LRRC37A","HSCHR17_1_CTG5",413625,459002,45377
"5256","ENSG00000277221","ENSG00000277221","LRRC37A2","HSCHR17_2_CTG5",1030000,1075355,45355
"5257","ENSG00000275621","ENSG00000275621","LRRC37A3","HSCHR17_1_CTG5",1496402,1541763,45361
"5258","ENSG00000066557","ENSG00000066557","LRRC40","1",70144805,70205579,60774
"5259","ENSG00000132128","ENSG00000132128","LRRC41","1",46261196,46303616,42420
"5260","ENSG00000116212","ENSG00000116212","LRRC42","1",53946077,53968168,22091
"5261","ENSG00000130764","ENSG00000130764","LRRC47","1",3778559,3796498,17939
"5262","ENSG00000137821","ENSG00000137821","LRRC49","15",70853239,71053658,200419
"5263","ENSG00000108829","ENSG00000108829","LRRC59","17",50375059,50397523,22464
"5264","ENSG00000127399","ENSG00000127399","LRRC61","7",150323263,150338156,14893
"5265","ENSG00000178026","ENSG00000178026","LRRC75B","22",24585620,24593208,7588
"5266","ENSG00000197147","ENSG00000197147","LRRC8B","1",89524829,89597861,73032
"5267","ENSG00000171492","ENSG00000171492","LRRC8D","1",89821014,89936611,115597
"5268","ENSG00000171017","ENSG00000171017","LRRC8E","19",7888505,7902021,13516
"5269","ENSG00000124831","ENSG00000124831","LRRFIP1","2",237627587,237813682,186095
"5270","ENSG00000093167","ENSG00000093167","LRRFIP2","3",37052626,37183689,131063
"5271","ENSG00000154237","ENSG00000154237","LRRK1","15",100919327,101078257,158930
"5272","ENSG00000170382","ENSG00000170382","LRRN2","1",204617170,204685738,68568
"5273","ENSG00000173114","ENSG00000173114","LRRN3","7",111091006,111125454,34448
"5274","ENSG00000146006","ENSG00000146006","LRRTM2","5",138868921,138875368,6447
"5275","ENSG00000176204","ENSG00000176204","LRRTM4","2",76747685,77593319,845634
"5276","ENSG00000144771","ENSG00000144771","LRTM1","3",54918231,54967088,48857
"5277","ENSG00000185565","ENSG00000185565","LSAMP","3",115802374,117139389,1337015
"5278","ENSG00000041802","ENSG00000041802","LSG1","3",194640791,194672463,31672
"5279","ENSG00000175324","ENSG00000175324","LSM1","8",38163335,38176730,13395
"5280","ENSG00000161654","ENSG00000161654","LSM12","17",44034328,44067619,33291
"5281","ENSG00000262860","ENSG00000262860","LSM14A","HSCHR19_1_CTG3_1",20188,77063,56875
"5282","ENSG00000149657","ENSG00000149657","LSM14B","20",62122461,62135374,12913
"5283","ENSG00000236826","ENSG00000236826","LSM2","HSCHR6_MHC_COX_CTG1",3274635,3284226,9591
"5284","ENSG00000170860","ENSG00000170860","LSM3","3",14178817,14201122,22305
"5285","ENSG00000130520","ENSG00000130520","LSM4","19",18306236,18323112,16876
"5286","ENSG00000106355","ENSG00000106355","LSM5","7",32485338,32495283,9945
"5287","ENSG00000164167","ENSG00000164167","LSM6","4",146175703,146200000,24297
"5288","ENSG00000130332","ENSG00000130332","LSM7","19",2321520,2328611,7091
"5289","ENSG00000128534","ENSG00000128534","LSM8","7",118184144,118204035,19891
"5290","ENSG00000130592","ENSG00000130592","LSP1","11",1850904,1892267,41363
"5291","ENSG00000105699","ENSG00000105699","LSR","19",35248330,35267964,19634
"5292","ENSG00000281289","ENSG00000281289","LSS","HSCHR21_5_CTG2",49511,80942,31431
"5293","ENSG00000235915","ENSG00000235915","LST1","HSCHR6_MHC_APD_CTG1",2918703,2921488,2785
"5294","ENSG00000238130","ENSG00000238130","LTA","HSCHR6_MHC_COX_CTG1",3049341,3051611,2270
"5295","ENSG00000111144","ENSG00000111144","LTA4H","12",96000753,96043520,42767
"5296","ENSG00000238114","ENSG00000238114","LTB","HSCHR6_MHC_SSTO_CTG1",2879835,2881802,1967
"5297","ENSG00000213903","ENSG00000213903","LTB4R","14",24311450,24318036,6586
"5298","ENSG00000213906","ENSG00000213906","LTB4R2","14",24305734,24312053,6319
"5299","ENSG00000049323","ENSG00000049323","LTBP1","2",32946953,33399509,452556
"5300","ENSG00000119681","ENSG00000119681","LTBP2","14",74498183,74612378,114195
"5301","ENSG00000168056","ENSG00000168056","LTBP3","11",65538559,65558930,20371
"5302","ENSG00000090006","ENSG00000090006","LTBP4","19",40592883,40629818,36935
"5303","ENSG00000111321","ENSG00000111321","LTBR","12",6375045,6391571,16526
"5304","ENSG00000213316","ENSG00000213316","LTC4S","5",179793980,179796647,2667
"5305","ENSG00000012223","ENSG00000012223","LTF","3",46435645,46485234,49589
"5306","ENSG00000198862","ENSG00000198862","LTN1","21",28928144,28992956,64812
"5307","ENSG00000007392","ENSG00000007392","LUC7L","16",188969,229463,40494
"5308","ENSG00000146963","ENSG00000146963","LUC7L2","7",139340359,139423457,83098
"5309","ENSG00000108848","ENSG00000108848","LUC7L3","17",50719565,50756219,36654
"5310","ENSG00000139329","ENSG00000139329","LUM","12",91102629,91111494,8865
"5311","ENSG00000079257","ENSG00000079257","LXN","3",158645822,158672648,26826
"5312","ENSG00000167656","ENSG00000167656","LY6D","8",142784882,142786539,1657
"5313","ENSG00000278032","ENSG00000278032","LY6E","HSCHR8_4_CTG7",8270,14120,5850
"5314","ENSG00000237495","ENSG00000237495","LY6G5C","HSCHR6_MHC_MCF_CTG1",3018556,3025912,7356
"5315","ENSG00000236183","ENSG00000236183","LY6G6C","HSCHR6_MHC_COX_CTG1",3195936,3199133,3197
"5316","ENSG00000244355","ENSG00000244355","LY6G6D","6",31715348,31717919,2571
"5317","ENSG00000274488","ENSG00000274488","LY6H","HSCHR8_4_CTG7",153499,156296,2797
"5318","ENSG00000054219","ENSG00000054219","LY75","2",159803355,159904756,101401
"5319","ENSG00000112799","ENSG00000112799","LY86","6",6588108,6654983,66875
"5320","ENSG00000122224","ENSG00000122224","LY9","1",160796074,160828261,32187
"5321","ENSG00000154589","ENSG00000154589","LY96","8",73991392,74029079,37687
"5322","ENSG00000104903","ENSG00000104903","LYL1","19",13099033,13103161,4128
"5323","ENSG00000254087","ENSG00000254087","LYN","8",55879835,56014169,134334
"5324","ENSG00000124466","ENSG00000124466","LYPD3","19",43460787,43465608,4821
"5325","ENSG00000120992","ENSG00000120992","LYPLA1","8",54046367,54102017,55650
"5326","ENSG00000011009","ENSG00000011009","LYPLA2","1",23791110,23795539,4429
"5327","ENSG00000102897","ENSG00000102897","LYRM1","16",20899868,20925006,25138
"5328","ENSG00000083099","ENSG00000083099","LYRM2","6",89568144,89638749,70605
"5329","ENSG00000214113","ENSG00000214113","LYRM4","6",5103629,5260950,157321
"5330","ENSG00000143669","ENSG00000143669","LYST","1",235661041,235883724,222683
"5331","ENSG00000133800","ENSG00000133800","LYVE1","11",10556966,10611689,54723
"5332","ENSG00000090382","ENSG00000090382","LYZ","12",69348381,69354234,5853
"5333","ENSG00000163818","ENSG00000163818","LZTFL1","3",45823316,45916042,92726
"5334","ENSG00000099949","ENSG00000099949","LZTR1","22",20982269,20999032,16763
"5335","ENSG00000061337","ENSG00000061337","LZTS1","8",20246165,20303963,57798
"5336","ENSG00000003056","ENSG00000003056","M6PR","12",8940361,8949761,9400
"5337","ENSG00000180660","ENSG00000180660","MAB21L1","13",35473419,35478764,5345
"5338","ENSG00000181541","ENSG00000181541","MAB21L2","4",150582151,150584693,2542
"5339","ENSG00000127603","ENSG00000127603","MACF1","1",39081316,39487177,405861
"5340","ENSG00000133315","ENSG00000133315","MACROD1","11",63998558,64166113,167555
"5341","ENSG00000002822","ENSG00000002822","MAD1L1","7",1815793,2233243,417450
"5342","ENSG00000164109","ENSG00000164109","MAD2L1","4",120055623,120066858,11235
"5343","ENSG00000124688","ENSG00000124688","MAD2L1BP","6",43629540,43640941,11401
"5344","ENSG00000099866","ENSG00000099866","MADCAM1","19",489176,505343,16167
"5345","ENSG00000110514","ENSG00000110514","MADD","11",47269161,47330031,60870
"5346","ENSG00000090316","ENSG00000090316","MAEA","4",1289887,1340147,50260
"5347","ENSG00000178573","ENSG00000178573","MAF","16",79585843,79600737,14894
"5348","ENSG00000204103","ENSG00000204103","MAFB","20",40685848,40689236,3388
"5349","ENSG00000185022","ENSG00000185022","MAFF","22",38200767,38216507,15740
"5350","ENSG00000197063","ENSG00000197063","MAFG","17",81918270,81927735,9465
"5351","ENSG00000105695","ENSG00000105695","MAG","19",35292125,35313807,21682
"5352","ENSG00000198681","ENSG00000198681","MAGEA1","X",153179284,153183880,4596
"5353","ENSG00000124260","ENSG00000124260","MAGEA10","X",152133310,152138578,5268
"5354","ENSG00000185247","ENSG00000185247","MAGEA11","X",149688228,149717268,29040
"5355","ENSG00000213401","ENSG00000213401","MAGEA12","X",152733757,152737669,3912
"5356","ENSG00000221867","ENSG00000221867","MAGEA3","X",152698767,152702347,3580
"5357","ENSG00000147381","ENSG00000147381","MAGEA4","X",151912495,151925171,12676
"5358","ENSG00000197172","ENSG00000197172","MAGEA6","X",152766136,152769716,3580
"5359","ENSG00000156009","ENSG00000156009","MAGEA8","X",149881141,149885835,4694
"5360","ENSG00000214107","ENSG00000214107","MAGEB1","X",30243715,30252040,8325
"5361","ENSG00000099399","ENSG00000099399","MAGEB2","X",30215563,30220089,4526
"5362","ENSG00000155495","ENSG00000155495","MAGEC1","X",141903894,141909374,5480
"5363","ENSG00000046774","ENSG00000046774","MAGEC2","X",142202342,142205290,2948
"5364","ENSG00000179222","ENSG00000179222","MAGED1","X",51803007,51902354,99347
"5365","ENSG00000102316","ENSG00000102316","MAGED2","X",54807599,54816015,8416
"5366","ENSG00000187243","ENSG00000187243","MAGED4B","X",52061827,52069219,7392
"5367","ENSG00000177383","ENSG00000177383","MAGEF1","3",184710364,184712064,1700
"5368","ENSG00000187601","ENSG00000187601","MAGEH1","X",55452127,55453566,1439
"5369","ENSG00000254585","ENSG00000254585","MAGEL2","15",23643549,23647867,4318
"5370","ENSG00000151276","ENSG00000151276","MAGI1","3",65353525,66038918,685393
"5371","ENSG00000187391","ENSG00000187391","MAGI2","7",78017055,79453667,1436612
"5372","ENSG00000269313","ENSG00000269313","MAGIX","X",49162564,49168774,6210
"5373","ENSG00000162385","ENSG00000162385","MAGOH","1",53226900,53238518,11618
"5374","ENSG00000111196","ENSG00000111196","MAGOHB","12",10604193,10613609,9416
"5375","ENSG00000102158","ENSG00000102158","MAGT1","X",77825747,77899271,73524
"5376","ENSG00000111837","ENSG00000111837","MAK","6",10762723,10838553,75830
"5377","ENSG00000198042","ENSG00000198042","MAK16","8",33485182,33501262,16080
"5378","ENSG00000172005","ENSG00000172005","MAL","2",95025677,95053992,28315
"5379","ENSG00000144063","ENSG00000144063","MALL","2",110083870,110116022,32152
"5380","ENSG00000172175","ENSG00000172175","MALT1","18",58671465,58754477,83012
"5381","ENSG00000161021","ENSG00000161021","MAML1","5",179732822,179777283,44461
"5382","ENSG00000196782","ENSG00000196782","MAML3","4",139716753,140154184,437431
"5383","ENSG00000013619","ENSG00000013619","MAMLD1","X",150361422,150514178,152756
"5384","ENSG00000111885","ENSG00000111885","MAN1A1","6",119177205,119349761,172556
"5385","ENSG00000198162","ENSG00000198162","MAN1A2","1",117367449,117528872,161423
"5386","ENSG00000177239","ENSG00000177239","MAN1B1","9",137086857,137109189,22332
"5387","ENSG00000117643","ENSG00000117643","MAN1C1","1",25616791,25784450,167659
"5388","ENSG00000112893","ENSG00000112893","MAN2A1","5",109689927,109869625,179698
"5389","ENSG00000196547","ENSG00000196547","MAN2A2","15",90902218,90922584,20366
"5390","ENSG00000104774","ENSG00000104774","MAN2B1","19",12646511,12666742,20231
"5391","ENSG00000013288","ENSG00000013288","MAN2B2","4",6575189,6623362,48173
"5392","ENSG00000140400","ENSG00000140400","MAN2C1","15",75355207,75368612,13405
"5393","ENSG00000109323","ENSG00000109323","MANBA","4",102630770,102760994,130224
"5394","ENSG00000172469","ENSG00000172469","MANEA","6",95577485,95609470,31985
"5395","ENSG00000145050","ENSG00000145050","MANF","3",51385291,51389397,4106
"5396","ENSG00000281818","ENSG00000281818","MANSC1","HG1362_PATCH",295054,319240,24186
"5397","ENSG00000189221","ENSG00000189221","MAOA","X",43654907,43746817,91910
"5398","ENSG00000069535","ENSG00000069535","MAOB","X",43766610,43882450,115840
"5399","ENSG00000166963","ENSG00000166963","MAP1A","15",43510958,43531620,20662
"5400","ENSG00000131711","ENSG00000131711","MAP1B","5",72107234,72209565,102331
"5401","ENSG00000140941","ENSG00000140941","MAP1LC3B","16",87383953,87404779,20826
"5402","ENSG00000197769","ENSG00000197769","MAP1LC3C","1",241995490,241999098,3608
"5403","ENSG00000130479","ENSG00000130479","MAP1S","19",17719242,17734513,15271
"5404","ENSG00000078018","ENSG00000078018","MAP2","2",209424047,209734147,310100
"5405","ENSG00000169032","ENSG00000169032","MAP2K1","15",66386837,66491656,104819
"5406","ENSG00000126934","ENSG00000126934","MAP2K2","19",4090321,4124122,33801
"5407","ENSG00000034152","ENSG00000034152","MAP2K3","17",21284672,21315232,30560
"5408","ENSG00000065559","ENSG00000065559","MAP2K4","17",12020829,12143830,123001
"5409","ENSG00000137764","ENSG00000137764","MAP2K5","15",67542703,67807117,264414
"5410","ENSG00000108984","ENSG00000108984","MAP2K6","17",69414697,69553865,139168
"5411","ENSG00000095015","ENSG00000095015","MAP3K1","5",56815549,56896152,80603
"5412","ENSG00000130758","ENSG00000130758","MAP3K10","19",40191426,40215575,24149
"5413","ENSG00000173327","ENSG00000173327","MAP3K11","11",65597756,65615382,17626
"5414","ENSG00000139625","ENSG00000139625","MAP3K12","12",53479669,53500063,20394
"5415","ENSG00000073803","ENSG00000073803","MAP3K13","3",185282941,185489094,206153
"5416","ENSG00000006062","ENSG00000006062","MAP3K14","17",45263119,45317029,53910
"5417","ENSG00000176601","ENSG00000176601","MAP3K19","2",134964485,135047468,82983
"5418","ENSG00000169967","ENSG00000169967","MAP3K2","2",127298668,127388465,89797
"5419","ENSG00000198909","ENSG00000198909","MAP3K3","17",63622415,63696305,73890
"5420","ENSG00000085511","ENSG00000085511","MAP3K4","6",160991727,161117385,125658
"5421","ENSG00000197442","ENSG00000197442","MAP3K5","6",136557046,136793097,236051
"5422","ENSG00000142733","ENSG00000142733","MAP3K6","1",27355184,27366961,11777
"5423","ENSG00000135341","ENSG00000135341","MAP3K7","6",90513573,90587086,73513
"5424","ENSG00000156265","ENSG00000156265","MAP3K7CL","21",29077221,29175889,98668
"5425","ENSG00000107968","ENSG00000107968","MAP3K8","10",30434021,30461833,27812
"5426","ENSG00000006432","ENSG00000006432","MAP3K9","14",70722526,70809534,87008
"5427","ENSG00000047849","ENSG00000047849","MAP4","3",47850690,48089272,238582
"5428","ENSG00000104814","ENSG00000104814","MAP4K1","19",38587641,38618882,31241
"5429","ENSG00000168067","ENSG00000168067","MAP4K2","11",64784918,64803241,18323
"5430","ENSG00000011566","ENSG00000011566","MAP4K3","2",39249266,39437301,188035
"5431","ENSG00000071054","ENSG00000071054","MAP4K4","2",101696850,101894690,197840
"5432","ENSG00000012983","ENSG00000012983","MAP4K5","14",50418501,50561126,142625
"5433","ENSG00000180834","ENSG00000180834","MAP6D1","3",183815922,183825594,9672
"5434","ENSG00000135525","ENSG00000135525","MAP7","6",136342281,136550819,208538
"5435","ENSG00000116871","ENSG00000116871","MAP7D1","1",36155579,36180849,25270
"5436","ENSG00000129680","ENSG00000129680","MAP7D3","X",136213220,136256482,43262
"5437","ENSG00000164114","ENSG00000164114","MAP9","4",155342658,155376970,34312
"5438","ENSG00000100030","ENSG00000100030","MAPK1","22",21759657,21867680,108023
"5439","ENSG00000109339","ENSG00000109339","MAPK10","4",85990007,86594625,604618
"5440","ENSG00000185386","ENSG00000185386","MAPK11","22",50263713,50270767,7054
"5441","ENSG00000188130","ENSG00000188130","MAPK12","22",50245450,50261716,16266
"5442","ENSG00000156711","ENSG00000156711","MAPK13","6",36127809,36144524,16715
"5443","ENSG00000112062","ENSG00000112062","MAPK14","6",36027782,36111236,83454
"5444","ENSG00000168175","ENSG00000168175","MAPK1IP1L","14",55051647,55070194,18547
"5445","ENSG00000102882","ENSG00000102882","MAPK3","16",30114105,30123506,9401
"5446","ENSG00000141639","ENSG00000141639","MAPK4","18",50560087,50731826,171739
"5447","ENSG00000069956","ENSG00000069956","MAPK6","15",51952106,52067375,115269
"5448","ENSG00000166484","ENSG00000166484","MAPK7","17",19377721,19383544,5823
"5449","ENSG00000107643","ENSG00000107643","MAPK8","10",48306639,48439360,132721
"5450","ENSG00000121653","ENSG00000121653","MAPK8IP1","11",45885651,45906465,20814
"5451","ENSG00000008735","ENSG00000008735","MAPK8IP2","22",50600793,50613981,13188
"5452","ENSG00000138834","ENSG00000138834","MAPK8IP3","16",1706166,1770351,64185
"5453","ENSG00000050748","ENSG00000050748","MAPK9","5",180233143,180292099,58956
"5454","ENSG00000119487","ENSG00000119487","MAPKAP1","9",125437393,125707234,269841
"5455","ENSG00000162889","ENSG00000162889","MAPKAPK2","1",206684905,206734281,49376
"5456","ENSG00000114738","ENSG00000114738","MAPKAPK3","3",50611520,50649291,37771
"5457","ENSG00000089022","ENSG00000089022","MAPKAPK5","12",111842013,111902222,60209
"5458","ENSG00000137802","ENSG00000137802","MAPKBP1","15",41774434,41827855,53421
"5459","ENSG00000101367","ENSG00000101367","MAPRE1","20",32819954,32850405,30451
"5460","ENSG00000166974","ENSG00000166974","MAPRE2","18",34976928,35143470,166542
"5461","ENSG00000084764","ENSG00000084764","MAPRE3","2",26970637,27027219,56582
"5462","ENSG00000276155","ENSG00000276155","MAPT","HSCHR17_1_CTG5",760287,893653,133366
"5463","ENSG00000277443","ENSG00000277443","MARCKS","6",113857345,113863475,6130
"5464","ENSG00000175130","ENSG00000175130","MARCKSL1","1",32333839,32336233,2394
"5465","ENSG00000019169","ENSG00000019169","MARCO","2",118942194,118994660,52466
"5466","ENSG00000116141","ENSG00000116141","MARK1","1",220528136,220664461,136325
"5467","ENSG00000072518","ENSG00000072518","MARK2","11",63838928,63911020,72092
"5468","ENSG00000075413","ENSG00000075413","MARK3","14",103385377,103503831,118454
"5469","ENSG00000007047","ENSG00000007047","MARK4","19",45079288,45305284,225996
"5470","ENSG00000130368","ENSG00000130368","MAS1","6",159890988,159917447,26459
"5471","ENSG00000127241","ENSG00000127241","MASP1","3",187217282,187291980,74698
"5472","ENSG00000009724","ENSG00000009724","MASP2","1",11022009,11047239,25230
"5473","ENSG00000105613","ENSG00000105613","MAST1","19",12833951,12874952,41001
"5474","ENSG00000086015","ENSG00000086015","MAST2","1",45786987,46036122,249135
"5475","ENSG00000099308","ENSG00000099308","MAST3","19",18097778,18151692,53914
"5476","ENSG00000069020","ENSG00000069020","MAST4","5",66596380,67169593,573213
"5477","ENSG00000151224","ENSG00000151224","MAT1A","10",80271820,80289658,17838
"5478","ENSG00000168906","ENSG00000168906","MAT2A","2",85539168,85545281,6113
"5479","ENSG00000038274","ENSG00000038274","MAT2B","5",163503114,163519558,16444
"5480","ENSG00000007264","ENSG00000007264","MATK","19",3777970,3802129,24159
"5481","ENSG00000162510","ENSG00000162510","MATN1","1",30711277,30723585,12308
"5482","ENSG00000132561","ENSG00000132561","MATN2","8",97868840,98036724,167884
"5483","ENSG00000132031","ENSG00000132031","MATN3","2",19992052,20012668,20616
"5484","ENSG00000015479","ENSG00000015479","MATR3","5",139293674,139331677,38003
"5485","ENSG00000129933","ENSG00000129933","MAU2","19",19320829,19358754,37925
"5486","ENSG00000088888","ENSG00000088888","MAVS","20",3846799,3876123,29324
"5487","ENSG00000125952","ENSG00000125952","MAX","14",65006174,65102695,96521
"5488","ENSG00000103495","ENSG00000103495","MAZ","16",29806106,29811164,5058
"5489","ENSG00000198125","ENSG00000198125","MB","22",35606764,35637951,31187
"5490","ENSG00000141644","ENSG00000141644","MBD1","18",50266882,50281774,14892
"5491","ENSG00000134046","ENSG00000134046","MBD2","18",54151606,54224669,73063
"5492","ENSG00000071655","ENSG00000071655","MBD3","19",1573596,1592865,19269
"5493","ENSG00000129071","ENSG00000129071","MBD4","3",129430947,129440179,9232
"5494","ENSG00000204406","ENSG00000204406","MBD5","2",148021011,148516971,495960
"5495","ENSG00000151332","ENSG00000151332","MBIP","14",36298564,36320637,22073
"5496","ENSG00000165471","ENSG00000165471","MBL2","10",52765380,52772784,7404
"5497","ENSG00000152601","ENSG00000152601","MBNL1","3",152243828,152465780,221952
"5498","ENSG00000139793","ENSG00000139793","MBNL2","13",97221434,97394120,172686
"5499","ENSG00000076770","ENSG00000076770","MBNL3","X",132369320,132489968,120648
"5500","ENSG00000143797","ENSG00000143797","MBOAT2","2",8852690,9003709,151019
"5501","ENSG00000278519","ENSG00000278519","MBOAT7","HSCHR19LRC_LRC_I_CTG3_1",148221,164847,16626
"5502","ENSG00000197971","ENSG00000197971","MBP","18",76978827,77133683,154856
"5503","ENSG00000140943","ENSG00000140943","MBTPS1","16",84053761,84116942,63181
"5504","ENSG00000012174","ENSG00000012174","MBTPS2","X",21839617,21885423,45806
"5505","ENSG00000258839","ENSG00000258839","MC1R","16",89912119,89920973,8854
"5506","ENSG00000185231","ENSG00000185231","MC2R","18",13882044,13915707,33663
"5507","ENSG00000166603","ENSG00000166603","MC4R","18",60371062,60372775,1713
"5508","ENSG00000176136","ENSG00000176136","MC5R","18",13824149,13827323,3174
"5509","ENSG00000076706","ENSG00000076706","MCAM","11",119308529,119321521,12992
"5510","ENSG00000100294","ENSG00000100294","MCAT","22",43132209,43143398,11189
"5511","ENSG00000171444","ENSG00000171444","MCC","5",113022106,113488823,466717
"5512","ENSG00000078070","ENSG00000078070","MCCC1","3",183015218,183116075,100857
"5513","ENSG00000131844","ENSG00000131844","MCCC2","5",71579531,71658706,79175
"5514","ENSG00000101977","ENSG00000101977","MCF2","X",139581770,139708216,126446
"5515","ENSG00000126217","ENSG00000126217","MCF2L","13",112894378,113099742,205364
"5516","ENSG00000053524","ENSG00000053524","MCF2L2","3",183178041,183428778,250737
"5517","ENSG00000180398","ENSG00000180398","MCFD2","2",46901870,46941855,39985
"5518","ENSG00000128285","ENSG00000128285","MCHR1","22",40679273,40682812,3539
"5519","ENSG00000143384","ENSG00000143384","MCL1","1",150560895,150579738,18843
"5520","ENSG00000065328","ENSG00000065328","MCM10","10",13161558,13211110,49552
"5521","ENSG00000073111","ENSG00000073111","MCM2","3",127598223,127622436,24213
"5522","ENSG00000112118","ENSG00000112118","MCM3","6",52264014,52284881,20867
"5523","ENSG00000160294","ENSG00000160294","MCM3AP","21",46235133,46286297,51164
"5524","ENSG00000104738","ENSG00000104738","MCM4","8",47960185,47978160,17975
"5525","ENSG00000100297","ENSG00000100297","MCM5","22",35400134,35425431,25297
"5526","ENSG00000076003","ENSG00000076003","MCM6","2",135839626,135876443,36817
"5527","ENSG00000166508","ENSG00000166508","MCM7","7",100092233,100101940,9707
"5528","ENSG00000111877","ENSG00000111877","MCM9","6",118813442,118935162,121720
"5529","ENSG00000197771","ENSG00000197771","MCMBP","10",119829404,119892556,63152
"5530","ENSG00000090674","ENSG00000090674","MCOLN1","19",7522624,7534009,11385
"5531","ENSG00000055732","ENSG00000055732","MCOLN3","1",85018082,85048500,30418
"5532","ENSG00000147316","ENSG00000147316","MCPH1","8",6406592,6648508,241916
"5533","ENSG00000187778","ENSG00000187778","MCRS1","12",49556544,49568145,11601
"5534","ENSG00000175471","ENSG00000175471","MCTP1","5",94703690,95285094,581404
"5535","ENSG00000140563","ENSG00000140563","MCTP2","15",94231538,94483952,252414
"5536","ENSG00000232119","ENSG00000232119","MCTS1","X",120594010,120621159,27149
"5537","ENSG00000050393","ENSG00000050393","MCUR1","6",13786557,13814568,28011
"5538","ENSG00000237095","ENSG00000237095","MDC1","HSCHR6_MHC_MCF_CTG1",2043883,2061964,18081
"5539","ENSG00000112559","ENSG00000112559","MDFI","6",41636882,41654244,17362
"5540","ENSG00000135272","ENSG00000135272","MDFIC","7",114922094,115019917,97823
"5541","ENSG00000014641","ENSG00000014641","MDH1","2",63588609,63607197,18588
"5542","ENSG00000146701","ENSG00000146701","MDH2","7",76048051,76067508,19457
"5543","ENSG00000110492","ENSG00000110492","MDK","11",46380756,46383837,3081
"5544","ENSG00000111554","ENSG00000111554","MDM1","12",68272443,68332381,59938
"5545","ENSG00000135679","ENSG00000135679","MDM2","12",68808177,68845544,37367
"5546","ENSG00000198625","ENSG00000198625","MDM4","1",204516379,204558120,41741
"5547","ENSG00000112159","ENSG00000112159","MDN1","6",89642498,89819794,177296
"5548","ENSG00000065833","ENSG00000065833","ME1","6",83210402,83431051,220649
"5549","ENSG00000082212","ENSG00000082212","ME2","18",50879080,50954257,75177
"5550","ENSG00000151376","ENSG00000151376","ME3","11",86441108,86672636,231528
"5551","ENSG00000124733","ENSG00000124733","MEA1","6",43011143,43016868,5725
"5552","ENSG00000163875","ENSG00000163875","MEAF6","1",37489993,37514766,24773
"5553","ENSG00000085276","ENSG00000085276","MECOM","3",169083499,169663775,580276
"5554","ENSG00000169057","ENSG00000169057","MECP2","X",154021573,154137103,115530
"5555","ENSG00000116353","ENSG00000116353","MECR","1",29192657,29230942,38285
"5556","ENSG00000125686","ENSG00000125686","MED1","17",39404285,39451272,46987
"5557","ENSG00000184634","ENSG00000184634","MED12","X",71118543,71144103,25560
"5558","ENSG00000108510","ENSG00000108510","MED13","17",61942605,62065278,122673
"5559","ENSG00000123066","ENSG00000123066","MED13L","12",115957905,116277693,319788
"5560","ENSG00000180182","ENSG00000180182","MED14","X",40648305,40735858,87553
"5561","ENSG00000099917","ENSG00000099917","MED15","22",20495913,20587632,91719
"5562","ENSG00000282092","ENSG00000282092","MED16","HSCHR19_5_CTG2",46856,60469,13613
"5563","ENSG00000042429","ENSG00000042429","MED17","11",93784227,93814963,30736
"5564","ENSG00000130772","ENSG00000130772","MED18","1",28329002,28335965,6963
"5565","ENSG00000124641","ENSG00000124641","MED20","6",41905354,41921139,15785
"5566","ENSG00000152944","ENSG00000152944","MED21","12",27022546,27066343,43797
"5567","ENSG00000148297","ENSG00000148297","MED22","9",133338312,133348131,9819
"5568","ENSG00000112282","ENSG00000112282","MED23","6",131573966,131628242,54276
"5569","ENSG00000008838","ENSG00000008838","MED24","17",40019097,40061215,42118
"5570","ENSG00000104973","ENSG00000104973","MED25","19",49818282,49840383,22101
"5571","ENSG00000160563","ENSG00000160563","MED27","9",131852928,132079867,226939
"5572","ENSG00000118579","ENSG00000118579","MED28","4",17614641,17634105,19464
"5573","ENSG00000108590","ENSG00000108590","MED31","17",6643311,6651634,8323
"5574","ENSG00000136146","ENSG00000136146","MED4","13",48053323,48095131,41808
"5575","ENSG00000133997","ENSG00000133997","MED6","14",70581257,70600690,19433
"5576","ENSG00000155868","ENSG00000155868","MED7","5",157137424,157159019,21595
"5577","ENSG00000159479","ENSG00000159479","MED8","1",43383917,43389808,5891
"5578","ENSG00000141026","ENSG00000141026","MED9","17",17476994,17493221,16227
"5579","ENSG00000068305","ENSG00000068305","MEF2A","15",99565417,99716488,151071
"5580","ENSG00000213999","ENSG00000213999","MEF2B","19",19145567,19192131,46564
"5581","ENSG00000081189","ENSG00000081189","MEF2C","5",88717117,88904257,187140
"5582","ENSG00000116604","ENSG00000116604","MEF2D","1",156463727,156500779,37052
"5583","ENSG00000103313","ENSG00000103313","MEFV","16",3242027,3256633,14606
"5584","ENSG00000162591","ENSG00000162591","MEGF6","1",3487951,3611508,123557
"5585","ENSG00000105429","ENSG00000105429","MEGF8","19",42325609,42378769,53160
"5586","ENSG00000106780","ENSG00000106780","MEGF9","9",120600811,120714470,113659
"5587","ENSG00000143995","ENSG00000143995","MEIS1","2",66433452,66573869,140417
"5588","ENSG00000134138","ENSG00000134138","MEIS2","15",36889204,37101299,212095
"5589","ENSG00000165304","ENSG00000165304","MELK","9",36572862,36677683,104821
"5590","ENSG00000163975","ENSG00000163975","MELTF","3",196980590,197029835,49245
"5591","ENSG00000162959","ENSG00000162959","MEMO1","2",31865060,32011230,146170
"5592","ENSG00000133895","ENSG00000133895","MEN1","11",64803510,64811294,7784
"5593","ENSG00000005102","ENSG00000005102","MEOX1","17",43640389,43661922,21533
"5594","ENSG00000106511","ENSG00000106511","MEOX2","7",15611212,15686683,75471
"5595","ENSG00000112818","ENSG00000112818","MEP1A","6",46793389,46839778,46389
"5596","ENSG00000141434","ENSG00000141434","MEP1B","18",32185069,32220404,35335
"5597","ENSG00000146834","ENSG00000146834","MEPCE","7",100428322,100434126,5804
"5598","ENSG00000152595","ENSG00000152595","MEPE","4",87821398,87846814,25416
"5599","ENSG00000153208","ENSG00000153208","MERTK","2",111898607,112029561,130954
"5600","ENSG00000106484","ENSG00000106484","MEST","7",130486171,130506465,20294
"5601","ENSG00000105976","ENSG00000105976","MET","7",116672196,116798377,126181
"5602","ENSG00000164024","ENSG00000164024","METAP1","4",98995659,99062809,67150
"5603","ENSG00000111142","ENSG00000111142","METAP2","12",95473520,95515839,42319
"5604","ENSG00000103260","ENSG00000103260","METRN","16",715118,719655,4537
"5605","ENSG00000037897","ENSG00000037897","METTL1","12",57768471,57772119,3648
"5606","ENSG00000010165","ENSG00000010165","METTL13","1",171781660,171814023,32363
"5607","ENSG00000127804","ENSG00000127804","METTL16","17",2405562,2511891,106329
"5608","ENSG00000165792","ENSG00000165792","METTL17","14",20989973,20997035,7062
"5609","ENSG00000171806","ENSG00000171806","METTL18","1",169792529,169794963,2434
"5610","ENSG00000067365","ENSG00000067365","METTL22","16",8621683,8649654,27971
"5611","ENSG00000087995","ENSG00000087995","METTL2A","17",62423875,62453385,29510
"5612","ENSG00000165055","ENSG00000165055","METTL2B","7",128476729,128506602,29873
"5613","ENSG00000165819","ENSG00000165819","METTL3","14",21498133,21511342,13209
"5614","ENSG00000101574","ENSG00000101574","METTL4","18",2537525,2571509,33984
"5615","ENSG00000138382","ENSG00000138382","METTL5","2",169810081,169824931,14850
"5616","ENSG00000123600","ENSG00000123600","METTL8","2",171315746,171434802,119056
"5617","ENSG00000197006","ENSG00000197006","METTL9","16",21597218,21657471,60253
"5618","ENSG00000176624","ENSG00000176624","MEX3C","18",51174550,51218333,43783
"5619","ENSG00000140259","ENSG00000140259","MFAP1","15",43804492,43824690,20198
"5620","ENSG00000117122","ENSG00000117122","MFAP2","1",16974502,16980632,6130
"5621","ENSG00000037749","ENSG00000037749","MFAP3","5",154038959,154220478,181519
"5622","ENSG00000198948","ENSG00000198948","MFAP3L","4",169986597,170033031,46434
"5623","ENSG00000166482","ENSG00000166482","MFAP4","17",19383442,19387190,3748
"5624","ENSG00000197614","ENSG00000197614","MFAP5","12",8637346,8662888,25542
"5625","ENSG00000168958","ENSG00000168958","MFF","2",227325151,227357833,32682
"5626","ENSG00000140545","ENSG00000140545","MFGE8","15",88898683,88913468,14785
"5627","ENSG00000147324","ENSG00000147324","MFHAS1","8",8783354,8893630,110276
"5628","ENSG00000171109","ENSG00000171109","MFN1","3",179347709,179394936,47227
"5629","ENSG00000116688","ENSG00000116688","MFN2","1",11980181,12015211,35030
"5630","ENSG00000100060","ENSG00000100060","MFNG","22",37469063,37486393,17330
"5631","ENSG00000118855","ENSG00000118855","MFSD1","3",158732198,158829719,97521
"5632","ENSG00000109736","ENSG00000109736","MFSD10","4",2930561,2934834,4273
"5633","ENSG00000092931","ENSG00000092931","MFSD11","17",76735865,76781449,45584
"5634","ENSG00000161091","ENSG00000161091","MFSD12","19",3538261,3574290,36029
"5635","ENSG00000138111","ENSG00000138111","MFSD13A","10",102461395,102477045,15650
"5636","ENSG00000182544","ENSG00000182544","MFSD5","12",53251251,53254406,3155
"5637","ENSG00000151690","ENSG00000151690","MFSD6","2",190408355,190509205,100850
"5638","ENSG00000135953","ENSG00000135953","MFSD9","2",102714630,102736888,22258
"5639","ENSG00000174197","ENSG00000174197","MGA","15",41621134,41773081,151947
"5640","ENSG00000282607","ENSG00000282607","MGAM","HSCHR7_2_CTG6",404,68627,68223
"5641","ENSG00000131446","ENSG00000131446","MGAT1","5",180784780,180815652,30872
"5642","ENSG00000168282","ENSG00000168282","MGAT2","14",49620799,49623481,2682
"5643","ENSG00000071073","ENSG00000071073","MGAT4A","2",98619106,98731132,112026
"5644","ENSG00000161013","ENSG00000161013","MGAT4B","5",179797597,179806952,9355
"5645","ENSG00000152127","ENSG00000152127","MGAT5","2",134119983,134454621,334638
"5646","ENSG00000074416","ENSG00000074416","MGLL","3",127689062,128052190,363128
"5647","ENSG00000170430","ENSG00000170430","MGMT","10",129467190,129770983,303793
"5648","ENSG00000111341","ENSG00000111341","MGP","12",14880864,14885857,4993
"5649","ENSG00000102858","ENSG00000102858","MGRN1","16",4616493,4690974,74481
"5650","ENSG00000085871","ENSG00000085871","MGST2","4",139665768,139740745,74977
"5651","ENSG00000143198","ENSG00000143198","MGST3","1",165631213,165661796,30583
"5652","ENSG00000261857","ENSG00000261857","MIA","19",40771648,40777490,5842
"5653","ENSG00000150527","ENSG00000150527","MIA2","14",39230231,39388513,158282
"5654","ENSG00000235233","ENSG00000235233","MICA","HSCHR6_MHC_MANN_CTG1",2708377,2724826,16449
"5655","ENSG00000135596","ENSG00000135596","MICAL1","6",109444062,109465968,21906
"5656","ENSG00000133816","ENSG00000133816","MICAL2","11",12094008,12359144,265136
"5657","ENSG00000243156","ENSG00000243156","MICAL3","22",17787649,18024561,236912
"5658","ENSG00000100139","ENSG00000100139","MICALL1","22",37905657,37942822,37165
"5659","ENSG00000164877","ENSG00000164877","MICALL2","7",1428465,1459470,31005
"5660","ENSG00000238289","ENSG00000238289","MICB","HSCHR6_MHC_MCF_CTG1",2840040,2853071,13031
"5661","ENSG00000107745","ENSG00000107745","MICU1","10",72367340,72626131,258791
"5662","ENSG00000165487","ENSG00000165487","MICU2","13",21492691,21604181,111490
"5663","ENSG00000101871","ENSG00000101871","MID1","X",10445310,10833654,388344
"5664","ENSG00000165175","ENSG00000165175","MID1IP1","X",38801440,38806537,5097
"5665","ENSG00000080561","ENSG00000080561","MID2","X",107825755,107931637,105882
"5666","ENSG00000100335","ENSG00000100335","MIEF1","22",39499432,39518132,18700
"5667","ENSG00000276701","ENSG00000276701","MIF","HSCHR22_1_CTG7",130366,131589,1223
"5668","ENSG00000116691","ENSG00000116691","MIIP","1",12019466,12032045,12579
"5669","ENSG00000141503","ENSG00000141503","MINK1","17",4833340,4898061,64721
"5670","ENSG00000107789","ENSG00000107789","MINPP1","10",87504875,87553461,48586
"5671","ENSG00000164654","ENSG00000164654","MIOS","7",7566875,7608932,42057
"5672","ENSG00000135517","ENSG00000135517","MIP","12",56449502,56469166,19664
"5673","ENSG00000027001","ENSG00000027001","MIPEP","13",23730189,23889400,159211
"5674","ENSG00000167842","ENSG00000167842","MIS12","17",5486285,5490814,4529
"5675","ENSG00000159055","ENSG00000159055","MIS18A","21",32268228,32279049,10821
"5676","ENSG00000129534","ENSG00000129534","MIS18BP1","14",45203190,45253540,50350
"5677","ENSG00000187098","ENSG00000187098","MITF","3",69739456,69968336,228880
"5678","ENSG00000148773","ENSG00000148773","MKI67","10",128096659,128126423,29764
"5679","ENSG00000125863","ENSG00000125863","MKKS","20",10401009,10434222,33213
"5680","ENSG00000128585","ENSG00000128585","MKLN1","7",131110096,131496632,386536
"5681","ENSG00000079277","ENSG00000079277","MKNK1","1",46557407,46616843,59436
"5682","ENSG00000099875","ENSG00000099875","MKNK2","19",2037465,2051244,13779
"5683","ENSG00000133606","ENSG00000133606","MKRN1","7",140453033,140479536,26503
"5684","ENSG00000075975","ENSG00000075975","MKRN2","3",12557057,12586208,29151
"5685","ENSG00000179455","ENSG00000179455","MKRN3","15",23565674,23630075,64401
"5686","ENSG00000011143","ENSG00000011143","MKS1","17",58205441,58219605,14164
"5687","ENSG00000120215","ENSG00000120215","MLANA","9",5890889,5910606,19717
"5688","ENSG00000100427","ENSG00000100427","MLC1","22",50059391,50085426,26035
"5689","ENSG00000110917","ENSG00000110917","MLEC","12",120687149,120701859,14710
"5690","ENSG00000178053","ENSG00000178053","MLF1","3",158571163,158607252,36089
"5691","ENSG00000089693","ENSG00000089693","MLF2","12",6747996,6767475,19479
"5692","ENSG00000076242","ENSG00000076242","MLH1","3",36993226,37050896,57670
"5693","ENSG00000119684","ENSG00000119684","MLH3","14",75013769,75051532,37763
"5694","ENSG00000130382","ENSG00000130382","MLLT1","19",6210381,6279975,69594
"5695","ENSG00000078403","ENSG00000078403","MLLT10","10",21524646,21743630,218984
"5696","ENSG00000213190","ENSG00000213190","MLLT11","1",151060397,151069544,9147
"5697","ENSG00000171843","ENSG00000171843","MLLT3","9",20341669,20622499,280830
"5698","ENSG00000102539","ENSG00000102539","MLNR","13",49220338,49222377,2039
"5699","ENSG00000115648","ENSG00000115648","MLPH","2",237485428,237555322,69894
"5700","ENSG00000167965","ENSG00000167965","MLST8","16",2204248,2209453,5205
"5701","ENSG00000108788","ENSG00000108788","MLX","17",42567072,42573239,6167
"5702","ENSG00000281178","ENSG00000281178","MLXIP","HG2247_PATCH",21012,85373,64361
"5703","ENSG00000009950","ENSG00000009950","MLXIPL","7",73593194,73624543,31349
"5704","ENSG00000103150","ENSG00000103150","MLYCD","16",83899115,83951445,52330
"5705","ENSG00000168288","ENSG00000168288","MMADHC","2",149569637,149587778,18141
"5706","ENSG00000108960","ENSG00000108960","MMD","17",55392622,55421924,29302
"5707","ENSG00000196549","ENSG00000196549","MME","3",155024124,155183704,159580
"5708","ENSG00000196611","ENSG00000196611","MMP1","11",102789401,102798160,8759
"5709","ENSG00000166670","ENSG00000166670","MMP10","11",102770502,102780628,10126
"5710","ENSG00000275365","ENSG00000275365","MMP11","HSCHR22_1_CTG7",4588,20678,16090
"5711","ENSG00000262406","ENSG00000262406","MMP12","11",102862736,102874982,12246
"5712","ENSG00000157227","ENSG00000157227","MMP14","14",22836560,22849041,12481
"5713","ENSG00000102996","ENSG00000102996","MMP15","16",58025754,58046901,21147
"5714","ENSG00000156103","ENSG00000156103","MMP16","8",88032011,88328025,296014
"5715","ENSG00000123342","ENSG00000123342","MMP19","12",55835433,55842966,7533
"5716","ENSG00000087245","ENSG00000087245","MMP2","16",55389700,55506691,116991
"5717","ENSG00000137674","ENSG00000137674","MMP20","11",102576832,102625332,48500
"5718","ENSG00000189409","ENSG00000189409","MMP23B","1",1632163,1635263,3100
"5719","ENSG00000125966","ENSG00000125966","MMP24","20",35226690,35276998,50308
"5720","ENSG00000008516","ENSG00000008516","MMP25","16",3046062,3060726,14664
"5721","ENSG00000137675","ENSG00000137675","MMP27","11",102691487,102705769,14282
"5722","ENSG00000278843","ENSG00000278843","MMP28","HSCHR17_7_CTG4",405,30239,29834
"5723","ENSG00000149968","ENSG00000149968","MMP3","11",102835801,102843609,7808
"5724","ENSG00000137673","ENSG00000137673","MMP7","11",102520508,102530750,10242
"5725","ENSG00000118113","ENSG00000118113","MMP8","11",102711796,102727050,15254
"5726","ENSG00000100985","ENSG00000100985","MMP9","20",46008908,46016561,7653
"5727","ENSG00000138722","ENSG00000138722","MMRN1","4",89879532,89954629,75097
"5728","ENSG00000173269","ENSG00000173269","MMRN2","10",86935540,86969481,33941
"5729","ENSG00000155229","ENSG00000155229","MMS19","10",97458324,97498794,40470
"5730","ENSG00000169184","ENSG00000169184","MN1","22",27748277,27801756,53479
"5731","ENSG00000020426","ENSG00000020426","MNAT1","14",60734742,60969965,235223
"5732","ENSG00000163563","ENSG00000163563","MNDA","1",158831351,158849506,18155
"5733","ENSG00000138587","ENSG00000138587","MNS1","15",56421544,56465137,43593
"5734","ENSG00000070444","ENSG00000070444","MNT","17",2384073,2401104,17031
"5735","ENSG00000130675","ENSG00000130675","MNX1","7",156994051,157010663,16612
"5736","ENSG00000278268","ENSG00000278268","MOAP1","HSCHR14_7_CTG1",296758,299490,2732
"5737","ENSG00000114978","ENSG00000114978","MOB1A","2",74152528,74178898,26370
"5738","ENSG00000120162","ENSG00000120162","MOB3B","9",27325209,27529814,204605
"5739","ENSG00000115540","ENSG00000115540","MOB4","2",197515571,197553699,38128
"5740","ENSG00000168314","ENSG00000168314","MOBP","3",39467198,39529479,62281
"5741","ENSG00000075643","ENSG00000075643","MOCOS","18",36187497,36272157,84660
"5742","ENSG00000124615","ENSG00000124615","MOCS1","6",39899578,39934551,34973
"5743","ENSG00000164172","ENSG00000164172","MOCS2","5",53095679,53110063,14384
"5744","ENSG00000124217","ENSG00000124217","MOCS3","20",50958818,50963929,5111
"5745","ENSG00000237834","ENSG00000237834","MOG","HSCHR6_MHC_COX_CTG1",1143453,1158845,15392
"5746","ENSG00000166391","ENSG00000166391","MOGAT2","11",75717838,75732958,15120
"5747","ENSG00000115275","ENSG00000115275","MOGS","2",74461057,74465410,4353
"5748","ENSG00000080823","ENSG00000080823","MOK","14",102224500,102305190,80690
"5749","ENSG00000103111","ENSG00000103111","MON1B","16",77190835,77202398,11563
"5750","ENSG00000061987","ENSG00000061987","MON2","12",62466817,62600476,133659
"5751","ENSG00000114487","ENSG00000114487","MORC1","3",108958248,109118134,159886
"5752","ENSG00000133422","ENSG00000133422","MORC2","22",30925130,30968774,43644
"5753","ENSG00000159256","ENSG00000159256","MORC3","21",36320189,36386148,65959
"5754","ENSG00000133131","ENSG00000133131","MORC4","X",106813871,107000212,186341
"5755","ENSG00000185787","ENSG00000185787","MORF4L1","15",78810487,78898139,87652
"5756","ENSG00000123562","ENSG00000123562","MORF4L2","X",103675496,103688158,12662
"5757","ENSG00000116151","ENSG00000116151","MORN1","1",2321253,2391707,70454
"5758","ENSG00000139714","ENSG00000139714","MORN3","12",121648742,121672631,23889
"5759","ENSG00000101928","ENSG00000101928","MOSPD1","X",134887632,134915257,27625
"5760","ENSG00000106330","ENSG00000106330","MOSPD3","7",100612102,100615384,3282
"5761","ENSG00000079931","ENSG00000079931","MOXD1","6",132296055,132401475,105420
"5762","ENSG00000060762","ENSG00000060762","MPC1","6",166364919,166383013,18094
"5763","ENSG00000143158","ENSG00000143158","MPC2","1",167916675,167937072,20397
"5764","ENSG00000129255","ENSG00000129255","MPDU1","17",7583529,7592789,9260
"5765","ENSG00000107186","ENSG00000107186","MPDZ","9",13105706,13279692,173986
"5766","ENSG00000103152","ENSG00000103152","MPG","16",77007,85851,8844
"5767","ENSG00000124383","ENSG00000124383","MPHOSPH10","2",71130310,71150101,19791
"5768","ENSG00000135698","ENSG00000135698","MPHOSPH6","16",82147798,82170224,22426
"5769","ENSG00000196199","ENSG00000196199","MPHOSPH8","13",19633659,19673441,39782
"5770","ENSG00000051825","ENSG00000051825","MPHOSPH9","12",123152320,123244014,91694
"5771","ENSG00000178802","ENSG00000178802","MPI","15",74890005,74902219,12214
"5772","ENSG00000117400","ENSG00000117400","MPL","1",43337818,43354466,16648
"5773","ENSG00000005381","ENSG00000005381","MPO","17",58269855,58280935,11080
"5774","ENSG00000130830","ENSG00000130830","MPP1","X",154778684,154821007,42323
"5775","ENSG00000108852","ENSG00000108852","MPP2","17",43875357,43909711,34354
"5776","ENSG00000161647","ENSG00000161647","MPP3","17",43800799,43833170,32371
"5777","ENSG00000154889","ENSG00000154889","MPPE1","18",11882622,11908366,25744
"5778","ENSG00000186732","ENSG00000186732","MPPED1","22",43411196,43507848,96652
"5779","ENSG00000066382","ENSG00000066382","MPPED2","11",30384493,30586872,202379
"5780","ENSG00000133030","ENSG00000133030","MPRIP","17",17042457,17217679,175222
"5781","ENSG00000128309","ENSG00000128309","MPST","22",37019635,37029821,10186
"5782","ENSG00000115204","ENSG00000115204","MPV17","2",27309492,27325680,16188
"5783","ENSG00000158887","ENSG00000158887","MPZ","1",161304735,161309968,5233
"5784","ENSG00000197965","ENSG00000197965","MPZL1","1",167721192,167791919,70727
"5785","ENSG00000149573","ENSG00000149573","MPZL2","11",118253416,118264536,11120
"5786","ENSG00000153029","ENSG00000153029","MR1","1",181033374,181061938,28564
"5787","ENSG00000158186","ENSG00000158186","MRAS","3",138347648,138405534,57886
"5788","ENSG00000260314","ENSG00000260314","MRC1","10",17809348,17911164,101816
"5789","ENSG00000011028","ENSG00000011028","MRC2","17",62627670,62693597,65927
"5790","ENSG00000118242","ENSG00000118242","MREG","2",215942584,216034096,91512
"5791","ENSG00000178988","ENSG00000178988","MRFAP1L1","4",6707701,6709865,2164
"5792","ENSG00000101189","ENSG00000101189","MRGBP","20",62796473,62801729,5256
"5793","ENSG00000278619","ENSG00000278619","MRM1","17",36601583,36608964,7381
"5794","ENSG00000122687","ENSG00000122687","MRM2","7",2234195,2242205,8010
"5795","ENSG00000171861","ENSG00000171861","MRM3","17",782353,792509,10156
"5796","ENSG00000184313","ENSG00000184313","MROH7","1",54641754,54710266,68512
"5797","ENSG00000117501","ENSG00000117501","MROH9","1",170935526,171064765,129239
"5798","ENSG00000174547","ENSG00000174547","MRPL11","11",66435075,66466738,31663
"5799","ENSG00000262814","ENSG00000262814","MRPL12","17",81703367,81707517,4150
"5800","ENSG00000172172","ENSG00000172172","MRPL13","8",120380761,120445402,64641
"5801","ENSG00000137547","ENSG00000137547","MRPL15","8",54135241,54148514,13273
"5802","ENSG00000166902","ENSG00000166902","MRPL16","11",59806140,59810778,4638
"5803","ENSG00000158042","ENSG00000158042","MRPL17","11",6680385,6683340,2955
"5804","ENSG00000112110","ENSG00000112110","MRPL18","6",159789812,159798436,8624
"5805","ENSG00000115364","ENSG00000115364","MRPL19","2",75646783,75690851,44068
"5806","ENSG00000112651","ENSG00000112651","MRPL2","6",43054029,43059438,5409
"5807","ENSG00000242485","ENSG00000242485","MRPL20","1",1401909,1407293,5384
"5808","ENSG00000082515","ENSG00000082515","MRPL22","5",154941073,154969411,28338
"5809","ENSG00000214026","ENSG00000214026","MRPL23","11",1947278,1984522,37244
"5810","ENSG00000143314","ENSG00000143314","MRPL24","1",156737303,156741590,4287
"5811","ENSG00000086504","ENSG00000086504","MRPL28","16",366969,371289,4320
"5812","ENSG00000114686","ENSG00000114686","MRPL3","3",131462212,131502983,40771
"5813","ENSG00000243147","ENSG00000243147","MRPL33","2",27771717,27988087,216370
"5814","ENSG00000130312","ENSG00000130312","MRPL34","19",17292609,17306843,14234
"5815","ENSG00000132313","ENSG00000132313","MRPL35","2",86199355,86213790,14435
"5816","ENSG00000154719","ENSG00000154719","MRPL39","21",25585656,25607517,21861
"5817","ENSG00000105364","ENSG00000105364","MRPL4","19",10251901,10260055,8154
"5818","ENSG00000185608","ENSG00000185608","MRPL40","22",19432545,19436075,3530
"5819","ENSG00000198015","ENSG00000198015","MRPL42","12",93467514,93516214,48700
"5820","ENSG00000135900","ENSG00000135900","MRPL44","2",223957463,223967714,10251
"5821","ENSG00000259494","ENSG00000259494","MRPL46","15",88459477,88467390,7913
"5822","ENSG00000175581","ENSG00000175581","MRPL48","11",73787872,73865133,77261
"5823","ENSG00000149792","ENSG00000149792","MRPL49","11",65122183,65127371,5188
"5824","ENSG00000172590","ENSG00000172590","MRPL52","14",22829879,22835037,5158
"5825","ENSG00000173141","ENSG00000173141","MRPL57","13",21176658,21179084,2426
"5826","ENSG00000167862","ENSG00000167862","MRPL58","17",75012670,75021261,8591
"5827","ENSG00000143436","ENSG00000143436","MRPL9","1",151759647,151763496,3849
"5828","ENSG00000048544","ENSG00000048544","MRPS10","6",42206807,42217861,11054
"5829","ENSG00000181991","ENSG00000181991","MRPS11","15",88467453,88480776,13323
"5830","ENSG00000128626","ENSG00000128626","MRPS12","19",38930944,38933168,2224
"5831","ENSG00000120333","ENSG00000120333","MRPS14","1",175010789,175023425,12636
"5832","ENSG00000116898","ENSG00000116898","MRPS15","1",36455718,36464384,8666
"5833","ENSG00000182180","ENSG00000182180","MRPS16","10",73248843,73252693,3850
"5834","ENSG00000239789","ENSG00000239789","MRPS17","7",55951877,55956500,4623
"5835","ENSG00000096080","ENSG00000096080","MRPS18A","6",43671202,43687791,16589
"5836","ENSG00000233813","ENSG00000233813","MRPS18B","HSCHR6_MHC_DBB_CTG1",1873539,1882225,8686
"5837","ENSG00000163319","ENSG00000163319","MRPS18C","4",83455932,83469735,13803
"5838","ENSG00000122140","ENSG00000122140","MRPS2","9",135499984,135504673,4689
"5839","ENSG00000175110","ENSG00000175110","MRPS22","3",139005806,139360497,354691
"5840","ENSG00000113048","ENSG00000113048","MRPS27","5",72214953,72321717,106764
"5841","ENSG00000147586","ENSG00000147586","MRPS28","8",79918717,80030289,111572
"5842","ENSG00000112996","ENSG00000112996","MRPS30","5",44808947,44820428,11481
"5843","ENSG00000102738","ENSG00000102738","MRPS31","13",40729128,40771190,42062
"5844","ENSG00000090263","ENSG00000090263","MRPS33","7",141002610,141015228,12618
"5845","ENSG00000074071","ENSG00000074071","MRPS34","16",1771890,1773150,1260
"5846","ENSG00000061794","ENSG00000061794","MRPS35","12",27710822,27756295,45473
"5847","ENSG00000125445","ENSG00000125445","MRPS7","17",75261674,75266376,4702
"5848","ENSG00000124532","ENSG00000124532","MRS2","6",24402908,24426194,23286
"5849","ENSG00000053372","ENSG00000053372","MRTO4","1",19251805,19260128,8323
"5850","ENSG00000156738","ENSG00000156738","MS4A1","11",60455846,60470752,14906
"5851","ENSG00000149534","ENSG00000149534","MS4A2","11",60088261,60098467,10206
"5852","ENSG00000149516","ENSG00000149516","MS4A3","11",60056587,60071115,14528
"5853","ENSG00000110079","ENSG00000110079","MS4A4A","11",60185657,60318080,132423
"5854","ENSG00000110077","ENSG00000110077","MS4A6A","11",60172015,60184666,12651
"5855","ENSG00000120458","ENSG00000120458","MSANTD2","11",124766498,124800706,34208
"5856","ENSG00000178860","ENSG00000178860","MSC","8",71841560,71844412,2852
"5857","ENSG00000095002","ENSG00000095002","MSH2","2",47403067,47663146,260079
"5858","ENSG00000113318","ENSG00000113318","MSH3","5",80654652,80876815,222163
"5859","ENSG00000057468","ENSG00000057468","MSH4","1",75796882,75913242,116360
"5860","ENSG00000235569","ENSG00000235569","MSH5","HSCHR6_MHC_QBL_CTG1",2995810,3017580,21770
"5861","ENSG00000116062","ENSG00000116062","MSH6","2",47695530,47810063,114533
"5862","ENSG00000135097","ENSG00000135097","MSI1","12",120341330,120369164,27834
"5863","ENSG00000188895","ENSG00000188895","MSL1","17",40121971,40136917,14946
"5864","ENSG00000174579","ENSG00000174579","MSL2","3",136148917,136197241,48324
"5865","ENSG00000005302","ENSG00000005302","MSL3","X",11758159,11775772,17613
"5866","ENSG00000102854","ENSG00000102854","MSLN","16",760734,768865,8131
"5867","ENSG00000263639","ENSG00000263639","MSMB","10",46033307,46048180,14873
"5868","ENSG00000052802","ENSG00000052802","MSMO1","4",165327667,165343164,15497
"5869","ENSG00000147065","ENSG00000147065","MSN","X",65588377,65741931,153554
"5870","ENSG00000038945","ENSG00000038945","MSR1","8",16107878,16567490,459612
"5871","ENSG00000175806","ENSG00000175806","MSRA","8",10054292,10428891,374599
"5872","ENSG00000198736","ENSG00000198736","MSRB1","16",1938229,1943199,4970
"5873","ENSG00000148450","ENSG00000148450","MSRB2","10",23095579,23122013,26434
"5874","ENSG00000173531","ENSG00000173531","MST1","3",49683947,49689501,5554
"5875","ENSG00000164078","ENSG00000164078","MST1R","3",49886902,49903873,16971
"5876","ENSG00000138379","ENSG00000138379","MSTN","2",190055700,190062729,7029
"5877","ENSG00000125459","ENSG00000125459","MSTO1","1",155563235,155614951,51716
"5878","ENSG00000163132","ENSG00000163132","MSX1","4",4859665,4863936,4271
"5879","ENSG00000120149","ENSG00000120149","MSX2","5",174724582,174730896,6314
"5880","ENSG00000169715","ENSG00000169715","MT1E","16",56625475,56627112,1637
"5881","ENSG00000198417","ENSG00000198417","MT1F","16",56657731,56660698,2967
"5882","ENSG00000205358","ENSG00000205358","MT1H","16",56669814,56671129,1315
"5883","ENSG00000187193","ENSG00000187193","MT1X","16",56682470,56684196,1726
"5884","ENSG00000125148","ENSG00000125148","MT2A","16",56608584,56609497,913
"5885","ENSG00000087250","ENSG00000087250","MT3","16",56589074,56591088,2014
"5886","ENSG00000182979","ENSG00000182979","MTA1","14",105419820,105470729,50909
"5887","ENSG00000149480","ENSG00000149480","MTA2","11",62593214,62601865,8651
"5888","ENSG00000099810","ENSG00000099810","MTAP","9",21802636,21937651,135015
"5889","ENSG00000137409","ENSG00000137409","MTCH1","6",36965807,36986298,20491
"5890","ENSG00000109919","ENSG00000109919","MTCH2","11",47617315,47642607,25292
"5891","ENSG00000168502","ENSG00000168502","MTCL1","18",8705556,8832778,127222
"5892","ENSG00000214827","ENSG00000214827","MTCP1","X",155064034,155147937,83903
"5893","ENSG00000147649","ENSG00000147649","MTDH","8",97644184,97730260,86076
"5894","ENSG00000127989","ENSG00000127989","MTERF1","7",91692008,91880702,188694
"5895","ENSG00000156469","ENSG00000156469","MTERF3","8",96239398,96261610,22212
"5896","ENSG00000122085","ENSG00000122085","MTERF4","2",241072169,241102332,30163
"5897","ENSG00000188786","ENSG00000188786","MTF1","1",37809574,37859592,50018
"5898","ENSG00000143033","ENSG00000143033","MTF2","1",93079235,93139079,59844
"5899","ENSG00000066855","ENSG00000066855","MTFR1","8",65644734,65771261,126527
"5900","ENSG00000100714","ENSG00000100714","MTHFD1","14",64388031,64463457,75426
"5901","ENSG00000065911","ENSG00000065911","MTHFD2","2",74186172,74217565,31393
"5902","ENSG00000163738","ENSG00000163738","MTHFD2L","4",74114174,74303099,188925
"5903","ENSG00000177000","ENSG00000177000","MTHFR","1",11785723,11806455,20732
"5904","ENSG00000136371","ENSG00000136371","MTHFS","15",79833585,79897379,63794
"5905","ENSG00000103248","ENSG00000103248","MTHFSD","16",86530178,86555235,25057
"5906","ENSG00000085760","ENSG00000085760","MTIF2","2",55236595,55269347,32752
"5907","ENSG00000171100","ENSG00000171100","MTM1","X",150568417,150673143,104726
"5908","ENSG00000063601","ENSG00000063601","MTMR1","X",150692971,150765108,72137
"5909","ENSG00000277086","ENSG00000277086","MTMR10","HSCHR15_4_CTG8",3227199,3277258,50059
"5910","ENSG00000014914","ENSG00000014914","MTMR11","1",149928651,149936879,8228
"5911","ENSG00000150712","ENSG00000150712","MTMR12","5",32226994,32312987,85993
"5912","ENSG00000163719","ENSG00000163719","MTMR14","3",9649433,9702393,52960
"5913","ENSG00000087053","ENSG00000087053","MTMR2","11",95821766,95925315,103549
"5914","ENSG00000100330","ENSG00000100330","MTMR3","22",29883169,30030868,147699
"5915","ENSG00000108389","ENSG00000108389","MTMR4","17",58489529,58517905,28376
"5916","ENSG00000139505","ENSG00000139505","MTMR6","13",25246222,25287510,41288
"5917","ENSG00000104643","ENSG00000104643","MTMR9","8",11284816,11328146,43330
"5918","ENSG00000135297","ENSG00000135297","MTO1","6",73461578,73509236,47658
"5919","ENSG00000198793","ENSG00000198793","MTOR","1",11106535,11262556,156021
"5920","ENSG00000107951","ENSG00000107951","MTPAP","10",30309801,30374448,64647
"5921","ENSG00000116984","ENSG00000116984","MTR","1",236795260,236921278,126018
"5922","ENSG00000120662","ENSG00000120662","MTRF1","13",41216369,41263577,47208
"5923","ENSG00000112031","ENSG00000112031","MTRF1L","6",152987362,153002709,15347
"5924","ENSG00000124275","ENSG00000124275","MTRR","5",7851186,7906025,54839
"5925","ENSG00000170873","ENSG00000170873","MTSS1","8",124550784,124728473,177689
"5926","ENSG00000138823","ENSG00000138823","MTTP","4",99564081,99623997,59916
"5927","ENSG00000129422","ENSG00000129422","MTUS1","8",17643795,17801094,157299
"5928","ENSG00000132938","ENSG00000132938","MTUS2","13",28820339,29505947,685608
"5929","ENSG00000173171","ENSG00000173171","MTX1","1",155208695,155213824,5129
"5930","ENSG00000128654","ENSG00000128654","MTX2","2",176269395,176338025,68630
"5931","ENSG00000185499","ENSG00000185499","MUC1","1",155185824,155192916,7092
"5932","ENSG00000173702","ENSG00000173702","MUC13","3",124905442,124953819,48377
"5933","ENSG00000181143","ENSG00000181143","MUC16","19",8848844,9010390,161546
"5934","ENSG00000278468","ENSG00000278468","MUC4","HSCHR3_4_CTG3",3235,49270,46035
"5935","ENSG00000117983","ENSG00000117983","MUC5B","11",1223066,1262172,39106
"5936","ENSG00000277518","ENSG00000277518","MUC6","HSCHR11_2_CTG1",75564,106271,30707
"5937","ENSG00000090432","ENSG00000090432","MUL1","1",20499448,20508151,8703
"5938","ENSG00000172732","ENSG00000172732","MUS81","11",65857126,65867653,10527
"5939","ENSG00000132781","ENSG00000132781","MUTYH","1",45329163,45340893,11730
"5940","ENSG00000196814","ENSG00000196814","MVB12B","9",126326829,126507041,180212
"5941","ENSG00000167508","ENSG00000167508","MVD","16",88651935,88663161,11226
"5942","ENSG00000110921","ENSG00000110921","MVK","12",109573255,109598125,24870
"5943","ENSG00000013364","ENSG00000013364","MVP","16",29820394,29848039,27645
"5944","ENSG00000157601","ENSG00000157601","MX1","21",41420020,41470071,50051
"5945","ENSG00000183486","ENSG00000183486","MX2","21",41361999,41409393,47394
"5946","ENSG00000059728","ENSG00000059728","MXD1","2",69897688,69942945,45257
"5947","ENSG00000213347","ENSG00000213347","MXD3","5",177301461,177312757,11296
"5948","ENSG00000123933","ENSG00000123933","MXD4","4",2247432,2262109,14677
"5949","ENSG00000119950","ENSG00000119950","MXI1","10",110207605,110287365,79760
"5950","ENSG00000101825","ENSG00000101825","MXRA5","X",3308565,3346652,38087
"5951","ENSG00000162576","ENSG00000162576","MXRA8","1",1352689,1361777,9088
"5952","ENSG00000118513","ENSG00000118513","MYB","6",135181308,135219173,37865
"5953","ENSG00000132382","ENSG00000132382","MYBBP1A","17",4538897,4555386,16489
"5954","ENSG00000185697","ENSG00000185697","MYBL1","8",66562175,66614247,52072
"5955","ENSG00000101057","ENSG00000101057","MYBL2","20",43667019,43716495,49476
"5956","ENSG00000196091","ENSG00000196091","MYBPC1","12",101568353,101686028,117675
"5957","ENSG00000086967","ENSG00000086967","MYBPC2","19",50432892,50466321,33429
"5958","ENSG00000134571","ENSG00000134571","MYBPC3","11",47331406,47352702,21296
"5959","ENSG00000133055","ENSG00000133055","MYBPH","1",203167811,203175826,8015
"5960","ENSG00000136997","ENSG00000136997","MYC","8",127735434,127742951,7517
"5961","ENSG00000214114","ENSG00000214114","MYCBP","1",38862493,38873368,10875
"5962","ENSG00000005810","ENSG00000005810","MYCBP2","13",77042474,77327094,284620
"5963","ENSG00000116990","ENSG00000116990","MYCL","1",39895428,39902256,6828
"5964","ENSG00000134323","ENSG00000134323","MYCN","2",15940550,15947007,6457
"5965","ENSG00000120279","ENSG00000120279","MYCT1","6",152697897,152724569,26672
"5966","ENSG00000172936","ENSG00000172936","MYD88","3",38138552,38143024,4472
"5967","ENSG00000074842","ENSG00000074842","MYDGF","19",4641374,4670362,28988
"5968","ENSG00000104177","ENSG00000104177","MYEF2","15",48134632,48178353,43721
"5969","ENSG00000111046","ENSG00000111046","MYF6","12",80707634,80709474,1840
"5970","ENSG00000109061","ENSG00000109061","MYH1","17",10492307,10518542,26235
"5971","ENSG00000133026","ENSG00000133026","MYH10","17",8474207,8631376,157169
"5972","ENSG00000276480","ENSG00000276480","MYH11","HSCHR16_1_CTG1",1361183,1515026,153843
"5973","ENSG00000105357","ENSG00000105357","MYH14","19",50188186,50310542,122356
"5974","ENSG00000144821","ENSG00000144821","MYH15","3",108380368,108529322,148954
"5975","ENSG00000125414","ENSG00000125414","MYH2","17",10521148,10549700,28552
"5976","ENSG00000109063","ENSG00000109063","MYH3","17",10628526,10657309,28783
"5977","ENSG00000197616","ENSG00000197616","MYH6","14",23381982,23408273,26291
"5978","ENSG00000092054","ENSG00000092054","MYH7","14",23412740,23435660,22920
"5979","ENSG00000078814","ENSG00000078814","MYH7B","20",34955810,35002437,46627
"5980","ENSG00000133020","ENSG00000133020","MYH8","17",10390322,10421950,31628
"5981","ENSG00000100345","ENSG00000100345","MYH9","22",36281280,36388010,106730
"5982","ENSG00000101608","ENSG00000101608","MYL12A","18",3247481,3256236,8755
"5983","ENSG00000118680","ENSG00000118680","MYL12B","18",3261479,3278461,16982
"5984","ENSG00000111245","ENSG00000111245","MYL2","12",110909996,111052434,142438
"5985","ENSG00000160808","ENSG00000160808","MYL3","3",46835110,46882178,47068
"5986","ENSG00000198336","ENSG00000198336","MYL4","17",47200446,47223679,23233
"5987","ENSG00000215375","ENSG00000215375","MYL5","4",673580,682028,8448
"5988","ENSG00000092841","ENSG00000092841","MYL6","12",56158346,56163496,5150
"5989","ENSG00000196465","ENSG00000196465","MYL6B","12",56152256,56159647,7391
"5990","ENSG00000106631","ENSG00000106631","MYL7","7",44138864,44141332,2468
"5991","ENSG00000007944","ENSG00000007944","MYLIP","6",16129086,16148248,19162
"5992","ENSG00000065534","ENSG00000065534","MYLK","3",123610049,123884332,274283
"5993","ENSG00000140795","ENSG00000140795","MYLK3","16",46702282,46790407,88125
"5994","ENSG00000085274","ENSG00000085274","MYNN","3",169773396,169789716,16320
"5995","ENSG00000145555","ENSG00000145555","MYO10","5",16661907,16936288,274381
"5996","ENSG00000091536","ENSG00000091536","MYO15A","17",18108756,18179802,71046
"5997","ENSG00000041515","ENSG00000041515","MYO16","13",108596152,109208005,611853
"5998","ENSG00000196535","ENSG00000196535","MYO18A","17",29071122,29180398,109276
"5999","ENSG00000278372","ENSG00000278372","MYO19","HSCHR17_7_CTG4",730537,778339,47802
"6000","ENSG00000166866","ENSG00000166866","MYO1A","12",57028517,57051198,22681
"6001","ENSG00000128641","ENSG00000128641","MYO1B","2",191245185,191425389,180204
"6002","ENSG00000197879","ENSG00000197879","MYO1C","17",1464186,1492686,28500
"6003","ENSG00000176658","ENSG00000176658","MYO1D","17",32492522,32877177,384655
"6004","ENSG00000157483","ENSG00000157483","MYO1E","15",59132434,59372871,240437
"6005","ENSG00000142347","ENSG00000142347","MYO1F","19",8520778,8577442,56664
"6006","ENSG00000095777","ENSG00000095777","MYO3A","10",25934229,26212532,278303
"6007","ENSG00000197535","ENSG00000197535","MYO5A","15",52307281,52529132,221851
"6008","ENSG00000128833","ENSG00000128833","MYO5C","15",52192322,52295804,103482
"6009","ENSG00000196586","ENSG00000196586","MYO6","6",75749201,75919537,170336
"6010","ENSG00000137474","ENSG00000137474","MYO7A","11",77128246,77215241,86995
"6011","ENSG00000066933","ENSG00000066933","MYO9A","15",71822291,72118577,296286
"6012","ENSG00000099331","ENSG00000099331","MYO9B","19",17075777,17214537,138760
"6013","ENSG00000034971","ENSG00000034971","MYOC","1",171635417,171652688,17271
"6014","ENSG00000129152","ENSG00000129152","MYOD1","11",17719571,17722136,2565
"6015","ENSG00000138119","ENSG00000138119","MYOF","10",93306429,93482334,175905
"6016","ENSG00000122180","ENSG00000122180","MYOG","1",203083129,203086012,2883
"6017","ENSG00000101605","ENSG00000101605","MYOM1","18",3066807,3219968,153161
"6018","ENSG00000274137","ENSG00000274137","MYOM2","HSCHR8_8_CTG1",228365,348679,120314
"6019","ENSG00000120729","ENSG00000120729","MYOT","5",137867858,137887851,19993
"6020","ENSG00000177791","ENSG00000177791","MYOZ1","10",73631612,73641474,9862
"6021","ENSG00000172399","ENSG00000172399","MYOZ2","4",119135832,119187789,51957
"6022","ENSG00000164591","ENSG00000164591","MYOZ3","5",150660882,150679368,18486
"6023","ENSG00000124920","ENSG00000124920","MYRF","11",61752636,61788518,35882
"6024","ENSG00000170011","ENSG00000170011","MYRIP","3",39808914,40260321,451407
"6025","ENSG00000276876","ENSG00000276876","MYT1","HSCHR20_1_CTG3",60383,150844,90461
"6026","ENSG00000186487","ENSG00000186487","MYT1L","2",1789113,2331664,542551
"6027","ENSG00000170476","ENSG00000170476","MZB1","5",139387467,139390081,2614
"6028","ENSG00000099326","ENSG00000099326","MZF1","19",58561931,58573575,11644
"6029","ENSG00000173272","ENSG00000173272","MZT2A","2",131464900,131492743,27843
"6030","ENSG00000152082","ENSG00000152082","MZT2B","2",130181737,130190729,8992
"6031","ENSG00000102921","ENSG00000102921","N4BP1","16",48538726,48620148,81422
"6032","ENSG00000139597","ENSG00000139597","N4BP2L1","13",32400723,32428311,27588
"6033","ENSG00000244754","ENSG00000244754","N4BP2L2","13",32432417,32538885,106468
"6034","ENSG00000145911","ENSG00000145911","N4BP3","5",178113532,178126081,12549
"6035","ENSG00000156239","ENSG00000156239","N6AMT1","21",28872191,28885371,13180
"6036","ENSG00000102030","ENSG00000102030","NAA10","X",153929225,153935080,5855
"6037","ENSG00000156269","ENSG00000156269","NAA11","4",79225694,79326061,100367
"6038","ENSG00000164134","ENSG00000164134","NAA15","4",139301446,139420033,118587
"6039","ENSG00000172766","ENSG00000172766","NAA16","13",41311267,41377030,65763
"6040","ENSG00000135040","ENSG00000135040","NAA35","9",85941146,86025462,84316
"6041","ENSG00000110583","ENSG00000110583","NAA40","11",63938959,63957319,18360
"6042","ENSG00000121579","ENSG00000121579","NAA50","3",113716458,113746300,29842
"6043","ENSG00000122390","ENSG00000122390","NAA60","16",3443649,3486953,43304
"6044","ENSG00000138744","ENSG00000138744","NAAA","4",75913660,75941013,27353
"6045","ENSG00000077616","ENSG00000077616","NAALAD2","11",90131515,90192894,61379
"6046","ENSG00000168060","ENSG00000168060","NAALADL1","11",65044818,65058553,13735
"6047","ENSG00000138386","ENSG00000138386","NAB1","2",190646746,190692766,46020
"6048","ENSG00000166886","ENSG00000166886","NAB2","12",57089043,57095476,6433
"6049","ENSG00000173559","ENSG00000173559","NABP1","2",191678068,191741097,63029
"6050","ENSG00000139579","ENSG00000139579","NABP2","12",56222015,56229854,7839
"6051","ENSG00000196531","ENSG00000196531","NACA","12",56712305,56731628,19323
"6052","ENSG00000253506","ENSG00000253506","NACA2","17",61590421,61591219,798
"6053","ENSG00000136274","ENSG00000136274","NACAD","7",45080437,45088969,8532
"6054","ENSG00000148411","ENSG00000148411","NACC2","9",136006537,136095289,88752
"6055","ENSG00000008130","ENSG00000008130","NADK","1",1751232,1780457,29225
"6056","ENSG00000172890","ENSG00000172890","NADSYN1","11",71453109,71524107,70998
"6057","ENSG00000159593","ENSG00000159593","NAE1","16",66802875,66873256,70381
"6058","ENSG00000198951","ENSG00000198951","NAGA","22",42058334,42070842,12508
"6059","ENSG00000124357","ENSG00000124357","NAGK","2",71064344,71079808,15464
"6060","ENSG00000108784","ENSG00000108784","NAGLU","17",42536241,42544449,8208
"6061","ENSG00000103174","ENSG00000103174","NAGPA","16",5024844,5034141,9297
"6062","ENSG00000278613","ENSG00000278613","NAIP","HSCHR5_2_CTG1_1",385732,442341,56609
"6063","ENSG00000105835","ENSG00000105835","NAMPT","7",106248298,106285966,37668
"6064","ENSG00000111704","ENSG00000111704","NANOG","12",7787794,7799146,11352
"6065","ENSG00000095380","ENSG00000095380","NANS","9",98056732,98083077,26345
"6066","ENSG00000187109","ENSG00000187109","NAP1L1","12",76036585,76084735,48150
"6067","ENSG00000186462","ENSG00000186462","NAP1L2","X",73212299,73214851,2552
"6068","ENSG00000186310","ENSG00000186310","NAP1L3","X",93670930,93673578,2648
"6069","ENSG00000273562","ENSG00000273562","NAP1L4","HSCHR11_1_CTG7",175479,223447,47968
"6070","ENSG00000105402","ENSG00000105402","NAPA","19",47487637,47515091,27454
"6071","ENSG00000134265","ENSG00000134265","NAPG","18",10525905,10552764,26859
"6072","ENSG00000141562","ENSG00000141562","NARF","17",82458180,82490537,32357
"6073","ENSG00000137513","ENSG00000137513","NARS2","11",78435620,78575194,139574
"6074","ENSG00000132780","ENSG00000132780","NASP","1",45583846,45618904,35058
"6075","ENSG00000171428","ENSG00000171428","NAT1","8",18170477,18223689,53212
"6076","ENSG00000135372","ENSG00000135372","NAT10","11",34105617,34147670,42053
"6077","ENSG00000156006","ENSG00000156006","NAT2","8",18391282,18401218,9936
"6078","ENSG00000144035","ENSG00000144035","NAT8","2",73640723,73642422,1699
"6079","ENSG00000204872","ENSG00000204872","NAT8B","2",73700576,73701340,764
"6080","ENSG00000109065","ENSG00000109065","NAT9","17",74770529,74776367,5838
"6081","ENSG00000166833","ENSG00000166833","NAV2","11",19350724,20121601,770877
"6082","ENSG00000067798","ENSG00000067798","NAV3","12",77324641,78213010,888369
"6083","ENSG00000213995","ENSG00000213995","NAXD","13",110615545,110639996,24451
"6084","ENSG00000151779","ENSG00000151779","NBAS","2",15166916,15561340,394424
"6085","ENSG00000172915","ENSG00000172915","NBEA","13",34942270,35673022,730752
"6086","ENSG00000160796","ENSG00000160796","NBEAL2","3",46979666,47009704,30038
"6087","ENSG00000158747","ENSG00000158747","NBL1","1",19596979,19658456,61477
"6088","ENSG00000104320","ENSG00000104320","NBN","8",89924515,90003228,78713
"6089","ENSG00000263956","ENSG00000263956","NBPF11","1",148102047,148152322,50275
"6090","ENSG00000188554","ENSG00000188554","NBR1","17",43170481,43211689,41208
"6091","ENSG00000198496","ENSG00000198496","NBR2","17",43125551,43153671,28120
"6092","ENSG00000104490","ENSG00000104490","NCALD","8",101686542,102124907,438365
"6093","ENSG00000149294","ENSG00000149294","NCAM1","11",112961275,113278436,317161
"6094","ENSG00000154654","ENSG00000154654","NCAM2","21",20998409,21543329,544920
"6095","ENSG00000130287","ENSG00000130287","NCAN","19",19211958,19252233,40275
"6096","ENSG00000010292","ENSG00000010292","NCAPD2","12",6493356,6531955,38599
"6097","ENSG00000151503","ENSG00000151503","NCAPD3","11",134150113,134225504,75391
"6098","ENSG00000109805","ENSG00000109805","NCAPG","4",17810979,17844865,33886
"6099","ENSG00000146918","ENSG00000146918","NCAPG2","7",158631169,158704804,73635
"6100","ENSG00000121152","ENSG00000121152","NCAPH","2",96335766,96377091,41325
"6101","ENSG00000025770","ENSG00000025770","NCAPH2","22",50508224,50524780,16556
"6102","ENSG00000136937","ENSG00000136937","NCBP1","9",97633668,97673748,40080
"6103","ENSG00000114503","ENSG00000114503","NCBP2","3",196935402,196942594,7192
"6104","ENSG00000074356","ENSG00000074356","NCBP3","17",3802158,3846246,44088
"6105","ENSG00000020129","ENSG00000020129","NCDN","1",35557473,35567274,9801
"6106","ENSG00000158517","ENSG00000158517","NCF1","7",74774011,74789315,15304
"6107","ENSG00000116701","ENSG00000116701","NCF2","1",183554461,183590905,36444
"6108","ENSG00000100365","ENSG00000100365","NCF4","22",36860988,36878017,17029
"6109","ENSG00000158092","ENSG00000158092","NCK1","3",136862208,136951606,89398
"6110","ENSG00000071051","ENSG00000071051","NCK2","2",105744912,105894274,149362
"6111","ENSG00000061676","ENSG00000061676","NCKAP1","2",182909115,183038858,129743
"6112","ENSG00000123338","ENSG00000123338","NCKAP1L","12",54497752,54548243,50491
"6113","ENSG00000213672","ENSG00000213672","NCKIPSD","3",48673844,48686364,12520
"6114","ENSG00000115053","ENSG00000115053","NCL","2",231453531,231483641,30110
"6115","ENSG00000125912","ENSG00000125912","NCLN","19",3185563,3209575,24012
"6116","ENSG00000084676","ENSG00000084676","NCOA1","2",24491254,24770702,279448
"6117","ENSG00000140396","ENSG00000140396","NCOA2","8",70109782,70403808,294026
"6118","ENSG00000124151","ENSG00000124151","NCOA3","20",47501887,47656877,154990
"6119","ENSG00000266412","ENSG00000266412","NCOA4","10",46005088,46030623,25535
"6120","ENSG00000198646","ENSG00000198646","NCOA6","20",34689097,34825651,136554
"6121","ENSG00000141027","ENSG00000141027","NCOR1","17",16029065,16218185,189120
"6122","ENSG00000196498","ENSG00000196498","NCOR2","12",124324415,124567612,243197
"6123","ENSG00000278362","ENSG00000278362","NCR1","HSCHR19LRC_COX2_CTG3_1",551333,561328,9995
"6124","ENSG00000107130","ENSG00000107130","NCS1","9",130172404,130237303,64899
"6125","ENSG00000162736","ENSG00000162736","NCSTN","1",160343294,160358952,15658
"6126","ENSG00000058804","ENSG00000058804","NDC1","1",53765478,53838463,72985
"6127","ENSG00000080986","ENSG00000080986","NDC80","18",2571557,2616635,45078
"6128","ENSG00000275911","ENSG00000275911","NDE1","HSCHR16_1_CTG1",1301278,1384364,83086
"6129","ENSG00000166579","ENSG00000166579","NDEL1","17",8413131,8490411,77280
"6130","ENSG00000131507","ENSG00000131507","NDFIP1","5",142108779,142154440,45661
"6131","ENSG00000182636","ENSG00000182636","NDN","15",23685400,23687305,1905
"6132","ENSG00000173376","ENSG00000173376","NDNF","4",121035613,121073021,37408
"6133","ENSG00000188566","ENSG00000188566","NDOR1","9",137205685,137219361,13676
"6134","ENSG00000124479","ENSG00000124479","NDP","X",43948776,43973395,24619
"6135","ENSG00000104419","ENSG00000104419","NDRG1","8",133237175,133302022,64847
"6136","ENSG00000165795","ENSG00000165795","NDRG2","14",21016763,21070872,54109
"6137","ENSG00000101079","ENSG00000101079","NDRG3","20",36651766,36746090,94324
"6138","ENSG00000103034","ENSG00000103034","NDRG4","16",58462846,58513628,50782
"6139","ENSG00000070614","ENSG00000070614","NDST1","5",150485818,150558211,72393
"6140","ENSG00000166507","ENSG00000166507","NDST2","10",73801911,73811798,9887
"6141","ENSG00000164100","ENSG00000164100","NDST3","4",118033618,118258634,225016
"6142","ENSG00000138653","ENSG00000138653","NDST4","4",114827763,115113876,286113
"6143","ENSG00000125356","ENSG00000125356","NDUFA1","X",119871832,119876662,4830
"6144","ENSG00000130414","ENSG00000130414","NDUFA10","2",239892450,240025743,133293
"6145","ENSG00000186010","ENSG00000186010","NDUFA13","19",19515736,19529054,13318
"6146","ENSG00000131495","ENSG00000131495","NDUFA2","5",140638740,140647771,9031
"6147","ENSG00000278365","ENSG00000278365","NDUFA3","HSCHR19LRC_LRC_S_CTG3_1",77273,81393,4120
"6148","ENSG00000189043","ENSG00000189043","NDUFA4","7",10931943,10940153,8210
"6149","ENSG00000185633","ENSG00000185633","NDUFA4L2","12",57234903,57240715,5812
"6150","ENSG00000128609","ENSG00000128609","NDUFA5","7",123536997,123557904,20907
"6151","ENSG00000281013","ENSG00000281013","NDUFA6","HSCHR22_4_CTG1",477,5733,5256
"6152","ENSG00000267855","ENSG00000267855","NDUFA7","19",8308768,8321375,12607
"6153","ENSG00000119421","ENSG00000119421","NDUFA8","9",122144058,122159779,15721
"6154","ENSG00000139180","ENSG00000139180","NDUFA9","12",4649095,4694317,45222
"6155","ENSG00000004779","ENSG00000004779","NDUFAB1","16",23581014,23596316,15302
"6156","ENSG00000137806","ENSG00000137806","NDUFAF1","15",41387218,41409403,22185
"6157","ENSG00000178057","ENSG00000178057","NDUFAF3","3",49020459,49023495,3036
"6158","ENSG00000123545","ENSG00000123545","NDUFAF4","6",96889315,96897891,8576
"6159","ENSG00000101247","ENSG00000101247","NDUFAF5","20",13785007,13821580,36573
"6160","ENSG00000003509","ENSG00000003509","NDUFAF7","2",37231631,37253403,21772
"6161","ENSG00000183648","ENSG00000183648","NDUFB1","14",92116122,92121917,5795
"6162","ENSG00000147123","ENSG00000147123","NDUFB11","X",47142071,47145466,3395
"6163","ENSG00000090266","ENSG00000090266","NDUFB2","7",140690777,140722790,32013
"6164","ENSG00000119013","ENSG00000119013","NDUFB3","2",201071433,201085750,14317
"6165","ENSG00000065518","ENSG00000065518","NDUFB4","3",120596328,120602507,6179
"6166","ENSG00000136521","ENSG00000136521","NDUFB5","3",179604690,179627647,22957
"6167","ENSG00000165264","ENSG00000165264","NDUFB6","9",32553001,32573184,20183
"6168","ENSG00000166136","ENSG00000166136","NDUFB8","10",100523740,100530000,6260
"6169","ENSG00000109390","ENSG00000109390","NDUFC1","4",139266880,139302551,35671
"6170","ENSG00000151366","ENSG00000151366","NDUFC2","11",78068297,78079862,11565
"6171","ENSG00000023228","ENSG00000023228","NDUFS1","2",206114817,206159509,44692
"6172","ENSG00000158864","ENSG00000158864","NDUFS2","1",161197104,161214723,17619
"6173","ENSG00000213619","ENSG00000213619","NDUFS3","11",47565336,47584562,19226
"6174","ENSG00000164258","ENSG00000164258","NDUFS4","5",53560633,53683338,122705
"6175","ENSG00000168653","ENSG00000168653","NDUFS5","1",39026318,39034636,8318
"6176","ENSG00000115286","ENSG00000115286","NDUFS7","19",1383527,1395589,12062
"6177","ENSG00000110717","ENSG00000110717","NDUFS8","11",68030617,68036644,6027
"6178","ENSG00000167792","ENSG00000167792","NDUFV1","11",67605653,67612554,6901
"6179","ENSG00000178127","ENSG00000178127","NDUFV2","18",9102630,9134345,31715
"6180","ENSG00000183091","ENSG00000183091","NEB","2",151485336,151734487,249151
"6181","ENSG00000078114","ENSG00000078114","NEBL","10",20779973,21293011,513038
"6182","ENSG00000103154","ENSG00000103154","NECAB2","16",83968244,84002776,34532
"6183","ENSG00000125967","ENSG00000125967","NECAB3","20",33657087,33674463,17376
"6184","ENSG00000089818","ENSG00000089818","NECAP1","12",8076939,8097881,20942
"6185","ENSG00000157191","ENSG00000157191","NECAP2","1",16440721,16460078,19357
"6186","ENSG00000110400","ENSG00000110400","NECTIN1","11",119623408,119729200,105792
"6187","ENSG00000130202","ENSG00000130202","NECTIN2","19",44846175,44889223,43048
"6188","ENSG00000177707","ENSG00000177707","NECTIN3","3",111070071,111275563,205492
"6189","ENSG00000069869","ENSG00000069869","NEDD4","15",55826922,55993660,166738
"6190","ENSG00000049759","ENSG00000049759","NEDD4L","18",58044226,58401540,357314
"6191","ENSG00000129559","ENSG00000129559","NEDD8","14",24216857,24232367,15510
"6192","ENSG00000111859","ENSG00000111859","NEDD9","6",11183298,11382348,199050
"6193","ENSG00000100285","ENSG00000100285","NEFH","22",29480218,29491390,11172
"6194","ENSG00000277586","ENSG00000277586","NEFL","8",24950955,24956721,5766
"6195","ENSG00000104722","ENSG00000104722","NEFM","8",24913758,24919098,5340
"6196","ENSG00000140398","ENSG00000140398","NEIL1","15",75346955,75357115,10160
"6197","ENSG00000109674","ENSG00000109674","NEIL3","4",177309874,177362936,53062
"6198","ENSG00000137601","ENSG00000137601","NEK1","4",169369704,169612632,242928
"6199","ENSG00000114670","ENSG00000114670","NEK11","3",131026850,131350465,323615
"6200","ENSG00000117650","ENSG00000117650","NEK2","1",211658657,211675630,16973
"6201","ENSG00000114904","ENSG00000114904","NEK4","3",52708444,52770946,62502
"6202","ENSG00000151414","ENSG00000151414","NEK7","1",198156994,198322420,165426
"6203","ENSG00000119638","ENSG00000119638","NEK9","14",75079353,75127344,47991
"6204","ENSG00000185049","ENSG00000185049","NELFA","4",1982717,2041903,59186
"6205","ENSG00000188986","ENSG00000188986","NELFB","9",137255327,137273542,18215
"6206","ENSG00000101158","ENSG00000101158","NELFCD","20",58981208,58995133,13925
"6207","ENSG00000233801","ENSG00000233801","NELFE","HSCHR6_MHC_SSTO_CTG1",3253276,3260281,7005
"6208","ENSG00000165973","ENSG00000165973","NELL1","11",20669551,21575686,906135
"6209","ENSG00000184613","ENSG00000184613","NELL2","12",44508275,44921848,413573
"6210","ENSG00000165525","ENSG00000165525","NEMF","14",49782083,49852821,70738
"6211","ENSG00000166881","ENSG00000166881","NEMP1","12",57055643,57088063,32420
"6212","ENSG00000117691","ENSG00000117691","NENF","1",212432920,212446379,13459
"6213","ENSG00000067141","ENSG00000067141","NEO1","15",73051710,73305205,253495
"6214","ENSG00000132688","ENSG00000132688","NES","1",156668763,156677407,8644
"6215","ENSG00000173848","ENSG00000173848","NET1","10",5412557,5459056,46499
"6216","ENSG00000171208","ENSG00000171208","NETO2","16",47077703,47143945,66242
"6217","ENSG00000234846","ENSG00000234846","NEU1","HSCHR6_MHC_SSTO_CTG1",3158886,3164159,5273
"6218","ENSG00000162139","ENSG00000162139","NEU3","11",74988279,75018893,30614
"6219","ENSG00000107954","ENSG00000107954","NEURL1","10",103493705,103592546,98841
"6220","ENSG00000162992","ENSG00000162992","NEUROD1","2",181668295,181680827,12532
"6221","ENSG00000171532","ENSG00000171532","NEUROD2","17",39603536,39609777,6241
"6222","ENSG00000164600","ENSG00000164600","NEUROD6","7",31337465,31340726,3261
"6223","ENSG00000181965","ENSG00000181965","NEUROG1","5",135534282,135535964,1682
"6224","ENSG00000122859","ENSG00000122859","NEUROG3","10",69571698,69573422,1724
"6225","ENSG00000196712","ENSG00000196712","NF1","17",31094927,31382116,287189
"6226","ENSG00000186575","ENSG00000186575","NF2","22",29603553,29698598,95045
"6227","ENSG00000163531","ENSG00000163531","NFASC","1",204828651,205022822,194171
"6228","ENSG00000102908","ENSG00000102908","NFAT5","16",69565094,69704666,139572
"6229","ENSG00000131196","ENSG00000131196","NFATC1","18",79395856,79529325,133469
"6230","ENSG00000176953","ENSG00000176953","NFATC2IP","16",28950807,28967092,16285
"6231","ENSG00000072736","ENSG00000072736","NFATC3","16",68084751,68229259,144508
"6232","ENSG00000100968","ENSG00000100968","NFATC4","14",24365673,24379604,13931
"6233","ENSG00000123405","ENSG00000123405","NFE2","12",54292111,54301015,8904
"6234","ENSG00000082641","ENSG00000082641","NFE2L1","17",48048329,48061545,13216
"6235","ENSG00000116044","ENSG00000116044","NFE2L2","2",177218667,177392756,174089
"6236","ENSG00000050344","ENSG00000050344","NFE2L3","7",26152198,26187137,34939
"6237","ENSG00000147862","ENSG00000147862","NFIB","9",14081843,14398983,317140
"6238","ENSG00000141905","ENSG00000141905","NFIC","19",3314403,3469217,154814
"6239","ENSG00000165030","ENSG00000165030","NFIL3","9",91409045,91423832,14787
"6240","ENSG00000109320","ENSG00000109320","NFKB1","4",102501330,102617302,115972
"6241","ENSG00000077150","ENSG00000077150","NFKB2","10",102394110,102402524,8414
"6242","ENSG00000100906","ENSG00000100906","NFKBIA","14",35401079,35404749,3670
"6243","ENSG00000104825","ENSG00000104825","NFKBIB","19",38899700,38908893,9193
"6244","ENSG00000146232","ENSG00000146232","NFKBIE","6",44258166,44265788,7622
"6245","ENSG00000236346","ENSG00000236346","NFKBIL1","HSCHR6_MHC_SSTO_CTG1",2846154,2858110,11956
"6246","ENSG00000170322","ENSG00000170322","NFRKB","11",129863636,129895590,31954
"6247","ENSG00000244005","ENSG00000244005","NFS1","20",35668052,35699355,31303
"6248","ENSG00000169599","ENSG00000169599","NFU1","2",69396113,69437628,41515
"6249","ENSG00000086102","ENSG00000086102","NFX1","9",33290512,33371157,80645
"6250","ENSG00000001167","ENSG00000001167","NFYA","6",41072974,41102403,29429
"6251","ENSG00000120837","ENSG00000120837","NFYB","12",104117086,104138241,21155
"6252","ENSG00000066136","ENSG00000066136","NFYC","1",40691648,40771603,79955
"6253","ENSG00000165553","ENSG00000165553","NGB","14",77265483,77271206,5723
"6254","ENSG00000129460","ENSG00000129460","NGDN","14",23469679,23509862,40183
"6255","ENSG00000134259","ENSG00000134259","NGF","1",115285904,115338770,52866
"6256","ENSG00000064300","ENSG00000064300","NGFR","17",49495293,49515008,19715
"6257","ENSG00000151092","ENSG00000151092","NGLY1","3",25718944,25790039,71095
"6258","ENSG00000182768","ENSG00000182768","NGRN","15",90265659,90275778,10119
"6259","ENSG00000187736","ENSG00000187736","NHEJ1","2",219069355,219160869,91514
"6260","ENSG00000171786","ENSG00000171786","NHLH1","1",160367071,160372846,5775
"6261","ENSG00000196865","ENSG00000196865","NHLRC2","10",113854661,113917194,62533
"6262","ENSG00000145912","ENSG00000145912","NHP2","5",178149463,178153894,4431
"6263","ENSG00000116962","ENSG00000116962","NID1","1",235975830,236065109,89279
"6264","ENSG00000087303","ENSG00000087303","NID2","14",52004809,52069059,64250
"6265","ENSG00000196290","ENSG00000196290","NIF3L1","2",200889327,200903938,14611
"6266","ENSG00000100503","ENSG00000100503","NIN","14",50719763,50831162,111399
"6267","ENSG00000131669","ENSG00000131669","NINJ1","9",93121496,93134251,12755
"6268","ENSG00000171840","ENSG00000171840","NINJ2","12",564296,663589,99293
"6269","ENSG00000101004","ENSG00000101004","NINL","20",25451594,25585531,133937
"6270","ENSG00000132603","ENSG00000132603","NIP7","16",69337996,69343106,5110
"6271","ENSG00000140157","ENSG00000140157","NIPA2","15",22838644,22869362,30718
"6272","ENSG00000104361","ENSG00000104361","NIPAL2","8",98189826,98294393,104567
"6273","ENSG00000001461","ENSG00000001461","NIPAL3","1",24415802,24472976,57174
"6274","ENSG00000164190","ENSG00000164190","NIPBL","5",36876769,37066413,189644
"6275","ENSG00000184117","ENSG00000184117","NIPSNAP1","22",29554808,29581327,26519
"6276","ENSG00000165028","ENSG00000165028","NIPSNAP3B","9",104764129,104777764,13635
"6277","ENSG00000010322","ENSG00000010322","NISCH","3",52455118,52493068,37950
"6278","ENSG00000158793","ENSG00000158793","NIT1","1",161118086,161125445,7359
"6279","ENSG00000114021","ENSG00000114021","NIT2","3",100334739,100361635,26896
"6280","ENSG00000084628","ENSG00000084628","NKAIN1","1",31179745,31239887,60142
"6281","ENSG00000105374","ENSG00000105374","NKG7","19",51371606,51372701,1095
"6282","ENSG00000168256","ENSG00000168256","NKIRAS2","17",42011382,42025644,14262
"6283","ENSG00000186416","ENSG00000186416","NKRF","X",119588337,119606443,18106
"6284","ENSG00000114857","ENSG00000114857","NKTR","3",42600655,42648735,48080
"6285","ENSG00000136352","ENSG00000136352","NKX2-1","14",36516392,36521149,4757
"6286","ENSG00000125820","ENSG00000125820","NKX2-2","20",21511017,21514064,3047
"6287","ENSG00000183072","ENSG00000183072","NKX2-5","5",173232109,173235311,3202
"6288","ENSG00000136327","ENSG00000136327","NKX2-8","14",36580004,36582614,2610
"6289","ENSG00000167034","ENSG00000167034","NKX3-1","8",23678697,23682938,4241
"6290","ENSG00000109705","ENSG00000109705","NKX3-2","4",13540830,13544508,3678
"6291","ENSG00000073536","ENSG00000073536","NLE1","17",35128730,35142304,13574
"6292","ENSG00000169760","ENSG00000169760","NLGN1","3",173396284,174294372,898088
"6293","ENSG00000196338","ENSG00000196338","NLGN3","X",71144821,71175255,30434
"6294","ENSG00000146938","ENSG00000146938","NLGN4X","X",5840637,6228867,388230
"6295","ENSG00000165246","ENSG00000165246","NLGN4Y","Y",14522573,14845654,323081
"6296","ENSG00000087095","ENSG00000087095","NLK","17",28041737,28196381,154644
"6297","ENSG00000091592","ENSG00000091592","NLRP1","17",5499415,5619424,120009
"6298","ENSG00000278789","ENSG00000278789","NLRP2","HSCHR19LRC_LRC_T_CTG3_1",883649,919505,35856
"6299","ENSG00000162711","ENSG00000162711","NLRP3","1",247332331,247449108,116777
"6300","ENSG00000160703","ENSG00000160703","NLRX1","11",119166568,119184016,17448
"6301","ENSG00000197696","ENSG00000197696","NMB","15",84655129,84658563,3434
"6302","ENSG00000169251","ENSG00000169251","NMD3","3",161104696,161253532,148836
"6303","ENSG00000239672","ENSG00000239672","NME1","17",51153559,51162428,8869
"6304","ENSG00000011052","ENSG00000011052","NME1-NME2","17",51153590,51171744,18154
"6305","ENSG00000243678","ENSG00000243678","NME2","17",51165435,51171744,6309
"6306","ENSG00000103024","ENSG00000103024","NME3","16",1770320,1771561,1241
"6307","ENSG00000103202","ENSG00000103202","NME4","16",396725,410367,13642
"6308","ENSG00000112981","ENSG00000112981","NME5","5",138115175,138139443,24268
"6309","ENSG00000172113","ENSG00000172113","NME6","3",48290722,48301685,10963
"6310","ENSG00000143156","ENSG00000143156","NME7","1",169132531,169367948,235417
"6311","ENSG00000086288","ENSG00000086288","NME8","7",37848597,37900397,51800
"6312","ENSG00000123609","ENSG00000123609","NMI","2",151270470,151289894,19424
"6313","ENSG00000157064","ENSG00000157064","NMNAT2","1",183248237,183418380,170143
"6314","ENSG00000106733","ENSG00000106733","NMRK1","9",75060573,75088217,27644
"6315","ENSG00000077009","ENSG00000077009","NMRK2","19",3933069,3942416,9347
"6316","ENSG00000136448","ENSG00000136448","NMT1","17",44957992,45109016,151024
"6317","ENSG00000152465","ENSG00000152465","NMT2","10",15102584,15168693,66109
"6318","ENSG00000109255","ENSG00000109255","NMU","4",55595229,55636698,41469
"6319","ENSG00000053438","ENSG00000053438","NNAT","20",37521206,37523690,2484
"6320","ENSG00000166741","ENSG00000166741","NNMT","11",114257787,114313536,55749
"6321","ENSG00000112992","ENSG00000112992","NNT","5",43602692,43707405,104713
"6322","ENSG00000188976","ENSG00000188976","NOC2L","1",944203,959309,15106
"6323","ENSG00000173145","ENSG00000173145","NOC3L","10",94333226,94362959,29733
"6324","ENSG00000184967","ENSG00000184967","NOC4L","12",132144457,132152473,8016
"6325","ENSG00000106100","ENSG00000106100","NOD1","7",30424527,30478784,54257
"6326","ENSG00000156574","ENSG00000156574","NODAL","10",70431936,70447951,16015
"6327","ENSG00000115761","ENSG00000115761","NOL10","2",10562347,10689987,127640
"6328","ENSG00000130935","ENSG00000130935","NOL11","17",67717931,67744531,26600
"6329","ENSG00000273899","ENSG00000273899","NOL12","22",37681673,37693476,11803
"6330","ENSG00000101746","ENSG00000101746","NOL4","18",33851100,34224952,373852
"6331","ENSG00000165271","ENSG00000165271","NOL6","9",33461353,33473930,12577
"6332","ENSG00000225921","ENSG00000225921","NOL7","6",13615335,13632739,17404
"6333","ENSG00000198000","ENSG00000198000","NOL8","9",92297358,92325636,28278
"6334","ENSG00000162408","ENSG00000162408","NOL9","1",6521347,6554513,33166
"6335","ENSG00000166197","ENSG00000166197","NOLC1","10",102152176,102163871,11695
"6336","ENSG00000274779","ENSG00000274779","NOMO1","HSCHR16_1_CTG1",890754,953160,62406
"6337","ENSG00000185164","ENSG00000185164","NOMO2","16",18417325,18562211,144886
"6338","ENSG00000278087","ENSG00000278087","NOMO3","HSCHR16_1_CTG1",1890490,1952819,62329
"6339","ENSG00000147140","ENSG00000147140","NONO","X",71254814,71301522,46708
"6340","ENSG00000182117","ENSG00000182117","NOP10","15",34339159,34343180,4021
"6341","ENSG00000087269","ENSG00000087269","NOP14","4",2937933,2963406,25473
"6342","ENSG00000048162","ENSG00000048162","NOP16","5",176383946,176388927,4981
"6343","ENSG00000111641","ENSG00000111641","NOP2","12",6556863,6568691,11828
"6344","ENSG00000101361","ENSG00000101361","NOP56","20",2652593,2658393,5800
"6345","ENSG00000089250","ENSG00000089250","NOS1","12",117208142,117452170,244028
"6346","ENSG00000198929","ENSG00000198929","NOS1AP","1",162069691,162370475,300784
"6347","ENSG00000007171","ENSG00000007171","NOS2","17",27756766,27800529,43763
"6348","ENSG00000164867","ENSG00000164867","NOS3","7",150991017,151014588,23571
"6349","ENSG00000142546","ENSG00000142546","NOSIP","19",49555468,49590262,34794
"6350","ENSG00000148400","ENSG00000148400","NOTCH1","9",136494433,136546048,51615
"6351","ENSG00000134250","ENSG00000134250","NOTCH2","1",119911553,120100779,189226
"6352","ENSG00000074181","ENSG00000074181","NOTCH3","19",15159038,15200995,41957
"6353","ENSG00000238196","ENSG00000238196","NOTCH4","HSCHR6_MHC_APD_CTG1",3527442,3536999,9557
"6354","ENSG00000139910","ENSG00000139910","NOVA1","14",26443090,26598033,154943
"6355","ENSG00000104967","ENSG00000104967","NOVA2","19",45933734,45974044,40310
"6356","ENSG00000007952","ENSG00000007952","NOX1","X",100843324,100874359,31035
"6357","ENSG00000086991","ENSG00000086991","NOX4","11",89324353,89498187,173834
"6358","ENSG00000255346","ENSG00000255346","NOX5","15",69014695,69062762,48067
"6359","ENSG00000130751","ENSG00000130751","NPAS1","19",47019837,47045775,25938
"6360","ENSG00000170485","ENSG00000170485","NPAS2","2",100820139,100996829,176690
"6361","ENSG00000151322","ENSG00000151322","NPAS3","14",32934396,33820863,886467
"6362","ENSG00000149308","ENSG00000149308","NPAT","11",108157215,108222638,65423
"6363","ENSG00000141458","ENSG00000141458","NPC1","18",23506184,23586506,80322
"6364","ENSG00000015520","ENSG00000015520","NPC1L1","7",44512535,44541330,28795
"6365","ENSG00000119655","ENSG00000119655","NPC2","14",74476192,74494177,17985
"6366","ENSG00000107281","ENSG00000107281","NPDC1","9",137039463,137046179,6716
"6367","ENSG00000215440","ENSG00000215440","NPEPL1","20",58689131,58719238,30107
"6368","ENSG00000141279","ENSG00000141279","NPEPPS","17",47522942,47624665,101723
"6369","ENSG00000139574","ENSG00000139574","NPFF","12",53506688,53507484,796
"6370","ENSG00000144061","ENSG00000144061","NPHP1","2",110122311,110205066,82755
"6371","ENSG00000131697","ENSG00000131697","NPHP4","1",5862811,5992473,129662
"6372","ENSG00000161270","ENSG00000161270","NPHS1","19",35825372,35869287,43915
"6373","ENSG00000281994","ENSG00000281994","NPIPA1","HSCHR16_1_CTG1",717613,744304,26691
"6374","ENSG00000135838","ENSG00000135838","NPL","1",182789293,182830384,41091
"6375","ENSG00000182446","ENSG00000182446","NPLOC4","17",81556887,81648465,91578
"6376","ENSG00000181163","ENSG00000181163","NPM1","5",171387116,171411810,24694
"6377","ENSG00000107833","ENSG00000107833","NPM3","10",101781325,101783446,2121
"6378","ENSG00000175206","ENSG00000175206","NPPA","1",11845709,11848345,2636
"6379","ENSG00000169418","ENSG00000169418","NPR1","1",153678688,153693992,15304
"6380","ENSG00000159899","ENSG00000159899","NPR2","9",35791003,35809732,18729
"6381","ENSG00000113389","ENSG00000113389","NPR3","5",32689070,32791724,102654
"6382","ENSG00000114388","ENSG00000114388","NPRL2","3",50347330,50350826,3496
"6383","ENSG00000103148","ENSG00000103148","NPRL3","16",84271,138677,54406
"6384","ENSG00000156642","ENSG00000156642","NPTN","15",73560014,73634134,74120
"6385","ENSG00000171246","ENSG00000171246","NPTX1","17",80466834,80477843,11009
"6386","ENSG00000106236","ENSG00000106236","NPTX2","7",98617285,98629869,12584
"6387","ENSG00000221890","ENSG00000221890","NPTXR","22",38818452,38844028,25576
"6388","ENSG00000122585","ENSG00000122585","NPY","7",24284188,24291862,7674
"6389","ENSG00000164128","ENSG00000164128","NPY1R","4",163323962,163344832,20870
"6390","ENSG00000185149","ENSG00000185149","NPY2R","4",155208636,155217078,8442
"6391","ENSG00000204174","ENSG00000204174","NPY4R","10",46461099,46465958,4859
"6392","ENSG00000164129","ENSG00000164129","NPY5R","4",163343892,163351934,8042
"6393","ENSG00000226306","ENSG00000226306","NPY6R","5",137808211,137809322,1111
"6394","ENSG00000181019","ENSG00000181019","NQO1","16",69706996,69726668,19672
"6395","ENSG00000124588","ENSG00000124588","NQO2","6",2987987,3019755,31768
"6396","ENSG00000169297","ENSG00000169297","NR0B1","X",30304206,30309390,5184
"6397","ENSG00000131910","ENSG00000131910","NR0B2","1",26911489,26913975,2486
"6398","ENSG00000126368","ENSG00000126368","NR1D1","17",40092793,40100589,7796
"6399","ENSG00000174738","ENSG00000174738","NR1D2","3",23945286,23980617,35331
"6400","ENSG00000131408","ENSG00000131408","NR1H2","19",50329653,50383388,53735
"6401","ENSG00000025434","ENSG00000025434","NR1H3","11",47248300,47269033,20733
"6402","ENSG00000012504","ENSG00000012504","NR1H4","12",100473708,100564414,90706
"6403","ENSG00000144852","ENSG00000144852","NR1I2","3",119780484,119818487,38003
"6404","ENSG00000143257","ENSG00000143257","NR1I3","1",161229666,161238244,8578
"6405","ENSG00000120798","ENSG00000120798","NR2C1","12",95020229,95073628,53399
"6406","ENSG00000177463","ENSG00000177463","NR2C2","3",14947583,15053600,106017
"6407","ENSG00000112333","ENSG00000112333","NR2E1","6",108166022,108188805,22783
"6408","ENSG00000175745","ENSG00000175745","NR2F1","5",93583222,93594611,11389
"6409","ENSG00000185551","ENSG00000185551","NR2F2","15",96325938,96340263,14325
"6410","ENSG00000160113","ENSG00000160113","NR2F6","19",17231883,17245919,14036
"6411","ENSG00000113580","ENSG00000113580","NR3C1","5",143277931,143435512,157581
"6412","ENSG00000151623","ENSG00000151623","NR3C2","4",148078762,148444698,365936
"6413","ENSG00000123358","ENSG00000123358","NR4A1","12",52022832,52059507,36675
"6414","ENSG00000153234","ENSG00000153234","NR4A2","2",156324437,156342348,17911
"6415","ENSG00000119508","ENSG00000119508","NR4A3","9",99821855,99866891,45036
"6416","ENSG00000116833","ENSG00000116833","NR5A2","1",200027614,200177420,149806
"6417","ENSG00000148200","ENSG00000148200","NR6A1","9",124517275,124771311,254036
"6418","ENSG00000213281","ENSG00000213281","NRAS","1",114704469,114716771,12302
"6419","ENSG00000148572","ENSG00000148572","NRBF2","10",63133247,63155031,21784
"6420","ENSG00000115216","ENSG00000115216","NRBP1","2",27427790,27442259,14469
"6421","ENSG00000091129","ENSG00000091129","NRCAM","7",108147623,108456717,309094
"6422","ENSG00000078618","ENSG00000078618","NRDC","1",51789191,51878805,89614
"6423","ENSG00000119720","ENSG00000119720","NRDE2","14",90267860,90331969,64109
"6424","ENSG00000134986","ENSG00000134986","NREP","5",111662621,111997464,334843
"6425","ENSG00000106459","ENSG00000106459","NRF1","7",129611720,129757082,145362
"6426","ENSG00000157168","ENSG00000157168","NRG1","8",31639222,32855666,1216444
"6427","ENSG00000158458","ENSG00000158458","NRG2","5",139846779,140043299,196520
"6428","ENSG00000154146","ENSG00000154146","NRGN","11",124739942,124747210,7268
"6429","ENSG00000180530","ENSG00000180530","NRIP1","21",14961235,15065936,104701
"6430","ENSG00000053702","ENSG00000053702","NRIP2","12",2825348,2835544,10196
"6431","ENSG00000175352","ENSG00000175352","NRIP3","11",8965682,9005288,39606
"6432","ENSG00000129535","ENSG00000129535","NRL","14",24078662,24115010,36348
"6433","ENSG00000124785","ENSG00000124785","NRN1","6",5997999,6007605,9606
"6434","ENSG00000099250","ENSG00000099250","NRP1","10",33177492,33336262,158770
"6435","ENSG00000118257","ENSG00000118257","NRP2","2",205681990,205798133,116143
"6436","ENSG00000125841","ENSG00000125841","NRSN2","20",346782,359660,12878
"6437","ENSG00000179915","ENSG00000179915","NRXN1","2",49918503,51225575,1307072
"6438","ENSG00000110076","ENSG00000110076","NRXN2","11",64606174,64723197,117023
"6439","ENSG00000021645","ENSG00000021645","NRXN3","14",78170373,79868291,1697918
"6440","ENSG00000164346","ENSG00000164346","NSA2","5",74766991,74780113,13122
"6441","ENSG00000165671","ENSG00000165671","NSD1","5",177131830,177300213,168383
"6442","ENSG00000147383","ENSG00000147383","NSDHL","X",152830967,152869729,38762
"6443","ENSG00000278174","ENSG00000278174","NSF","HSCHR17_1_CTG5",1576739,1743341,166602
"6444","ENSG00000088833","ENSG00000088833","NSFL1C","20",1442162,1473842,31680
"6445","ENSG00000168824","ENSG00000168824","NSG1","4",4348140,4419058,70918
"6446","ENSG00000117697","ENSG00000117697","NSL1","1",212726153,212791782,65629
"6447","ENSG00000035681","ENSG00000035681","NSMAF","8",58583508,58659853,76345
"6448","ENSG00000107672","ENSG00000107672","NSMCE4A","10",121957091,121975217,18126
"6449","ENSG00000165802","ENSG00000165802","NSMF","9",137447570,137459334,11764
"6450","ENSG00000178694","ENSG00000178694","NSUN3","3",94062980,94131832,68852
"6451","ENSG00000130305","ENSG00000130305","NSUN5","7",73302516,73308826,6310
"6452","ENSG00000223705","ENSG00000223705","NSUN5P1","7",75410368,75416597,6229
"6453","ENSG00000179299","ENSG00000179299","NSUN7","4",40749925,40811184,61259
"6454","ENSG00000125458","ENSG00000125458","NT5C","17",75130225,75131757,1532
"6455","ENSG00000076685","ENSG00000076685","NT5C2","10",103087185,103277605,190420
"6456","ENSG00000168268","ENSG00000168268","NT5DC2","3",52524385,52535054,10669
"6457","ENSG00000111696","ENSG00000111696","NT5DC3","12",103770453,103841234,70781
"6458","ENSG00000135318","ENSG00000135318","NT5E","6",85449584,85495791,46207
"6459","ENSG00000205309","ENSG00000205309","NT5M","17",17303335,17347663,44328
"6460","ENSG00000275779","ENSG00000275779","NTAN1","HSCHR16_1_CTG1",613600,631834,18234
"6461","ENSG00000065057","ENSG00000065057","NTHL1","16",2039815,2047866,8051
"6462","ENSG00000182667","ENSG00000182667","NTM","11",131370478,132336822,966344
"6463","ENSG00000065320","ENSG00000065320","NTN1","17",9021510,9244000,222490
"6464","ENSG00000162068","ENSG00000162068","NTN3","16",2471297,2474145,2848
"6465","ENSG00000162631","ENSG00000162631","NTNG1","1",107140007,107484923,344916
"6466","ENSG00000198400","ENSG00000198400","NTRK1","1",156815636,156881850,66214
"6467","ENSG00000148053","ENSG00000148053","NTRK2","9",84668375,85095751,427376
"6468","ENSG00000140538","ENSG00000140538","NTRK3","15",87859751,88256791,397040
"6469","ENSG00000133636","ENSG00000133636","NTS","12",85874295,85882992,8697
"6470","ENSG00000169006","ENSG00000169006","NTSR2","2",11658178,11670195,12017
"6471","ENSG00000074590","ENSG00000074590","NUAK1","12",106063345,106138954,75609
"6472","ENSG00000163545","ENSG00000163545","NUAK2","1",205302063,205321745,19682
"6473","ENSG00000095906","ENSG00000095906","NUBP2","16",1782932,1789186,6254
"6474","ENSG00000151413","ENSG00000151413","NUBPL","14",31489956,31861224,371268
"6475","ENSG00000104805","ENSG00000104805","NUCB1","19",48900050,48923473,23423
"6476","ENSG00000070081","ENSG00000070081","NUCB2","11",17208153,17349980,141827
"6477","ENSG00000069275","ENSG00000069275","NUCKS1","1",205712822,205750182,37360
"6478","ENSG00000090273","ENSG00000090273","NUDC","1",26900238,26946871,46633
"6479","ENSG00000015676","ENSG00000015676","NUDCD3","7",44379119,44490658,111539
"6480","ENSG00000106268","ENSG00000106268","NUDT1","7",2242226,2251146,8920
"6481","ENSG00000196368","ENSG00000196368","NUDT11","X",51490011,51496592,6581
"6482","ENSG00000166321","ENSG00000166321","NUDT13","10",73110375,73131828,21453
"6483","ENSG00000136159","ENSG00000136159","NUDT15","13",48037726,48047221,9495
"6484","ENSG00000275074","ENSG00000275074","NUDT18","8",22106874,22109419,2545
"6485","ENSG00000164978","ENSG00000164978","NUDT2","9",34329506,34343711,14205
"6486","ENSG00000167005","ENSG00000167005","NUDT21","16",56429133,56452199,23066
"6487","ENSG00000272325","ENSG00000272325","NUDT3","6",34279679,34392669,112990
"6488","ENSG00000170917","ENSG00000170917","NUDT6","4",122888697,122922968,34271
"6489","ENSG00000140876","ENSG00000140876","NUDT7","16",77722492,77742260,19768
"6490","ENSG00000170502","ENSG00000170502","NUDT9","4",87422573,87459455,36882
"6491","ENSG00000083635","ENSG00000083635","NUFIP1","13",44939249,44989471,50222
"6492","ENSG00000137497","ENSG00000137497","NUMA1","11",72002864,72080693,77829
"6493","ENSG00000133961","ENSG00000133961","NUMB","14",73275107,73458617,183510
"6494","ENSG00000111581","ENSG00000111581","NUP107","12",68686951,68745809,58858
"6495","ENSG00000069248","ENSG00000069248","NUP133","1",229440259,229508341,68082
"6496","ENSG00000124789","ENSG00000124789","NUP153","6",17615035,17706925,91890
"6497","ENSG00000113569","ENSG00000113569","NUP155","5",37288137,37371106,82969
"6498","ENSG00000030066","ENSG00000030066","NUP160","11",47778087,47848555,70468
"6499","ENSG00000155561","ENSG00000155561","NUP205","7",135557917,135648757,90840
"6500","ENSG00000132182","ENSG00000132182","NUP210","3",13316235,13420322,104087
"6501","ENSG00000126883","ENSG00000126883","NUP214","9",131125573,131234663,109090
"6502","ENSG00000075188","ENSG00000075188","NUP37","12",102073103,102120120,47017
"6503","ENSG00000120253","ENSG00000120253","NUP43","6",149724315,149749665,25350
"6504","ENSG00000093000","ENSG00000093000","NUP50","22",45163925,45188017,24092
"6505","ENSG00000138750","ENSG00000138750","NUP54","4",76107562,76148485,40923
"6506","ENSG00000139496","ENSG00000139496","NUP58","13",25301524,25365390,63866
"6507","ENSG00000213024","ENSG00000213024","NUP62","19",49906825,49929764,22939
"6508","ENSG00000198088","ENSG00000198088","NUP62CL","X",107123427,107206433,83006
"6509","ENSG00000125450","ENSG00000125450","NUP85","17",75205659,75235758,30099
"6510","ENSG00000108559","ENSG00000108559","NUP88","17",5359668,5420164,60496
"6511","ENSG00000102900","ENSG00000102900","NUP93","16",56730118,56850286,120168
"6512","ENSG00000110713","ENSG00000110713","NUP98","11",3671083,3797792,126709
"6513","ENSG00000176046","ENSG00000176046","NUPR1","16",28532708,28539008,6300
"6514","ENSG00000137804","ENSG00000137804","NUSAP1","15",41320794,41381050,60256
"6515","ENSG00000102898","ENSG00000102898","NUTF2","16",67846882,67872567,25685
"6516","ENSG00000143748","ENSG00000143748","NVL","1",224227334,224330189,102855
"6517","ENSG00000162231","ENSG00000162231","NXF1","11",62792123,62806302,14179
"6518","ENSG00000167693","ENSG00000167693","NXN","17",799310,979776,180466
"6519","ENSG00000144815","ENSG00000144815","NXPE3","3",101779177,101843743,64566
"6520","ENSG00000137634","ENSG00000137634","NXPE4","11",114570591,114595786,25195
"6521","ENSG00000182575","ENSG00000182575","NXPH3","17",49575871,49583827,7956
"6522","ENSG00000132661","ENSG00000132661","NXT1","20",23350791,23354771,3980
"6523","ENSG00000101888","ENSG00000101888","NXT2","X",109535781,109544698,8917
"6524","ENSG00000205978","ENSG00000205978","NYNRIN","14",24399003,24419283,20280
"6525","ENSG00000089127","ENSG00000089127","OAS1","12",112905856,112933219,27363
"6526","ENSG00000111335","ENSG00000111335","OAS2","12",112978395,113011723,33328
"6527","ENSG00000111331","ENSG00000111331","OAS3","12",112938051,112976460,38409
"6528","ENSG00000135114","ENSG00000135114","OASL","12",121017763,121039246,21483
"6529","ENSG00000065154","ENSG00000065154","OAT","10",124397303,124418976,21673
"6530","ENSG00000104904","ENSG00000104904","OAZ1","19",2269509,2273490,3981
"6531","ENSG00000180304","ENSG00000180304","OAZ2","15",64687573,64703281,15708
"6532","ENSG00000154358","ENSG00000154358","OBSCN","1",228208044,228378876,170832
"6533","ENSG00000104044","ENSG00000104044","OCA2","15",27754875,28099315,344440
"6534","ENSG00000099330","ENSG00000099330","OCEL1","19",17226213,17229219,3006
"6535","ENSG00000273814","ENSG00000273814","OCLN","HSCHR5_2_CTG1_1",275189,339606,64417
"6536","ENSG00000122126","ENSG00000122126","OCRL","X",129539849,129592561,52712
"6537","ENSG00000109205","ENSG00000109205","ODAM","4",70195725,70204576,8851
"6538","ENSG00000115758","ENSG00000115758","ODC1","2",10439968,10448327,8359
"6539","ENSG00000136811","ENSG00000136811","ODF2","9",128455186,128501292,46106
"6540","ENSG00000046651","ENSG00000046651","OFD1","X",13734743,13777955,43212
"6541","ENSG00000105953","ENSG00000105953","OGDH","7",44606572,44709066,102494
"6542","ENSG00000197444","ENSG00000197444","OGDHL","10",49734641,49762379,27738
"6543","ENSG00000087263","ENSG00000087263","OGFOD1","16",56451521,56479104,27583
"6544","ENSG00000111325","ENSG00000111325","OGFOD2","12",122974580,122980043,5463
"6545","ENSG00000181396","ENSG00000181396","OGFOD3","17",82389210,82418637,29427
"6546","ENSG00000060491","ENSG00000060491","OGFR","20",62804835,62814000,9165
"6547","ENSG00000119900","ENSG00000119900","OGFRL1","6",71288811,71309059,20248
"6548","ENSG00000114026","ENSG00000114026","OGG1","3",9749944,9788219,38275
"6549","ENSG00000106809","ENSG00000106809","OGN","9",92383268,92404696,21428
"6550","ENSG00000147162","ENSG00000147162","OGT","X",71533087,71575892,42805
"6551","ENSG00000104147","ENSG00000104147","OIP5","15",41309273,41332591,23318
"6552","ENSG00000138430","ENSG00000138430","OLA1","2",174072447,174248599,176152
"6553","ENSG00000152463","ENSG00000152463","OLAH","10",15032227,15073853,41626
"6554","ENSG00000130558","ENSG00000130558","OLFM1","9",135075422,135121180,45758
"6555","ENSG00000102837","ENSG00000102837","OLFM4","13",53028813,53052057,23244
"6556","ENSG00000183801","ENSG00000183801","OLFML1","11",7485388,7511377,25989
"6557","ENSG00000185585","ENSG00000185585","OLFML2A","9",124777133,124814885,37752
"6558","ENSG00000162745","ENSG00000162745","OLFML2B","1",161983192,162023869,40677
"6559","ENSG00000116774","ENSG00000116774","OLFML3","1",113979391,114035572,56181
"6560","ENSG00000205927","ENSG00000205927","OLIG2","21",33025935,33029196,3261
"6561","ENSG00000173391","ENSG00000173391","OLR1","12",10158301,10172138,13837
"6562","ENSG00000127083","ENSG00000127083","OMD","9",92412380,92424471,12091
"6563","ENSG00000126861","ENSG00000126861","OMG","17",31272013,31297539,25526
"6564","ENSG00000198836","ENSG00000198836","OPA1","3",193593144,193697811,104667
"6565","ENSG00000125741","ENSG00000125741","OPA3","19",45527767,45602212,74445
"6566","ENSG00000183715","ENSG00000183715","OPCML","11",132414977,133532501,1117524
"6567","ENSG00000079482","ENSG00000079482","OPHN1","X",67949349,68433913,484564
"6568","ENSG00000178814","ENSG00000178814","OPLAH","8",144051266,144063965,12699
"6569","ENSG00000128617","ENSG00000128617","OPN1SW","7",128772485,128775794,3309
"6570","ENSG00000054277","ENSG00000054277","OPN3","1",241590102,241677376,87274
"6571","ENSG00000277044","ENSG00000277044","OPRL1","HSCHR20_1_CTG3",2748,5589,2841
"6572","ENSG00000112038","ENSG00000112038","OPRM1","6",154010496,154246867,236371
"6573","ENSG00000123240","ENSG00000123240","OPTN","10",13099449,13138308,38859
"6574","ENSG00000237258","ENSG00000237258","OR11A1","HSCHR6_MHC_MANN_CTG1",690640,722195,31555
"6575","ENSG00000168124","ENSG00000168124","OR1F1","16",3188204,3224779,36575
"6576","ENSG00000167332","ENSG00000167332","OR51E2","11",4680171,4697854,17683
"6577","ENSG00000188269","ENSG00000188269","OR7A5","19",14826241,14835185,8944
"6578","ENSG00000160991","ENSG00000160991","ORAI2","7",102433106,102456825,23719
"6579","ENSG00000175938","ENSG00000175938","ORAI3","16",30949068,30956461,7393
"6580","ENSG00000085840","ENSG00000085840","ORC1","1",52372829,52404423,31594
"6581","ENSG00000115942","ENSG00000115942","ORC2","2",200908977,200963680,54703
"6582","ENSG00000135336","ENSG00000135336","ORC3","6",87590067,87667453,77386
"6583","ENSG00000115947","ENSG00000115947","ORC4","2",147930396,148021604,91208
"6584","ENSG00000164815","ENSG00000164815","ORC5","7",104126341,104208047,81706
"6585","ENSG00000091651","ENSG00000091651","ORC6","16",46689643,46698394,8751
"6586","ENSG00000229314","ENSG00000229314","ORM1","9",114323098,114326479,3381
"6587","ENSG00000228278","ENSG00000228278","ORM2","9",114329869,114333251,3382
"6588","ENSG00000123353","ENSG00000123353","ORMDL2","12",55818041,55821879,3838
"6589","ENSG00000135506","ENSG00000135506","OS9","12",57693841,57728342,34501
"6590","ENSG00000110048","ENSG00000110048","OSBP","11",59574398,59615774,41376
"6591","ENSG00000184792","ENSG00000184792","OSBP2","22",30693782,30907824,214042
"6592","ENSG00000144645","ENSG00000144645","OSBPL10","3",31657912,32077580,419668
"6593","ENSG00000144909","ENSG00000144909","OSBPL11","3",125528858,125595497,66639
"6594","ENSG00000141447","ENSG00000141447","OSBPL1A","18",24162045,24397880,235835
"6595","ENSG00000130703","ENSG00000130703","OSBPL2","20",62231922,62296213,64291
"6596","ENSG00000070882","ENSG00000070882","OSBPL3","7",24796540,24981634,185094
"6597","ENSG00000091039","ENSG00000091039","OSBPL8","12",76351797,76559809,208012
"6598","ENSG00000117859","ENSG00000117859","OSBPL9","1",51577179,51798427,221248
"6599","ENSG00000132823","ENSG00000132823","OSER1","20",44195939,44210771,14832
"6600","ENSG00000092094","ENSG00000092094","OSGEP","14",20446401,20455089,8688
"6601","ENSG00000128694","ENSG00000128694","OSGEPL1","2",189746660,189763227,16567
"6602","ENSG00000140961","ENSG00000140961","OSGIN1","16",83931311,83966332,35021
"6603","ENSG00000164823","ENSG00000164823","OSGIN2","8",89901849,89927888,26039
"6604","ENSG00000099985","ENSG00000099985","OSM","22",30262829,30266851,4022
"6605","ENSG00000145623","ENSG00000145623","OSMR","5",38845858,38945596,99738
"6606","ENSG00000164920","ENSG00000164920","OSR2","8",98944403,98952104,7701
"6607","ENSG00000134996","ENSG00000134996","OSTF1","9",75088514,75147265,58751
"6608","ENSG00000081087","ENSG00000081087","OSTM1","6",108029245,108165854,136609
"6609","ENSG00000036473","ENSG00000036473","OTC","X",38327598,38422908,95310
"6610","ENSG00000115155","ENSG00000115155","OTOF","2",26457203,26558756,101553
"6611","ENSG00000167770","ENSG00000167770","OTUB1","11",63985853,64001811,15958
"6612","ENSG00000277276","ENSG00000277276","OTUB2","HSCHR14_7_CTG1",1140891,1164186,23295
"6613","ENSG00000169914","ENSG00000169914","OTUD3","1",19882395,19912945,30550
"6614","ENSG00000164164","ENSG00000164164","OTUD4","4",145110838,145180589,69751
"6615","ENSG00000264522","ENSG00000264522","OTUD7B","1",149937812,150010726,72914
"6616","ENSG00000085465","ENSG00000085465","OVGP1","1",111414319,111427735,13416
"6617","ENSG00000172818","ENSG00000172818","OVOL1","11",65787063,65797214,10151
"6618","ENSG00000125850","ENSG00000125850","OVOL2","20",17956979,18059188,102209
"6619","ENSG00000155463","ENSG00000155463","OXA1L","14",22766522,22773042,6520
"6620","ENSG00000083720","ENSG00000083720","OXCT1","5",41730065,41870425,140360
"6621","ENSG00000198754","ENSG00000198754","OXCT2","1",39769523,39771348,1825
"6622","ENSG00000164830","ENSG00000164830","OXR1","8",106270144,106752694,482550
"6623","ENSG00000151093","ENSG00000151093","OXSM","3",25782917,25794534,11617
"6624","ENSG00000172939","ENSG00000172939","OXSR1","3",38165089,38255484,90395
"6625","ENSG00000101405","ENSG00000101405","OXT","20",3071620,3072517,897
"6626","ENSG00000180914","ENSG00000180914","OXTR","3",8750381,8769628,19247
"6627","ENSG00000108405","ENSG00000108405","P2RX1","17",3896592,3916476,19884
"6628","ENSG00000109991","ENSG00000109991","P2RX3","11",57338352,57372396,34044
"6629","ENSG00000135124","ENSG00000135124","P2RX4","12",121210065,121234106,24041
"6630","ENSG00000083454","ENSG00000083454","P2RX5","17",3672199,3696240,24041
"6631","ENSG00000099957","ENSG00000099957","P2RX6","22",21009808,21028013,18205
"6632","ENSG00000089041","ENSG00000089041","P2RX7","12",121132819,121188032,55213
"6633","ENSG00000169860","ENSG00000169860","P2RY1","3",152835131,152841439,6308
"6634","ENSG00000078589","ENSG00000078589","P2RY10","X",78945332,78963727,18395
"6635","ENSG00000244165","ENSG00000244165","P2RY11","19",10111693,10115372,3679
"6636","ENSG00000181631","ENSG00000181631","P2RY13","3",151326312,151329549,3237
"6637","ENSG00000174944","ENSG00000174944","P2RY14","3",151212117,151278542,66425
"6638","ENSG00000175591","ENSG00000175591","P2RY2","11",73218281,73242427,24146
"6639","ENSG00000186912","ENSG00000186912","P2RY4","X",70258166,70260204,2038
"6640","ENSG00000171631","ENSG00000171631","P2RY6","11",73264498,73305103,40605
"6641","ENSG00000117385","ENSG00000117385","P3H1","1",42746335,42767084,20749
"6642","ENSG00000090530","ENSG00000090530","P3H2","3",189956728,190122437,165709
"6643","ENSG00000110811","ENSG00000110811","P3H3","12",6828407,6839847,11440
"6644","ENSG00000141696","ENSG00000141696","P3H4","17",41801947,41812604,10657
"6645","ENSG00000122884","ENSG00000122884","P4HA1","10",73007217,73096974,89757
"6646","ENSG00000072682","ENSG00000072682","P4HA2","5",132190147,132295315,105168
"6647","ENSG00000185624","ENSG00000185624","P4HB","17",81843159,81860856,17697
"6648","ENSG00000178467","ENSG00000178467","P4HTM","3",48989889,49007153,17264
"6649","ENSG00000170515","ENSG00000170515","PA2G4","12",56104537,56113910,9373
"6650","ENSG00000175575","ENSG00000175575","PAAF1","11",73876699,73931114,54415
"6651","ENSG00000070756","ENSG00000070756","PABPC1","8",100685816,100722809,36993
"6652","ENSG00000090621","ENSG00000090621","PABPC4","1",39560709,39576790,16081
"6653","ENSG00000100836","ENSG00000100836","PABPN1","14",23321457,23326163,4706
"6654","ENSG00000112530","ENSG00000112530","PACRG","6",162727132,163315500,588368
"6655","ENSG00000175115","ENSG00000175115","PACS1","11",66070272,66244744,174472
"6656","ENSG00000179364","ENSG00000179364","PACS2","14",105300563,105398147,97584
"6657","ENSG00000100266","ENSG00000100266","PACSIN2","22",42835412,43015149,179737
"6658","ENSG00000165912","ENSG00000165912","PACSIN3","11",47177522,47186443,8921
"6659","ENSG00000117115","ENSG00000117115","PADI2","1",17066761,17119451,52690
"6660","ENSG00000280549","ENSG00000280549","PADI3","HG2095_PATCH",91612,126747,35135
"6661","ENSG00000280908","ENSG00000280908","PADI4","HG2095_PATCH",153419,209227,55808
"6662","ENSG00000122133","ENSG00000122133","PAEP","9",135561756,135566955,5199
"6663","ENSG00000006712","ENSG00000006712","PAF1","19",39385629,39391154,5525
"6664","ENSG00000007168","ENSG00000007168","PAFAH1B1","17",2593183,2685615,92432
"6665","ENSG00000168092","ENSG00000168092","PAFAH1B2","11",117144284,117176894,32610
"6666","ENSG00000079462","ENSG00000079462","PAFAH1B3","19",42297033,42303546,6513
"6667","ENSG00000158006","ENSG00000158006","PAFAH2","1",25959767,25998117,38350
"6668","ENSG00000068985","ENSG00000068985","PAGE1","X",49687447,49695984,8537
"6669","ENSG00000101951","ENSG00000101951","PAGE4","X",49793653,49834264,40611
"6670","ENSG00000280789","ENSG00000280789","PAGR1","16",29816152,29822489,6337
"6671","ENSG00000171759","ENSG00000171759","PAH","12",102836889,102958410,121521
"6672","ENSG00000128050","ENSG00000128050","PAICS","4",56435741,56464578,28837
"6673","ENSG00000172239","ENSG00000172239","PAIP1","5",43526267,43557758,31491
"6674","ENSG00000124374","ENSG00000124374","PAIP2B","2",71182738,71227103,44365
"6675","ENSG00000149269","ENSG00000149269","PAK1","11",77322017,77474635,152618
"6676","ENSG00000111845","ENSG00000111845","PAK1IP1","6",10694972,10709782,14810
"6677","ENSG00000077264","ENSG00000077264","PAK3","X",110944285,111227361,283076
"6678","ENSG00000130669","ENSG00000130669","PAK4","19",39125770,39182816,57046
"6679","ENSG00000101349","ENSG00000101349","PAK5","20",9537370,9839076,301706
"6680","ENSG00000137843","ENSG00000137843","PAK6","15",40217428,40277487,60059
"6681","ENSG00000083093","ENSG00000083093","PALB2","16",23603160,23641321,38161
"6682","ENSG00000129116","ENSG00000129116","PALLD","4",168497052,168928457,431405
"6683","ENSG00000099864","ENSG00000099864","PALM","19",708935,748329,39394
"6684","ENSG00000099260","ENSG00000099260","PALMD","1",99646113,99694541,48428
"6685","ENSG00000145730","ENSG00000145730","PAM","5",102753981,103029730,275749
"6686","ENSG00000282228","ENSG00000282228","PAM16","HSCHR16_3_CTG1",31913,56943,25030
"6687","ENSG00000149090","ENSG00000149090","PAMR1","11",35431823,35530300,98477
"6688","ENSG00000135473","ENSG00000135473","PAN2","12",56316223,56334053,17830
"6689","ENSG00000125779","ENSG00000125779","PANK2","20",3888839,3929887,41048
"6690","ENSG00000120137","ENSG00000120137","PANK3","5",168548495,168579368,30873
"6691","ENSG00000273494","ENSG00000273494","PANK4","HSCHR1_1_CTG3",59723,77790,18067
"6692","ENSG00000110218","ENSG00000110218","PANX1","11",94128841,94181968,53127
"6693","ENSG00000090060","ENSG00000090060","PAPOLA","14",96501433,96567116,65683
"6694","ENSG00000218823","ENSG00000218823","PAPOLB","7",4857738,4862030,4292
"6695","ENSG00000115421","ENSG00000115421","PAPOLG","2",60756253,60802086,45833
"6696","ENSG00000182752","ENSG00000182752","PAPPA","9",116153791,116402321,248530
"6697","ENSG00000116183","ENSG00000116183","PAPPA2","1",176463171,176845601,382430
"6698","ENSG00000138801","ENSG00000138801","PAPSS1","4",107590276,107720234,129958
"6699","ENSG00000198682","ENSG00000198682","PAPSS2","10",87659613,87747705,88092
"6700","ENSG00000163291","ENSG00000163291","PAQR3","4",78887127,78939438,52311
"6701","ENSG00000137819","ENSG00000137819","PAQR5","15",69298912,69407780,108868
"6702","ENSG00000160781","ENSG00000160781","PAQR6","1",156243320,156248117,4797
"6703","ENSG00000148498","ENSG00000148498","PARD3","10",34109560,34815325,705765
"6704","ENSG00000102981","ENSG00000102981","PARD6A","16",67660946,67662774,1828
"6705","ENSG00000227345","ENSG00000227345","PARG","10",49818279,49970203,151924
"6706","ENSG00000116288","ENSG00000116288","PARK7","1",7954291,7985505,31214
"6707","ENSG00000175193","ENSG00000175193","PARL","3",183829271,183884933,55662
"6708","ENSG00000169116","ENSG00000169116","PARM1","4",74933095,75050115,117020
"6709","ENSG00000274829","ENSG00000274829","PARN","HSCHR16_1_CTG1",8558,205584,197026
"6710","ENSG00000143799","ENSG00000143799","PARP1","1",226360210,226408154,47944
"6711","ENSG00000111224","ENSG00000111224","PARP11","12",3791047,3873448,82401
"6712","ENSG00000059378","ENSG00000059378","PARP12","7",140023749,140062951,39202
"6713","ENSG00000138617","ENSG00000138617","PARP16","15",65234460,65300618,66158
"6714","ENSG00000129484","ENSG00000129484","PARP2","14",20343615,20357904,14289
"6715","ENSG00000041880","ENSG00000041880","PARP3","3",51942345,51948867,6522
"6716","ENSG00000102699","ENSG00000102699","PARP4","13",24420931,24512778,91847
"6717","ENSG00000137817","ENSG00000137817","PARP6","15",72241181,72272999,31818
"6718","ENSG00000151883","ENSG00000151883","PARP8","5",50665899,50846519,180620
"6719","ENSG00000185480","ENSG00000185480","PARPBP","12",102120183,102197520,77337
"6720","ENSG00000197702","ENSG00000197702","PARVA","11",12377563,12535356,157793
"6721","ENSG00000188677","ENSG00000188677","PARVB","22",43999211,44172939,173728
"6722","ENSG00000115687","ENSG00000115687","PASK","2",241106099,241150264,44165
"6723","ENSG00000132849","ENSG00000132849","PATJ","1",61742477,62178675,436198
"6724","ENSG00000100105","ENSG00000100105","PATZ1","22",31325804,31346346,20542
"6725","ENSG00000177425","ENSG00000177425","PAWR","12",79574979,79690964,115985
"6726","ENSG00000075891","ENSG00000075891","PAX2","10",100735396,100829944,94548
"6727","ENSG00000135903","ENSG00000135903","PAX3","2",222199887,222298998,99111
"6728","ENSG00000106331","ENSG00000106331","PAX4","7",127610292,127618142,7850
"6729","ENSG00000196092","ENSG00000196092","PAX5","9",36833269,37034268,200999
"6730","ENSG00000007372","ENSG00000007372","PAX6","11",31784779,31817961,33182
"6731","ENSG00000125618","ENSG00000125618","PAX8","2",113215997,113278921,62924
"6732","ENSG00000198807","ENSG00000198807","PAX9","14",36657568,36679362,21794
"6733","ENSG00000159086","ENSG00000159086","PAXBP1","21",32733899,32771792,37893
"6734","ENSG00000157212","ENSG00000157212","PAXIP1","7",154943687,155003124,59437
"6735","ENSG00000168078","ENSG00000168078","PBK","8",27809624,27838082,28458
"6736","ENSG00000108187","ENSG00000108187","PBLD","10",68282660,68333049,50389
"6737","ENSG00000163939","ENSG00000163939","PBRM1","3",52545352,52685917,140565
"6738","ENSG00000185630","ENSG00000185630","PBX1","1",164555584,164899296,343712
"6739","ENSG00000237344","ENSG00000237344","PBX2","HSCHR6_MHC_COX_CTG1",3623085,3628535,5450
"6740","ENSG00000167081","ENSG00000167081","PBX3","9",125747345,125967377,220032
"6741","ENSG00000163346","ENSG00000163346","PBXIP1","1",154944076,154956123,12047
"6742","ENSG00000173599","ENSG00000173599","PC","11",66848417,66958386,109969
"6743","ENSG00000166228","ENSG00000166228","PCBD1","10",70882280,70888565,6285
"6744","ENSG00000169564","ENSG00000169564","PCBP1","2",70087477,70089203,1726
"6745","ENSG00000197111","ENSG00000197111","PCBP2","12",53452102,53481162,29060
"6746","ENSG00000183570","ENSG00000183570","PCBP3","21",45643694,45942454,298760
"6747","ENSG00000090097","ENSG00000090097","PCBP4","3",51957454,51974016,16562
"6748","ENSG00000175198","ENSG00000175198","PCCA","13",100089015,100530437,441422
"6749","ENSG00000114054","ENSG00000114054","PCCB","3",136250340,136337896,87556
"6750","ENSG00000156453","ENSG00000156453","PCDH1","5",141853090,141879246,26156
"6751","ENSG00000102290","ENSG00000102290","PCDH11X","X",91779261,92623230,843969
"6752","ENSG00000099715","ENSG00000099715","PCDH11Y","Y",5000226,5742224,741998
"6753","ENSG00000113555","ENSG00000113555","PCDH12","5",141943581,141969741,26160
"6754","ENSG00000118946","ENSG00000118946","PCDH17","13",57631744,57729311,97567
"6755","ENSG00000169851","ENSG00000169851","PCDH7","4",30720369,31146805,426436
"6756","ENSG00000136099","ENSG00000136099","PCDH8","13",52842889,52848641,5752
"6757","ENSG00000184226","ENSG00000184226","PCDH9","13",66302834,67230445,927611
"6758","ENSG00000204970","ENSG00000204970","PCDHA1","5",140786136,141012347,226211
"6759","ENSG00000250120","ENSG00000250120","PCDHA10","5",140855883,141012347,156464
"6760","ENSG00000249158","ENSG00000249158","PCDHA11","5",140868183,141012347,144164
"6761","ENSG00000251664","ENSG00000251664","PCDHA12","5",140875302,141012347,137045
"6762","ENSG00000239389","ENSG00000239389","PCDHA13","5",140882124,141012347,130223
"6763","ENSG00000204969","ENSG00000204969","PCDHA2","5",140794852,141012347,217495
"6764","ENSG00000255408","ENSG00000255408","PCDHA3","5",140801028,141012347,211319
"6765","ENSG00000204967","ENSG00000204967","PCDHA4","5",140807037,141012347,205310
"6766","ENSG00000204965","ENSG00000204965","PCDHA5","5",140821604,141012347,190743
"6767","ENSG00000081842","ENSG00000081842","PCDHA6","5",140827958,141012347,184389
"6768","ENSG00000204963","ENSG00000204963","PCDHA7","5",140834248,141012347,178099
"6769","ENSG00000204962","ENSG00000204962","PCDHA8","5",140841187,141012347,171160
"6770","ENSG00000204961","ENSG00000204961","PCDHA9","5",140847772,141012347,164575
"6771","ENSG00000248383","ENSG00000248383","PCDHAC1","5",140926299,141012347,86048
"6772","ENSG00000243232","ENSG00000243232","PCDHAC2","5",140966470,141012347,45877
"6773","ENSG00000120328","ENSG00000120328","PCDHB12","5",141208697,141212571,3874
"6774","ENSG00000113205","ENSG00000113205","PCDHB3","5",141100473,141103827,3354
"6775","ENSG00000204956","ENSG00000204956","PCDHGA1","5",141330514,141512975,182461
"6776","ENSG00000253873","ENSG00000253873","PCDHGA11","5",141421047,141512975,91928
"6777","ENSG00000081853","ENSG00000081853","PCDHGA2","5",141338760,141512975,174215
"6778","ENSG00000262576","ENSG00000262576","PCDHGA4","5",141355021,141512975,157954
"6779","ENSG00000253485","ENSG00000253485","PCDHGA5","5",141364162,141512975,148813
"6780","ENSG00000253537","ENSG00000253537","PCDHGA7","5",141382739,141512975,130236
"6781","ENSG00000261934","ENSG00000261934","PCDHGA9","5",141402778,141512975,110197
"6782","ENSG00000254122","ENSG00000254122","PCDHGB7","5",141417645,141512975,95330
"6783","ENSG00000240184","ENSG00000240184","PCDHGC3","5",141475947,141512977,37030
"6784","ENSG00000240764","ENSG00000240764","PCDHGC5","5",141489081,141512975,23894
"6785","ENSG00000165494","ENSG00000165494","PCF11","11",83156988,83187451,30463
"6786","ENSG00000115289","ENSG00000115289","PCGF1","2",74505043,74507695,2652
"6787","ENSG00000278644","ENSG00000278644","PCGF2","HSCHR17_7_CTG4",2769216,2785136,15920
"6788","ENSG00000185619","ENSG00000185619","PCGF3","4",705748,770089,64341
"6789","ENSG00000126226","ENSG00000126226","PCID2","13",113177536,113208715,31179
"6790","ENSG00000100982","ENSG00000100982","PCIF1","20",45934683,45948023,13340
"6791","ENSG00000124253","ENSG00000124253","PCK1","20",57561080,57568121,7041
"6792","ENSG00000100889","ENSG00000100889","PCK2","14",24094053,24110598,16545
"6793","ENSG00000186472","ENSG00000186472","PCLO","7",82754012,83162930,408918
"6794","ENSG00000078674","ENSG00000078674","PCM1","8",17922842,18029948,107106
"6795","ENSG00000120265","ENSG00000120265","PCMT1","6",149749444,149811420,61976
"6796","ENSG00000280663","ENSG00000280663","PCMTD2","HSCHR20_1_CTG3",164332,183433,19101
"6797","ENSG00000132646","ENSG00000132646","PCNA","20",5114953,5126626,11673
"6798","ENSG00000081154","ENSG00000081154","PCNP","3",101574180,101594465,20285
"6799","ENSG00000160299","ENSG00000160299","PCNT","21",46324124,46445769,121645
"6800","ENSG00000100731","ENSG00000100731","PCNX1","14",70907405,71115382,207977
"6801","ENSG00000135749","ENSG00000135749","PCNX2","1",232983435,233295725,312290
"6802","ENSG00000126773","ENSG00000126773","PCNX4","14",60091911,60169133,77222
"6803","ENSG00000106333","ENSG00000106333","PCOLCE","7",100602363,100608175,5812
"6804","ENSG00000163710","ENSG00000163710","PCOLCE2","3",142815922,142889206,73284
"6805","ENSG00000183036","ENSG00000183036","PCP4","21",39867438,39929397,61959
"6806","ENSG00000175426","ENSG00000175426","PCSK1","5",96390333,96434143,43810
"6807","ENSG00000102109","ENSG00000102109","PCSK1N","X",48831096,48835610,4514
"6808","ENSG00000125851","ENSG00000125851","PCSK2","20",17226107,17484578,258471
"6809","ENSG00000099139","ENSG00000099139","PCSK5","9",75890644,76362975,472331
"6810","ENSG00000140479","ENSG00000140479","PCSK6","15",101289784,101525202,235418
"6811","ENSG00000160613","ENSG00000160613","PCSK7","11",117204337,117232525,28188
"6812","ENSG00000141179","ENSG00000141179","PCTP","17",55751051,55842830,91779
"6813","ENSG00000116005","ENSG00000116005","PCYOX1","2",70257386,70281185,23799
"6814","ENSG00000145882","ENSG00000145882","PCYOX1L","5",149358037,149369653,11616
"6815","ENSG00000161217","ENSG00000161217","PCYT1A","3",196214222,196287957,73735
"6816","ENSG00000102230","ENSG00000102230","PCYT1B","X",24558087,24672677,114590
"6817","ENSG00000185813","ENSG00000185813","PCYT2","17",81900958,81911432,10474
"6818","ENSG00000106244","ENSG00000106244","PDAP1","7",99392048,99408597,16549
"6819","ENSG00000276977","ENSG00000276977","PDCD1","HSCHR2_3_CTG15",61979,71006,9027
"6820","ENSG00000114209","ENSG00000114209","PDCD10","3",167683298,167734939,51641
"6821","ENSG00000148843","ENSG00000148843","PDCD11","10",103396626,103446294,49668
"6822","ENSG00000197646","ENSG00000197646","PDCD1LG2","9",5510531,5571282,60751
"6823","ENSG00000071994","ENSG00000071994","PDCD2","6",170575295,170584692,9397
"6824","ENSG00000150593","ENSG00000150593","PDCD4","10",110871795,110900006,28211
"6825","ENSG00000105185","ENSG00000105185","PDCD5","19",32581190,32587453,6263
"6826","ENSG00000249915","ENSG00000249915","PDCD6","5",271621,314974,43353
"6827","ENSG00000170248","ENSG00000170248","PDCD6IP","3",33798571,33869707,71136
"6828","ENSG00000136940","ENSG00000136940","PDCL","9",122798389,122828588,30199
"6829","ENSG00000115539","ENSG00000115539","PDCL3","2",100562993,100576739,13746
"6830","ENSG00000112541","ENSG00000112541","PDE10A","6",165327287,165988117,660830
"6831","ENSG00000128655","ENSG00000128655","PDE11A","2",177623244,178108339,485095
"6832","ENSG00000174840","ENSG00000174840","PDE12","3",57556274,57566848,10574
"6833","ENSG00000115252","ENSG00000115252","PDE1A","2",182139968,182523359,383391
"6834","ENSG00000123360","ENSG00000123360","PDE1B","12",54549601,54579239,29638
"6835","ENSG00000154678","ENSG00000154678","PDE1C","7",31751179,32428131,676952
"6836","ENSG00000186642","ENSG00000186642","PDE2A","11",72576141,72674591,98450
"6837","ENSG00000172572","ENSG00000172572","PDE3A","12",20368537,20688583,320046
"6838","ENSG00000152270","ENSG00000152270","PDE3B","11",14643804,14872044,228240
"6839","ENSG00000065989","ENSG00000065989","PDE4A","19",10416773,10469630,52857
"6840","ENSG00000184588","ENSG00000184588","PDE4B","1",65792514,66374579,582065
"6841","ENSG00000105650","ENSG00000105650","PDE4C","19",18207965,18248200,40235
"6842","ENSG00000113448","ENSG00000113448","PDE4D","5",58969038,60522120,1553082
"6843","ENSG00000178104","ENSG00000178104","PDE4DIP","1",148808140,149048286,240146
"6844","ENSG00000138735","ENSG00000138735","PDE5A","4",119494397,119628804,134407
"6845","ENSG00000132915","ENSG00000132915","PDE6A","5",149857953,149944793,86840
"6846","ENSG00000133256","ENSG00000133256","PDE6B","4",625573,670782,45209
"6847","ENSG00000095464","ENSG00000095464","PDE6C","10",93612537,93666010,53473
"6848","ENSG00000156973","ENSG00000156973","PDE6D","2",231732433,231786272,53839
"6849","ENSG00000185527","ENSG00000185527","PDE6G","17",81650459,81663112,12653
"6850","ENSG00000139053","ENSG00000139053","PDE6H","12",14973042,14981865,8823
"6851","ENSG00000171408","ENSG00000171408","PDE7B","6",135851701,136195574,343873
"6852","ENSG00000073417","ENSG00000073417","PDE8A","15",84980440,85139145,158705
"6853","ENSG00000113231","ENSG00000113231","PDE8B","5",77210449,77428256,217807
"6854","ENSG00000160191","ENSG00000160191","PDE9A","21",42653621,42775509,121888
"6855","ENSG00000258429","ENSG00000258429","PDF","16",69326913,69330588,3675
"6856","ENSG00000197461","ENSG00000197461","PDGFA","7",497258,520296,23038
"6857","ENSG00000100311","ENSG00000100311","PDGFB","22",39223359,39244982,21623
"6858","ENSG00000145431","ENSG00000145431","PDGFC","4",156760454,156971799,211345
"6859","ENSG00000170962","ENSG00000170962","PDGFD","11",103907189,104164379,257190
"6860","ENSG00000134853","ENSG00000134853","PDGFRA","4",54229280,54298245,68965
"6861","ENSG00000113721","ENSG00000113721","PDGFRB","5",150113839,150155872,42033
"6862","ENSG00000104213","ENSG00000104213","PDGFRL","8",17576433,17644071,67638
"6863","ENSG00000131828","ENSG00000131828","PDHA1","X",19343893,19361718,17825
"6864","ENSG00000168291","ENSG00000168291","PDHB","3",58427630,58433857,6227
"6865","ENSG00000110435","ENSG00000110435","PDHX","11",34915829,35020591,104762
"6866","ENSG00000185615","ENSG00000185615","PDIA2","16",283164,287215,4051
"6867","ENSG00000167004","ENSG00000167004","PDIA3","15",43746394,43773279,26885
"6868","ENSG00000155660","ENSG00000155660","PDIA4","7",149003062,149028662,25600
"6869","ENSG00000065485","ENSG00000065485","PDIA5","3",123067025,123225227,158202
"6870","ENSG00000143870","ENSG00000143870","PDIA6","2",10783391,10837977,54586
"6871","ENSG00000152256","ENSG00000152256","PDK1","2",172555373,172608669,53296
"6872","ENSG00000005882","ENSG00000005882","PDK2","17",50094737,50112152,17415
"6873","ENSG00000067992","ENSG00000067992","PDK3","X",24465244,24550466,85222
"6874","ENSG00000004799","ENSG00000004799","PDK4","7",95583499,95596516,13017
"6875","ENSG00000107438","ENSG00000107438","PDLIM1","10",95237572,95291012,53440
"6876","ENSG00000120913","ENSG00000120913","PDLIM2","8",22578279,22598025,19746
"6877","ENSG00000154553","ENSG00000154553","PDLIM3","4",185500660,185535507,34847
"6878","ENSG00000131435","ENSG00000131435","PDLIM4","5",132257696,132273454,15758
"6879","ENSG00000163110","ENSG00000163110","PDLIM5","4",94451857,94668227,216370
"6880","ENSG00000196923","ENSG00000196923","PDLIM7","5",177483394,177497606,14212
"6881","ENSG00000164951","ENSG00000164951","PDP1","8",93857807,93926068,68261
"6882","ENSG00000140992","ENSG00000140992","PDPK1","16",2537979,2603188,65209
"6883","ENSG00000162493","ENSG00000162493","PDPN","1",13583465,13617957,34492
"6884","ENSG00000090857","ENSG00000090857","PDPR","16",70114332,70162537,48205
"6885","ENSG00000121892","ENSG00000121892","PDS5A","4",39822863,39977956,155093
"6886","ENSG00000083642","ENSG00000083642","PDS5B","13",32586452,32778019,191567
"6887","ENSG00000148459","ENSG00000148459","PDSS1","10",26697701,26746798,49097
"6888","ENSG00000164494","ENSG00000164494","PDSS2","6",107152562,107459564,307002
"6889","ENSG00000139515","ENSG00000139515","PDX1","13",27920000,27926313,6313
"6890","ENSG00000275498","ENSG00000275498","PDXDC1","HSCHR16_1_CTG1",631355,695082,63727
"6891","ENSG00000160209","ENSG00000160209","PDXK","21",43719094,43762307,43213
"6892","ENSG00000101327","ENSG00000101327","PDYN","20",1978757,1994285,15528
"6893","ENSG00000133401","ENSG00000133401","PDZD2","5",31639131,32110932,471801
"6894","ENSG00000186862","ENSG00000186862","PDZD7","10",101007679,101032295,24616
"6895","ENSG00000165650","ENSG00000165650","PDZD8","10",117277274,117375440,98166
"6896","ENSG00000174827","ENSG00000174827","PDZK1","1",145670852,145708148,37296
"6897","ENSG00000162366","ENSG00000162366","PDZK1IP1","1",47183582,47191044,7462
"6898","ENSG00000121440","ENSG00000121440","PDZRN3","3",73382431,73624941,242510
"6899","ENSG00000165966","ENSG00000165966","PDZRN4","12",41188320,41574745,386425
"6900","ENSG00000162734","ENSG00000162734","PEA15","1",160205380,160215376,9996
"6901","ENSG00000173517","ENSG00000173517","PEAK1","15",77100656,77420144,319488
"6902","ENSG00000089220","ENSG00000089220","PEBP1","12",118136124,118145584,9460
"6903","ENSG00000261371","ENSG00000261371","PECAM1","17",64319415,64413776,94361
"6904","ENSG00000115425","ENSG00000115425","PECR","2",215996329,216082955,86626
"6905","ENSG00000162517","ENSG00000162517","PEF1","1",31629866,31644896,15030
"6906","ENSG00000242265","ENSG00000242265","PEG10","7",94656325,94669695,13370
"6907","ENSG00000198300","ENSG00000198300","PEG3","19",56810077,56840728,30651
"6908","ENSG00000197329","ENSG00000197329","PELI1","2",64092652,64144420,51768
"6909","ENSG00000139946","ENSG00000139946","PELI2","14",56117814,56301524,183710
"6910","ENSG00000152684","ENSG00000152684","PELO","5",52787916,52804044,16128
"6911","ENSG00000141456","ENSG00000141456","PELP1","17",4669774,4704337,34563
"6912","ENSG00000133027","ENSG00000133027","PEMT","17",17505563,17591708,86145
"6913","ENSG00000181195","ENSG00000181195","PENK","8",56436674,56446671,9997
"6914","ENSG00000124299","ENSG00000124299","PEPD","19",33386950,33521823,134873
"6915","ENSG00000179094","ENSG00000179094","PER1","17",8140472,8156506,16034
"6916","ENSG00000132326","ENSG00000132326","PER2","2",238244044,238290102,46058
"6917","ENSG00000049246","ENSG00000049246","PER3","1",7784291,7845177,60886
"6918","ENSG00000112378","ENSG00000112378","PERP","6",138088505,138107419,18914
"6919","ENSG00000100029","ENSG00000100029","PES1","22",30576625,30607083,30458
"6920","ENSG00000127980","ENSG00000127980","PEX1","7",92487020,92528520,41500
"6921","ENSG00000157911","ENSG00000157911","PEX10","1",2403964,2413797,9833
"6922","ENSG00000166821","ENSG00000166821","PEX11A","15",89677764,89690783,13019
"6923","ENSG00000131779","ENSG00000131779","PEX11B","1",145911350,145918717,7367
"6924","ENSG00000108733","ENSG00000108733","PEX12","17",35574795,35578863,4068
"6925","ENSG00000162928","ENSG00000162928","PEX13","2",61017225,61051990,34765
"6926","ENSG00000142655","ENSG00000142655","PEX14","1",10472288,10630758,158470
"6927","ENSG00000121680","ENSG00000121680","PEX16","11",45909663,45918812,9149
"6928","ENSG00000162735","ENSG00000162735","PEX19","1",160276807,160286348,9541
"6929","ENSG00000164751","ENSG00000164751","PEX2","8",76980258,77001044,20786
"6930","ENSG00000215193","ENSG00000215193","PEX26","22",18077923,18105396,27473
"6931","ENSG00000034693","ENSG00000034693","PEX3","6",143450805,143490616,39811
"6932","ENSG00000139197","ENSG00000139197","PEX5","12",7188685,7218574,29889
"6933","ENSG00000114757","ENSG00000114757","PEX5L","3",179794958,180037053,242095
"6934","ENSG00000124587","ENSG00000124587","PEX6","6",42963865,42979181,15316
"6935","ENSG00000112357","ENSG00000112357","PEX7","6",136822564,136913934,91370
"6936","ENSG00000163737","ENSG00000163737","PF4","4",73980811,73982027,1216
"6937","ENSG00000109272","ENSG00000109272","PF4V1","4",73853296,73854483,1187
"6938","ENSG00000178921","ENSG00000178921","PFAS","17",8247618,8270491,22873
"6939","ENSG00000113068","ENSG00000113068","PFDN1","5",140245035,140303113,58078
"6940","ENSG00000143256","ENSG00000143256","PFDN2","1",161100556,161118055,17499
"6941","ENSG00000101132","ENSG00000101132","PFDN4","20",54208087,54228052,19965
"6942","ENSG00000237335","ENSG00000237335","PFDN6","HSCHR6_MHC_COX_CTG1",4700787,4709886,9099
"6943","ENSG00000158571","ENSG00000158571","PFKFB1","X",54932961,54998534,65573
"6944","ENSG00000123836","ENSG00000123836","PFKFB2","1",207034366,207081024,46658
"6945","ENSG00000170525","ENSG00000170525","PFKFB3","10",6144934,6254644,109710
"6946","ENSG00000114268","ENSG00000114268","PFKFB4","3",48517684,48562015,44331
"6947","ENSG00000141959","ENSG00000141959","PFKL","21",44300051,44327376,27325
"6948","ENSG00000152556","ENSG00000152556","PFKM","12",48105139,48146404,41265
"6949","ENSG00000067057","ENSG00000067057","PFKP","10",3066333,3137718,71385
"6950","ENSG00000070087","ENSG00000070087","PFN2","3",149964904,150050788,85884
"6951","ENSG00000256713","ENSG00000256713","PGA5","11",61241175,61251444,10269
"6952","ENSG00000171314","ENSG00000171314","PGAM1","10",97426191,97433444,7253
"6953","ENSG00000164708","ENSG00000164708","PGAM2","7",44062727,44065567,2840
"6954","ENSG00000197121","ENSG00000197121","PGAP1","2",196833004,196927796,94792
"6955","ENSG00000148985","ENSG00000148985","PGAP2","11",3797724,3826371,28647
"6956","ENSG00000161395","ENSG00000161395","PGAP3","17",39671122,39696797,25675
"6957","ENSG00000096088","ENSG00000096088","PGC","6",41736711,41754109,17398
"6958","ENSG00000142657","ENSG00000142657","PGD","1",10398592,10420511,21919
"6959","ENSG00000119630","ENSG00000119630","PGF","14",74941834,74955626,13792
"6960","ENSG00000164219","ENSG00000164219","PGGT1B","5",115204012,115262877,58865
"6961","ENSG00000102144","ENSG00000102144","PGK1","X",77910739,78129295,218556
"6962","ENSG00000130313","ENSG00000130313","PGLS","19",17511636,17521288,9652
"6963","ENSG00000008438","ENSG00000008438","PGLYRP1","19",46019153,46023053,3900
"6964","ENSG00000163218","ENSG00000163218","PGLYRP4","1",153330120,153348841,18721
"6965","ENSG00000079739","ENSG00000079739","PGM1","1",63593411,63660245,66834
"6966","ENSG00000013375","ENSG00000013375","PGM3","6",83147324,83193936,46612
"6967","ENSG00000154330","ENSG00000154330","PGM5","9",68328308,68531061,202753
"6968","ENSG00000130517","ENSG00000130517","PGPEP1","19",18340598,18369950,29352
"6969","ENSG00000082175","ENSG00000082175","PGR","11",101029624,101129813,100189
"6970","ENSG00000101856","ENSG00000101856","PGRMC1","X",119236245,119244466,8221
"6971","ENSG00000164040","ENSG00000164040","PGRMC2","4",128269237,128288829,19592
"6972","ENSG00000087157","ENSG00000087157","PGS1","17",78378649,78425114,46465
"6973","ENSG00000112419","ENSG00000112419","PHACTR2","6",143536845,143831185,294340
"6974","ENSG00000204138","ENSG00000204138","PHACTR4","1",28369582,28500364,130782
"6975","ENSG00000215021","ENSG00000215021","PHB2","12",6965327,6970780,5453
"6976","ENSG00000111752","ENSG00000111752","PHC1","12",8913896,8941467,27571
"6977","ENSG00000134686","ENSG00000134686","PHC2","1",33323623,33431095,107472
"6978","ENSG00000173889","ENSG00000173889","PHC3","3",170086732,170181749,95017
"6979","ENSG00000225553","ENSG00000225553","PHF1","HSCHR6_MHC_SSTO_CTG1",4859097,4865178,6081
"6980","ENSG00000130024","ENSG00000130024","PHF10","6",169703902,169725566,21664
"6981","ENSG00000136147","ENSG00000136147","PHF11","13",49495610,49528981,33371
"6982","ENSG00000106443","ENSG00000106443","PHF14","7",10973336,11169623,196287
"6983","ENSG00000197724","ENSG00000197724","PHF2","9",93576584,93679587,103003
"6984","ENSG00000025293","ENSG00000025293","PHF20","20",35771974,35950370,178396
"6985","ENSG00000129292","ENSG00000129292","PHF20L1","8",132775358,132848807,73449
"6986","ENSG00000135365","ENSG00000135365","PHF21A","11",45929319,46121454,192135
"6987","ENSG00000122733","ENSG00000122733","PHF24","9",34957608,34982544,24936
"6988","ENSG00000118482","ENSG00000118482","PHF3","6",63635802,63779336,143534
"6989","ENSG00000010318","ENSG00000010318","PHF7","3",52410660,52423641,12981
"6990","ENSG00000092621","ENSG00000092621","PHGDH","1",119648411,119744218,95807
"6991","ENSG00000146247","ENSG00000146247","PHIP","6",78934419,79078287,143868
"6992","ENSG00000067177","ENSG00000067177","PHKA1","X",72578814,72714319,135505
"6993","ENSG00000044446","ENSG00000044446","PHKA2","X",18892298,18984114,91816
"6994","ENSG00000102893","ENSG00000102893","PHKB","16",47461123,47701523,240400
"6995","ENSG00000164776","ENSG00000164776","PHKG1","7",56080283,56092996,12713
"6996","ENSG00000156873","ENSG00000156873","PHKG2","16",30748293,30761176,12883
"6997","ENSG00000139289","ENSG00000139289","PHLDA1","12",76025447,76031776,6329
"6998","ENSG00000274538","ENSG00000274538","PHLDA2","HSCHR11_1_CTG7",160388,161570,1182
"6999","ENSG00000174307","ENSG00000174307","PHLDA3","1",201464278,201469237,4959
"7000","ENSG00000019144","ENSG00000019144","PHLDB1","11",118606440,118658031,51591
"7001","ENSG00000081913","ENSG00000081913","PHLPP1","18",62715541,62980433,264892
"7002","ENSG00000040199","ENSG00000040199","PHLPP2","16",71637835,71724701,86866
"7003","ENSG00000165462","ENSG00000165462","PHOX2A","11",72239077,72245664,6587
"7004","ENSG00000116793","ENSG00000116793","PHTF1","1",113696831,113759489,62658
"7005","ENSG00000006576","ENSG00000006576","PHTF2","7",77798773,77957503,158730
"7006","ENSG00000107537","ENSG00000107537","PHYH","10",13277796,13302412,24616
"7007","ENSG00000168490","ENSG00000168490","PHYHIP","8",22219703,22232101,12398
"7008","ENSG00000137558","ENSG00000137558","PI15","8",74824534,74855029,30495
"7009","ENSG00000124102","ENSG00000124102","PI3","20",45174902,45176544,1642
"7010","ENSG00000155252","ENSG00000155252","PI4K2A","10",97640671,97676434,35763
"7011","ENSG00000241973","ENSG00000241973","PI4KA","22",20707691,20859417,151726
"7012","ENSG00000143393","ENSG00000143393","PI4KB","1",151291797,151327715,35918
"7013","ENSG00000033800","ENSG00000033800","PIAS1","15",68054309,68198603,144294
"7014","ENSG00000078043","ENSG00000078043","PIAS2","18",46803218,46920160,116942
"7015","ENSG00000131788","ENSG00000131788","PIAS3","1",145848522,145859836,11314
"7016","ENSG00000105229","ENSG00000105229","PIAS4","19",4007736,4039386,31650
"7017","ENSG00000083535","ENSG00000083535","PIBF1","13",72782133,73016461,234328
"7018","ENSG00000073921","ENSG00000073921","PICALM","11",85957175,86069882,112707
"7019","ENSG00000100151","ENSG00000100151","PICK1","22",38056311,38075701,19390
"7020","ENSG00000153823","ENSG00000153823","PID1","2",228850526,229271287,420761
"7021","ENSG00000177595","ENSG00000177595","PIDD1","11",799179,809753,10574
"7022","ENSG00000154864","ENSG00000154864","PIEZO2","18",10666483,11149569,483086
"7023","ENSG00000165195","ENSG00000165195","PIGA","X",15319452,15335554,16102
"7024","ENSG00000069943","ENSG00000069943","PIGB","15",55318960,55355648,36688
"7025","ENSG00000135845","ENSG00000135845","PIGC","1",172370189,172444086,73897
"7026","ENSG00000151665","ENSG00000151665","PIGF","2",46580937,46617055,36118
"7027","ENSG00000174227","ENSG00000174227","PIGG","4",499210,540200,40990
"7028","ENSG00000100564","ENSG00000100564","PIGH","14",67581955,67600286,18331
"7029","ENSG00000142892","ENSG00000142892","PIGK","1",77088989,77219430,130441
"7030","ENSG00000108474","ENSG00000108474","PIGL","17",16217191,16351797,134606
"7031","ENSG00000197563","ENSG00000197563","PIGN","18",61905255,62187118,281863
"7032","ENSG00000165282","ENSG00000165282","PIGO","9",35087237,35096619,9382
"7033","ENSG00000185808","ENSG00000185808","PIGP","21",37062846,37073170,10324
"7034","ENSG00000007541","ENSG00000007541","PIGQ","16",566995,584109,17114
"7035","ENSG00000162896","ENSG00000162896","PIGR","1",206928522,206946466,17944
"7036","ENSG00000124155","ENSG00000124155","PIGT","20",45416084,45456934,40850
"7037","ENSG00000060642","ENSG00000060642","PIGV","1",26787054,26800659,13605
"7038","ENSG00000119227","ENSG00000119227","PIGZ","3",196946356,196969060,22704
"7039","ENSG00000104872","ENSG00000104872","PIH1D1","19",49446298,49453497,7199
"7040","ENSG00000011405","ENSG00000011405","PIK3C2A","11",17077730,17207986,130256
"7041","ENSG00000133056","ENSG00000133056","PIK3C2B","1",204422628,204494805,72177
"7042","ENSG00000139144","ENSG00000139144","PIK3C2G","12",18242961,18648416,405455
"7043","ENSG00000078142","ENSG00000078142","PIK3C3","18",41955234,42087830,132596
"7044","ENSG00000121879","ENSG00000121879","PIK3CA","3",179148114,179240093,91979
"7045","ENSG00000051382","ENSG00000051382","PIK3CB","3",138652698,138834928,182230
"7046","ENSG00000171608","ENSG00000171608","PIK3CD","1",9629889,9729114,99225
"7047","ENSG00000105851","ENSG00000105851","PIK3CG","7",106865278,106908980,43702
"7048","ENSG00000100100","ENSG00000100100","PIK3IP1","22",31281594,31292534,10940
"7049","ENSG00000145675","ENSG00000145675","PIK3R1","5",68215740,68301821,86081
"7050","ENSG00000105647","ENSG00000105647","PIK3R2","19",18153163,18170532,17369
"7051","ENSG00000117461","ENSG00000117461","PIK3R3","1",46040140,46133036,92896
"7052","ENSG00000196455","ENSG00000196455","PIK3R4","3",130678934,130746829,67895
"7053","ENSG00000141506","ENSG00000141506","PIK3R5","17",8878911,8965712,86801
"7054","ENSG00000115020","ENSG00000115020","PIKFYVE","2",208266255,208358746,92491
"7055","ENSG00000085514","ENSG00000085514","PILRA","7",100367530,100400096,32566
"7056","ENSG00000121716","ENSG00000121716","PILRB","7",100352176,100367831,15655
"7057","ENSG00000137193","ENSG00000137193","PIM1","6",37170152,37175428,5276
"7058","ENSG00000102096","ENSG00000102096","PIM2","X",48913182,48919024,5842
"7059","ENSG00000127445","ENSG00000127445","PIN1","19",9835257,9849689,14432
"7060","ENSG00000102309","ENSG00000102309","PIN4","X",72181353,72302926,121573
"7061","ENSG00000158828","ENSG00000158828","PINK1","1",20633458,20651511,18053
"7062","ENSG00000234465","ENSG00000234465","PINLYP","19",43575801,43583964,8163
"7063","ENSG00000159763","ENSG00000159763","PIP","7",143132077,143139739,7662
"7064","ENSG00000150867","ENSG00000150867","PIP4K2A","10",22534854,22714578,179724
"7065","ENSG00000277292","ENSG00000277292","PIP4K2B","HSCHR17_7_CTG4",2801008,2835445,34437
"7066","ENSG00000166908","ENSG00000166908","PIP4K2C","12",57591174,57603418,12244
"7067","ENSG00000143398","ENSG00000143398","PIP5K1A","1",151197949,151249536,51587
"7068","ENSG00000107242","ENSG00000107242","PIP5K1B","9",68705240,69009176,303936
"7069","ENSG00000186111","ENSG00000186111","PIP5K1C","19",3630183,3700468,70285
"7070","ENSG00000179761","ENSG00000179761","PIPOX","17",28950513,29057216,106703
"7071","ENSG00000087842","ENSG00000087842","PIR","X",15384799,15493564,108765
"7072","ENSG00000241878","ENSG00000241878","PISD","22",31618491,31662221,43730
"7073","ENSG00000174238","ENSG00000174238","PITPNA","17",1517718,1562792,45074
"7074","ENSG00000180957","ENSG00000180957","PITPNB","22",27851669,27920134,68465
"7075","ENSG00000154217","ENSG00000154217","PITPNC1","17",67377281,67697256,319975
"7076","ENSG00000110697","ENSG00000110697","PITPNM1","11",67491768,67506263,14495
"7077","ENSG00000091622","ENSG00000091622","PITPNM3","17",6451263,6556555,105292
"7078","ENSG00000069011","ENSG00000069011","PITX1","5",135027734,135034813,7079
"7079","ENSG00000164093","ENSG00000164093","PITX2","4",110617423,110642123,24700
"7080","ENSG00000107859","ENSG00000107859","PITX3","10",102230189,102241512,11323
"7081","ENSG00000197181","ENSG00000197181","PIWIL2","8",22275316,22357568,82252
"7082","ENSG00000181191","ENSG00000181191","PJA1","X",69160851,69165521,4670
"7083","ENSG00000198961","ENSG00000198961","PJA2","5",109334713,109409974,75261
"7084","ENSG00000008710","ENSG00000008710","PKD1","16",2088708,2135898,47190
"7085","ENSG00000118762","ENSG00000118762","PKD2","4",88007635,88077777,70142
"7086","ENSG00000078795","ENSG00000078795","PKD2L2","5",137887968,137942747,54779
"7087","ENSG00000130943","ENSG00000130943","PKDREJ","22",46255663,46263343,7680
"7088","ENSG00000171033","ENSG00000171033","PKIA","8",78516340,78605267,88927
"7089","ENSG00000168734","ENSG00000168734","PKIG","20",44531785,44624247,92462
"7090","ENSG00000262785","ENSG00000262785","PKLR","HSCHR1_2_CTG31",94862,106457,11595
"7091","ENSG00000067225","ENSG00000067225","PKM","15",72199029,72231819,32790
"7092","ENSG00000127564","ENSG00000127564","PKMYT1","16",2968024,2980479,12455
"7093","ENSG00000123143","ENSG00000123143","PKN1","19",14433053,14471867,38814
"7094","ENSG00000065243","ENSG00000065243","PKN2","1",88684222,88836255,152033
"7095","ENSG00000160199","ENSG00000160199","PKNOX1","21",42974510,43033931,59421
"7096","ENSG00000165495","ENSG00000165495","PKNOX2","11",125164687,125433389,268702
"7097","ENSG00000081277","ENSG00000081277","PKP1","1",201283452,201332993,49541
"7098","ENSG00000057294","ENSG00000057294","PKP2","12",32790745,32896798,106053
"7099","ENSG00000184363","ENSG00000184363","PKP3","11",392614,404908,12294
"7100","ENSG00000144283","ENSG00000144283","PKP4","2",158456952,158682879,225927
"7101","ENSG00000144837","ENSG00000144837","PLA1A","3",119597875,119629811,31936
"7102","ENSG00000276870","ENSG00000276870","PLA2G10","HSCHR16_1_CTG1",245404,267531,22127
"7103","ENSG00000123739","ENSG00000123739","PLA2G12A","4",109709989,109730070,20081
"7104","ENSG00000103066","ENSG00000103066","PLA2G15","16",68245304,68261058,15754
"7105","ENSG00000170890","ENSG00000170890","PLA2G1B","12",120322115,120327779,5664
"7106","ENSG00000188257","ENSG00000188257","PLA2G2A","1",19975431,19980416,4985
"7107","ENSG00000117215","ENSG00000117215","PLA2G2D","1",20111939,20119566,7627
"7108","ENSG00000158786","ENSG00000158786","PLA2G2F","1",20139323,20150381,11058
"7109","ENSG00000100078","ENSG00000100078","PLA2G3","22",31134807,31140508,5701
"7110","ENSG00000116711","ENSG00000116711","PLA2G4A","1",186828949,186988981,160032
"7111","ENSG00000105499","ENSG00000105499","PLA2G4C","19",48047843,48110817,62974
"7112","ENSG00000127472","ENSG00000127472","PLA2G5","1",20028179,20091911,63732
"7113","ENSG00000184381","ENSG00000184381","PLA2G6","22",38111495,38214778,103283
"7114","ENSG00000146070","ENSG00000146070","PLA2G7","6",46704201,46735693,31492
"7115","ENSG00000153246","ENSG00000153246","PLA2R1","2",159932006,160062615,130609
"7116","ENSG00000137055","ENSG00000137055","PLAA","9",26903372,26947242,43870
"7117","ENSG00000170965","ENSG00000170965","PLAC1","X",134565838,134764322,198484
"7118","ENSG00000145287","ENSG00000145287","PLAC8","4",83090048,83137075,47027
"7119","ENSG00000181690","ENSG00000181690","PLAG1","8",56160909,56211324,50415
"7120","ENSG00000118495","ENSG00000118495","PLAGL1","6",143940300,144064599,124299
"7121","ENSG00000126003","ENSG00000126003","PLAGL2","20",32192504,32207743,15239
"7122","ENSG00000104368","ENSG00000104368","PLAT","8",42174718,42207709,32991
"7123","ENSG00000122861","ENSG00000122861","PLAU","10",73909177,73917496,8319
"7124","ENSG00000011422","ENSG00000011422","PLAUR","19",43646095,43670547,24452
"7125","ENSG00000121316","ENSG00000121316","PLBD1","12",14503661,14567883,64222
"7126","ENSG00000182621","ENSG00000182621","PLCB1","20",8077251,8968360,891109
"7127","ENSG00000137841","ENSG00000137841","PLCB2","15",40278176,40307935,29759
"7128","ENSG00000149782","ENSG00000149782","PLCB3","11",64251530,64269150,17620
"7129","ENSG00000101333","ENSG00000101333","PLCB4","20",9067825,9504593,436768
"7130","ENSG00000187091","ENSG00000187091","PLCD1","3",38007496,38029642,22146
"7131","ENSG00000138193","ENSG00000138193","PLCE1","10",93993931,94332823,338892
"7132","ENSG00000124181","ENSG00000124181","PLCG1","20",41136960,41196801,59841
"7133","ENSG00000197943","ENSG00000197943","PLCG2","16",81779279,81962685,183406
"7134","ENSG00000114805","ENSG00000114805","PLCH1","3",155375580,155745071,369491
"7135","ENSG00000276429","ENSG00000276429","PLCH2","HSCHR1_1_CTG3",18649,56720,38071
"7136","ENSG00000115896","ENSG00000115896","PLCL1","2",197804593,198572581,767988
"7137","ENSG00000154822","ENSG00000154822","PLCL2","3",16802651,17090604,287953
"7138","ENSG00000182378","ENSG00000182378","PLCXD1","X",276322,303356,27034
"7139","ENSG00000075651","ENSG00000075651","PLD1","3",171600404,171810950,210546
"7140","ENSG00000129219","ENSG00000129219","PLD2","17",4807152,4823434,16282
"7141","ENSG00000105223","ENSG00000105223","PLD3","19",40348456,40389472,41016
"7142","ENSG00000178209","ENSG00000178209","PLEC","8",143915153,143976734,61581
"7143","ENSG00000115956","ENSG00000115956","PLEK","2",68365282,68397453,32171
"7144","ENSG00000100558","ENSG00000100558","PLEK2","14",67386984,67412167,25183
"7145","ENSG00000107679","ENSG00000107679","PLEKHA1","10",122374696,122432354,57658
"7146","ENSG00000105559","ENSG00000105559","PLEKHA4","19",48837092,48868617,31525
"7147","ENSG00000052126","ENSG00000052126","PLEKHA5","12",19129669,19376400,246731
"7148","ENSG00000143850","ENSG00000143850","PLEKHA6","1",204218853,204378214,159361
"7149","ENSG00000134297","ENSG00000134297","PLEKHA8P1","12",45173190,45174713,1523
"7150","ENSG00000021300","ENSG00000021300","PLEKHB1","11",73646178,73662819,16641
"7151","ENSG00000115762","ENSG00000115762","PLEKHB2","2",131104847,131353709,248862
"7152","ENSG00000166289","ENSG00000166289","PLEKHF1","19",29665459,29675477,10018
"7153","ENSG00000175895","ENSG00000175895","PLEKHF2","8",95115642,95156698,41056
"7154","ENSG00000126822","ENSG00000126822","PLEKHG3","14",64704102,64750249,46147
"7155","ENSG00000008323","ENSG00000008323","PLEKHG6","12",6310436,6328506,18070
"7156","ENSG00000068137","ENSG00000068137","PLEKHH3","17",42667914,42676994,9080
"7157","ENSG00000104886","ENSG00000104886","PLEKHJ1","19",2230084,2237704,7620
"7158","ENSG00000277111","ENSG00000277111","PLEKHM1","HSCHR17_1_CTG5",126335,181190,54855
"7159","ENSG00000116786","ENSG00000116786","PLEKHM2","1",15684320,15734769,50449
"7160","ENSG00000023902","ENSG00000023902","PLEKHO1","1",150149183,150164720,15537
"7161","ENSG00000241839","ENSG00000241839","PLEKHO2","15",64841883,64868002,26119
"7162","ENSG00000148735","ENSG00000148735","PLEKHS1","10",113751262,113783429,32167
"7163","ENSG00000122194","ENSG00000122194","PLG","6",160702194,160754097,51903
"7164","ENSG00000125551","ENSG00000125551","PLGLB2","2",87748087,87759476,11389
"7165","ENSG00000107020","ENSG00000107020","PLGRKT","9",5357971,5437925,79954
"7166","ENSG00000166819","ENSG00000166819","PLIN1","15",89664367,89679427,15060
"7167","ENSG00000147872","ENSG00000147872","PLIN2","9",19108375,19149290,40915
"7168","ENSG00000105355","ENSG00000105355","PLIN3","19",4838341,4867694,29353
"7169","ENSG00000166851","ENSG00000166851","PLK1","16",23677656,23690367,12711
"7170","ENSG00000145632","ENSG00000145632","PLK2","5",58453982,58460139,6157
"7171","ENSG00000173846","ENSG00000173846","PLK3","1",44800377,44805990,5613
"7172","ENSG00000142731","ENSG00000142731","PLK4","4",127880893,127899224,18331
"7173","ENSG00000102934","ENSG00000102934","PLLP","16",57248547,57284672,36125
"7174","ENSG00000198523","ENSG00000198523","PLN","6",118548296,118561716,13420
"7175","ENSG00000083444","ENSG00000083444","PLOD1","1",11934205,11975538,41333
"7176","ENSG00000152952","ENSG00000152952","PLOD2","3",146035139,146163725,128586
"7177","ENSG00000106397","ENSG00000106397","PLOD3","7",101205977,101218420,12443
"7178","ENSG00000123560","ENSG00000123560","PLP1","X",103773718,103792619,18901
"7179","ENSG00000102007","ENSG00000102007","PLP2","X",49171898,49175235,3337
"7180","ENSG00000067113","ENSG00000067113","PLPP1","5",55424854,55534969,110115
"7181","ENSG00000141934","ENSG00000141934","PLPP2","19",281040,291403,10363
"7182","ENSG00000162407","ENSG00000162407","PLPP3","1",56494761,56645301,150540
"7183","ENSG00000276539","ENSG00000276539","PLPPR1","HSCHR9_1_CTG5",79912,376338,296426
"7184","ENSG00000105520","ENSG00000105520","PLPPR2","19",11355386,11365698,10312
"7185","ENSG00000129951","ENSG00000129951","PLPPR3","19",812488,821955,9467
"7186","ENSG00000117600","ENSG00000117600","PLPPR4","1",99264292,99309590,45298
"7187","ENSG00000120756","ENSG00000120756","PLS1","3",142596393,142713664,117271
"7188","ENSG00000102024","ENSG00000102024","PLS3","X",115561174,115650861,89687
"7189","ENSG00000188313","ENSG00000188313","PLSCR1","3",146515180,146544856,29676
"7190","ENSG00000114698","ENSG00000114698","PLSCR4","3",146192335,146251179,58844
"7191","ENSG00000100979","ENSG00000100979","PLTP","20",45898621,45912155,13534
"7192","ENSG00000130300","ENSG00000130300","PLVAP","19",17351450,17377342,25892
"7193","ENSG00000161381","ENSG00000161381","PLXDC1","17",39063313,39154394,91081
"7194","ENSG00000120594","ENSG00000120594","PLXDC2","10",19816239,20289856,473617
"7195","ENSG00000114554","ENSG00000114554","PLXNA1","3",126982693,127037389,54696
"7196","ENSG00000076356","ENSG00000076356","PLXNA2","1",208022242,208244384,222142
"7197","ENSG00000130827","ENSG00000130827","PLXNA3","X",154458281,154477779,19498
"7198","ENSG00000164050","ENSG00000164050","PLXNB1","3",48403854,48430086,26232
"7199","ENSG00000196576","ENSG00000196576","PLXNB2","22",50274979,50307646,32667
"7200","ENSG00000198753","ENSG00000198753","PLXNB3","X",153764196,153779346,15150
"7201","ENSG00000136040","ENSG00000136040","PLXNC1","12",94148577,94307675,159098
"7202","ENSG00000004399","ENSG00000004399","PLXND1","3",129555214,129606676,51462
"7203","ENSG00000141682","ENSG00000141682","PMAIP1","18",59899996,59904305,4309
"7204","ENSG00000183395","ENSG00000183395","PMCH","12",102196459,102197833,1374
"7205","ENSG00000185664","ENSG00000185664","PMEL","12",55954105,55973317,19212
"7206","ENSG00000124225","ENSG00000124225","PMEPA1","20",57648392,57711536,63144
"7207","ENSG00000160783","ENSG00000160783","PMF1","1",156212993,156240042,27049
"7208","ENSG00000118557","ENSG00000118557","PMFBP1","16",72112157,72176878,64721
"7209","ENSG00000140464","ENSG00000140464","PML","15",73994673,74047827,53154
"7210","ENSG00000100417","ENSG00000100417","PMM1","22",41576900,41589871,12971
"7211","ENSG00000140650","ENSG00000140650","PMM2","16",8788823,8862534,73711
"7212","ENSG00000147588","ENSG00000147588","PMP2","8",81440326,81447439,7113
"7213","ENSG00000109099","ENSG00000109099","PMP22","17",15229773,15272292,42519
"7214","ENSG00000165688","ENSG00000165688","PMPCA","9",136410630,136427992,17362
"7215","ENSG00000105819","ENSG00000105819","PMPCB","7",103297407,103331818,34411
"7216","ENSG00000064933","ENSG00000064933","PMS1","2",189784085,189877629,93544
"7217","ENSG00000122512","ENSG00000122512","PMS2","7",5970925,6009130,38205
"7218","ENSG00000163344","ENSG00000163344","PMVK","1",154924740,154936719,11979
"7219","ENSG00000132424","ENSG00000132424","PNISR","6",99397629,99425331,27702
"7220","ENSG00000039650","ENSG00000039650","PNKP","19",49859882,49878351,18469
"7221","ENSG00000187021","ENSG00000187021","PNLIPRP1","10",116590385,116609175,18790
"7222","ENSG00000266200","ENSG00000266200","PNLIPRP2","10",116620953,116645143,24190
"7223","ENSG00000176903","ENSG00000176903","PNMA1","14",73711783,73714384,2601
"7224","ENSG00000240694","ENSG00000240694","PNMA2","8",26504701,26514092,9391
"7225","ENSG00000183837","ENSG00000183837","PNMA3","X",153056409,153060467,4058
"7226","ENSG00000141744","ENSG00000141744","PNMT","17",39667981,39670475,2494
"7227","ENSG00000100941","ENSG00000100941","PNN","14",39175183,39183220,8037
"7228","ENSG00000115946","ENSG00000115946","PNO1","2",68157888,68176238,18350
"7229","ENSG00000168081","ENSG00000168081","PNOC","8",28316986,28343355,26369
"7230","ENSG00000198805","ENSG00000198805","PNP","14",20461992,20477094,15102
"7231","ENSG00000177666","ENSG00000177666","PNPLA2","11",818914,825573,6659
"7232","ENSG00000100344","ENSG00000100344","PNPLA3","22",43923792,43964488,40696
"7233","ENSG00000032444","ENSG00000032444","PNPLA6","19",7534004,7561764,27760
"7234","ENSG00000108439","ENSG00000108439","PNPO","17",47941506,47949308,7802
"7235","ENSG00000146278","ENSG00000146278","PNRC1","6",89080751,89085160,4409
"7236","ENSG00000189266","ENSG00000189266","PNRC2","1",23956839,23963462,6623
"7237","ENSG00000259075","ENSG00000259075","POC1B-GALNT4","12",89519408,89526262,6854
"7238","ENSG00000132000","ENSG00000132000","PODNL1","19",13931187,13953392,22205
"7239","ENSG00000128567","ENSG00000128567","PODXL","7",131500262,131558217,57955
"7240","ENSG00000114631","ENSG00000114631","PODXL2","3",127629185,127672802,43617
"7241","ENSG00000124429","ENSG00000124429","POF1B","X",85277396,85379717,102321
"7242","ENSG00000101346","ENSG00000101346","POFUT1","20",32207855,32238658,30803
"7243","ENSG00000186866","ENSG00000186866","POFUT2","21",45263928,45287898,23970
"7244","ENSG00000143157","ENSG00000143157","POGK","1",166839447,166856359,16912
"7245","ENSG00000163389","ENSG00000163389","POGLUT1","3",119468963,119494708,25745
"7246","ENSG00000143442","ENSG00000143442","POGZ","1",151402724,151459494,56770
"7247","ENSG00000101868","ENSG00000101868","POLA1","X",24693873,24996986,303113
"7248","ENSG00000014138","ENSG00000014138","POLA2","11",65261913,65305959,44046
"7249","ENSG00000062822","ENSG00000062822","POLD1","19",50384204,50418018,33814
"7250","ENSG00000106628","ENSG00000106628","POLD2","7",44114631,44124358,9727
"7251","ENSG00000077514","ENSG00000077514","POLD3","11",74493851,74669117,175266
"7252","ENSG00000175482","ENSG00000175482","POLD4","11",67350772,67356972,6200
"7253","ENSG00000004142","ENSG00000004142","POLDIP2","17",28346633,28357527,10894
"7254","ENSG00000100227","ENSG00000100227","POLDIP3","22",42583721,42614962,31241
"7255","ENSG00000177084","ENSG00000177084","POLE","12",132623753,132687376,63623
"7256","ENSG00000100479","ENSG00000100479","POLE2","14",49643555,49688422,44867
"7257","ENSG00000148229","ENSG00000148229","POLE3","9",113407235,113410675,3440
"7258","ENSG00000140521","ENSG00000140521","POLG","15",89305198,89334861,29663
"7259","ENSG00000256525","ENSG00000256525","POLG2","17",64477785,64497054,19269
"7260","ENSG00000170734","ENSG00000170734","POLH","6",43576185,43620523,44338
"7261","ENSG00000101751","ENSG00000101751","POLI","18",54269517,54321266,51749
"7262","ENSG00000166169","ENSG00000166169","POLL","10",101578882,101588270,9388
"7263","ENSG00000122678","ENSG00000122678","POLM","7",44072062,44082530,10468
"7264","ENSG00000051341","ENSG00000051341","POLQ","3",121431431,121545988,114557
"7265","ENSG00000171453","ENSG00000171453","POLR1C","6",43509702,43562419,52717
"7266","ENSG00000186184","ENSG00000186184","POLR1D","13",27620742,27744237,123495
"7267","ENSG00000137054","ENSG00000137054","POLR1E","9",37485948,37503697,17749
"7268","ENSG00000181222","ENSG00000181222","POLR2A","17",7484366,7514616,30250
"7269","ENSG00000047315","ENSG00000047315","POLR2B","4",56977722,57031158,53436
"7270","ENSG00000102978","ENSG00000102978","POLR2C","16",57462660,57472009,9349
"7271","ENSG00000144231","ENSG00000144231","POLR2D","2",127843553,127858155,14602
"7272","ENSG00000099817","ENSG00000099817","POLR2E","19",1086574,1095380,8806
"7273","ENSG00000100142","ENSG00000100142","POLR2F","22",37952607,38041915,89308
"7274","ENSG00000168002","ENSG00000168002","POLR2G","11",62761565,62766710,5145
"7275","ENSG00000163882","ENSG00000163882","POLR2H","3",184361710,184368596,6886
"7276","ENSG00000105258","ENSG00000105258","POLR2I","19",36113709,36115213,1504
"7277","ENSG00000228049","ENSG00000228049","POLR2J2","7",102665368,102671663,6295
"7278","ENSG00000147669","ENSG00000147669","POLR2K","8",100150623,100154003,3380
"7279","ENSG00000177700","ENSG00000177700","POLR2L","11",837356,842529,5173
"7280","ENSG00000255529","ENSG00000255529","POLR2M","15",57706695,57782762,76067
"7281","ENSG00000013503","ENSG00000013503","POLR3B","12",106357748,106510198,152450
"7282","ENSG00000186141","ENSG00000186141","POLR3C","1",145824053,145844402,20349
"7283","ENSG00000168495","ENSG00000168495","POLR3D","8",22245133,22254601,9468
"7284","ENSG00000058600","ENSG00000058600","POLR3E","16",22297375,22335101,37726
"7285","ENSG00000132664","ENSG00000132664","POLR3F","20",18466878,18484648,17770
"7286","ENSG00000113356","ENSG00000113356","POLR3G","5",90471748,90514557,42809
"7287","ENSG00000161980","ENSG00000161980","POLR3K","16",46407,53608,7201
"7288","ENSG00000099821","ENSG00000099821","POLRMT","19",617221,633537,16316
"7289","ENSG00000196313","ENSG00000196313","POM121","7",72879349,72951440,72091
"7290","ENSG00000115138","ENSG00000115138","POMC","2",25160853,25168903,8050
"7291","ENSG00000085998","ENSG00000085998","POMGNT1","1",46188683,46220305,31622
"7292","ENSG00000132963","ENSG00000132963","POMP","13",28659065,28678959,19894
"7293","ENSG00000130714","ENSG00000130714","POMT1","9",131502789,131523806,21017
"7294","ENSG00000009830","ENSG00000009830","POMT2","14",77274956,77320883,45927
"7295","ENSG00000276464","ENSG00000276464","POMZP3","HSCHR7_2_CTG4_4",96821,114096,17275
"7296","ENSG00000005421","ENSG00000005421","PON1","7",95297676,95324532,26856
"7297","ENSG00000105854","ENSG00000105854","PON2","7",95404862,95435329,30467
"7298","ENSG00000105852","ENSG00000105852","PON3","7",95359872,95396375,36503
"7299","ENSG00000104356","ENSG00000104356","POP1","8",98117293,98159835,42542
"7300","ENSG00000105171","ENSG00000105171","POP4","19",29606283,29617237,10954
"7301","ENSG00000167272","ENSG00000167272","POP5","12",120578764,120581402,2638
"7302","ENSG00000172336","ENSG00000172336","POP7","7",100706121,100707486,1365
"7303","ENSG00000121577","ENSG00000121577","POPDC2","3",119636457,119665324,28867
"7304","ENSG00000132429","ENSG00000132429","POPDC3","6",105157900,105180014,22114
"7305","ENSG00000127948","ENSG00000127948","POR","7",75899200,75986855,87655
"7306","ENSG00000102312","ENSG00000102312","PORCN","X",48508959,48520814,11855
"7307","ENSG00000133110","ENSG00000133110","POSTN","13",37562583,37598844,36261
"7308","ENSG00000128513","ENSG00000128513","POT1","7",124822386,124929983,107597
"7309","ENSG00000222036","ENSG00000222036","POTEM","14",18967434,19003752,36318
"7310","ENSG00000110777","ENSG00000110777","POU2AF1","11",111352255,111455630,103375
"7311","ENSG00000143190","ENSG00000143190","POU2F1","1",167220876,167427345,206469
"7312","ENSG00000028277","ENSG00000028277","POU2F2","19",42086110,42196585,110475
"7313","ENSG00000137709","ENSG00000137709","POU2F3","11",120236640,120319945,83305
"7314","ENSG00000185668","ENSG00000185668","POU3F1","1",38043829,38046793,2964
"7315","ENSG00000196767","ENSG00000196767","POU3F4","X",83508290,83512127,3837
"7316","ENSG00000152192","ENSG00000152192","POU4F1","13",78598362,78603552,5190
"7317","ENSG00000151615","ENSG00000151615","POU4F2","4",146638893,146642474,3581
"7318","ENSG00000237582","ENSG00000237582","POU5F1","HSCHR6_MHC_SSTO_CTG1",2467753,2474125,6372
"7319","ENSG00000184271","ENSG00000184271","POU6F1","12",51186936,51218062,31126
"7320","ENSG00000106536","ENSG00000106536","POU6F2","7",38977909,39493095,515186
"7321","ENSG00000180817","ENSG00000180817","PPA1","10",70202835,70233911,31076
"7322","ENSG00000138777","ENSG00000138777","PPA2","4",105369077,105474067,104990
"7323","ENSG00000130810","ENSG00000130810","PPAN","19",10106362,10112012,5650
"7324","ENSG00000186951","ENSG00000186951","PPARA","22",46150521,46243755,93234
"7325","ENSG00000112033","ENSG00000112033","PPARD","6",35342558,35428191,85633
"7326","ENSG00000132170","ENSG00000132170","PPARG","3",12287368,12434356,146988
"7327","ENSG00000109819","ENSG00000109819","PPARGC1A","4",23755041,23904089,149048
"7328","ENSG00000128059","ENSG00000128059","PPAT","4",56393362,56435615,42253
"7329","ENSG00000163736","ENSG00000163736","PPBP","4",73986439,73988190,1751
"7330","ENSG00000138621","ENSG00000138621","PPCDC","15",75023586,75117462,93876
"7331","ENSG00000127125","ENSG00000127125","PPCS","1",42456117,42473385,17268
"7332","ENSG00000086717","ENSG00000086717","PPEF1","X",18675909,18827921,152012
"7333","ENSG00000156194","ENSG00000156194","PPEF2","4",75859864,75902571,42707
"7334","ENSG00000131626","ENSG00000131626","PPFIA1","11",70270690,70385312,114622
"7335","ENSG00000139220","ENSG00000139220","PPFIA2","12",81257975,81759553,501578
"7336","ENSG00000177380","ENSG00000177380","PPFIA3","19",49119544,49151026,31482
"7337","ENSG00000143847","ENSG00000143847","PPFIA4","1",203026491,203078740,52249
"7338","ENSG00000110841","ENSG00000110841","PPFIBP1","12",27523431,27695564,172133
"7339","ENSG00000166387","ENSG00000166387","PPFIBP2","11",7513298,7657127,143829
"7340","ENSG00000196262","ENSG00000196262","PPIA","7",44796680,44824564,27884
"7341","ENSG00000166794","ENSG00000166794","PPIB","15",64155740,64163134,7394
"7342","ENSG00000168938","ENSG00000168938","PPIC","5",123023250,123036725,13475
"7343","ENSG00000171497","ENSG00000171497","PPID","4",158709127,158723396,14269
"7344","ENSG00000084072","ENSG00000084072","PPIE","1",39692182,39763914,71732
"7345","ENSG00000108179","ENSG00000108179","PPIF","10",79347469,79355334,7865
"7346","ENSG00000138398","ENSG00000138398","PPIG","2",169584342,169641406,57064
"7347","ENSG00000171960","ENSG00000171960","PPIH","1",42658335,42676758,18423
"7348","ENSG00000100023","ENSG00000100023","PPIL2","22",21666000,21700015,34015
"7349","ENSG00000168781","ENSG00000168781","PPIP5K1","15",43533462,43590208,56746
"7350","ENSG00000145725","ENSG00000145725","PPIP5K2","5",103120149,103212799,92650
"7351","ENSG00000118898","ENSG00000118898","PPL","16",4882507,4960741,78234
"7352","ENSG00000100614","ENSG00000100614","PPM1A","14",60245752,60299087,53335
"7353","ENSG00000138032","ENSG00000138032","PPM1B","2",44167969,44244384,76415
"7354","ENSG00000170836","ENSG00000170836","PPM1D","17",60600193,60666280,66087
"7355","ENSG00000175175","ENSG00000175175","PPM1E","17",58755854,58985179,229325
"7356","ENSG00000100034","ENSG00000100034","PPM1F","22",21919425,21952848,33423
"7357","ENSG00000115241","ENSG00000115241","PPM1G","2",27381195,27409591,28396
"7358","ENSG00000111110","ENSG00000111110","PPM1H","12",62643994,62935150,291156
"7359","ENSG00000214517","ENSG00000214517","PPME1","11",74171267,74254703,83436
"7360","ENSG00000143224","ENSG00000143224","PPOX","1",161166056,161178013,11957
"7361","ENSG00000172531","ENSG00000172531","PPP1CA","11",67398181,67421183,23002
"7362","ENSG00000213639","ENSG00000213639","PPP1CB","2",28751640,28802940,51300
"7363","ENSG00000186298","ENSG00000186298","PPP1CC","12",110719680,110742939,23259
"7364","ENSG00000238104","ENSG00000238104","PPP1R10","HSCHR6_MHC_SSTO_CTG1",1901158,1919370,18212
"7365","ENSG00000237829","ENSG00000237829","PPP1R11","HSCHR6_MHC_SSTO_CTG1",1365628,1369252,3624
"7366","ENSG00000058272","ENSG00000058272","PPP1R12A","12",79773563,79935460,161897
"7367","ENSG00000077157","ENSG00000077157","PPP1R12B","1",202348699,202592706,244007
"7368","ENSG00000088808","ENSG00000088808","PPP1R13B","14",103733195,103847575,114380
"7369","ENSG00000104881","ENSG00000104881","PPP1R13L","19",45379638,45406349,26711
"7370","ENSG00000173457","ENSG00000173457","PPP1R14B","11",64244479,64246943,2464
"7371","ENSG00000166143","ENSG00000166143","PPP1R14D","15",40815451,40828709,13258
"7372","ENSG00000087074","ENSG00000087074","PPP1R15A","19",48872212,48876059,3847
"7373","ENSG00000101445","ENSG00000101445","PPP1R16B","20",38805697,38923024,117327
"7374","ENSG00000106341","ENSG00000106341","PPP1R17","7",31687215,31708455,21240
"7375","ENSG00000135447","ENSG00000135447","PPP1R1A","12",54575387,54588659,13272
"7376","ENSG00000184203","ENSG00000184203","PPP1R2","3",195514428,195543386,28958
"7377","ENSG00000196422","ENSG00000196422","PPP1R26","9",135479079,135488893,9814
"7378","ENSG00000119938","ENSG00000119938","PPP1R3C","10",91628442,91633071,4629
"7379","ENSG00000132825","ENSG00000132825","PPP1R3D","20",59936663,59940305,3642
"7380","ENSG00000115685","ENSG00000115685","PPP1R7","2",241149576,241183652,34076
"7381","ENSG00000117751","ENSG00000117751","PPP1R8","1",27830782,27851676,20894
"7382","ENSG00000158528","ENSG00000158528","PPP1R9A","7",94907202,95296415,389213
"7383","ENSG00000113575","ENSG00000113575","PPP2CA","5",134194035,134226073,32038
"7384","ENSG00000104695","ENSG00000104695","PPP2CB","8",30774457,30814314,39857
"7385","ENSG00000105568","ENSG00000105568","PPP2R1A","19",52170936,52229518,58582
"7386","ENSG00000137713","ENSG00000137713","PPP2R1B","11",111726908,111766389,39481
"7387","ENSG00000221914","ENSG00000221914","PPP2R2A","8",26291508,26372680,81172
"7388","ENSG00000156475","ENSG00000156475","PPP2R2B","5",146580742,147084784,504042
"7389","ENSG00000175470","ENSG00000175470","PPP2R2D","10",131901008,131959834,58826
"7390","ENSG00000073711","ENSG00000073711","PPP2R3A","3",135965728,136147894,182166
"7391","ENSG00000276438","ENSG00000276438","PPP2R3B","HSCHRX_1_CTG3",17159,70308,53149
"7392","ENSG00000092020","ENSG00000092020","PPP2R3C","14",35085467,35122517,37050
"7393","ENSG00000066027","ENSG00000066027","PPP2R5A","1",212285410,212361853,76443
"7394","ENSG00000068971","ENSG00000068971","PPP2R5B","11",64917553,64934475,16922
"7395","ENSG00000078304","ENSG00000078304","PPP2R5C","14",101761709,101927989,166280
"7396","ENSG00000112640","ENSG00000112640","PPP2R5D","6",42984553,43012342,27789
"7397","ENSG00000154001","ENSG00000154001","PPP2R5E","14",63371364,63543377,172013
"7398","ENSG00000138814","ENSG00000138814","PPP3CA","4",101023409,101348278,324869
"7399","ENSG00000107758","ENSG00000107758","PPP3CB","10",73436433,73496024,59591
"7400","ENSG00000120910","ENSG00000120910","PPP3CC","8",22440819,22541142,100323
"7401","ENSG00000149923","ENSG00000149923","PPP4C","16",30075978,30085376,9398
"7402","ENSG00000154845","ENSG00000154845","PPP4R1","18",9546791,9615240,68449
"7403","ENSG00000163605","ENSG00000163605","PPP4R2","3",72996803,73069198,72395
"7404","ENSG00000100796","ENSG00000100796","PPP4R3A","14",91457508,91510554,53046
"7405","ENSG00000275052","ENSG00000275052","PPP4R3B","2",55547292,55618880,71588
"7406","ENSG00000011485","ENSG00000011485","PPP5C","19",46347087,46392981,45894
"7407","ENSG00000119414","ENSG00000119414","PPP6C","9",125146573,125189939,43366
"7408","ENSG00000105063","ENSG00000105063","PPP6R1","19",55229779,55259017,29238
"7409","ENSG00000100239","ENSG00000100239","PPP6R2","22",50343304,50445090,101786
"7410","ENSG00000110075","ENSG00000110075","PPP6R3","11",68460731,68615334,154603
"7411","ENSG00000148840","ENSG00000148840","PPRC1","10",102132994,102150333,17339
"7412","ENSG00000131238","ENSG00000131238","PPT1","1",40072710,40097260,24550
"7413","ENSG00000228116","ENSG00000228116","PPT2","HSCHR6_MHC_DBB_CTG1",3394806,3399697,4891
"7414","ENSG00000113593","ENSG00000113593","PPWD1","5",65563236,65587549,24313
"7415","ENSG00000102103","ENSG00000102103","PQBP1","X",48890197,48903402,13205
"7416","ENSG00000275013","ENSG00000275013","PRAME","HSCHR22_1_CTG3",183358,195018,11660
"7417","ENSG00000282673","ENSG00000282673","PRB1","HSCHR12_3_CTG2",546786,550554,3768
"7418","ENSG00000198901","ENSG00000198901","PRC1","15",90966040,90995629,29589
"7419","ENSG00000143294","ENSG00000143294","PRCC","1",156750610,156800815,50205
"7420","ENSG00000137509","ENSG00000137509","PRCP","11",82822936,82970584,147648
"7421","ENSG00000057657","ENSG00000057657","PRDM1","6",105993463,106109939,116476
"7422","ENSG00000170325","ENSG00000170325","PRDM10","11",129899706,130002835,103129
"7423","ENSG00000019485","ENSG00000019485","PRDM11","11",45095806,45235110,139304
"7424","ENSG00000130711","ENSG00000130711","PRDM12","9",130664594,130682986,18392
"7425","ENSG00000112238","ENSG00000112238","PRDM13","6",99606774,99615578,8804
"7426","ENSG00000147596","ENSG00000147596","PRDM14","8",70051651,70071693,20042
"7427","ENSG00000116731","ENSG00000116731","PRDM2","1",13700188,13825079,124891
"7428","ENSG00000110851","ENSG00000110851","PRDM4","12",107732871,107761272,28401
"7429","ENSG00000138738","ENSG00000138738","PRDM5","4",120684919,120922870,237951
"7430","ENSG00000152784","ENSG00000152784","PRDM8","4",80183879,80204329,20450
"7431","ENSG00000117450","ENSG00000117450","PRDX1","1",45510914,45542732,31818
"7432","ENSG00000167815","ENSG00000167815","PRDX2","19",12796820,12801800,4980
"7433","ENSG00000165672","ENSG00000165672","PRDX3","10",119167720,119178812,11092
"7434","ENSG00000123131","ENSG00000123131","PRDX4","X",23664262,23686397,22135
"7435","ENSG00000117592","ENSG00000117592","PRDX6","1",173477330,173488815,11485
"7436","ENSG00000138073","ENSG00000138073","PREB","2",27130756,27134666,3910
"7437","ENSG00000141391","ENSG00000141391","PRELID3A","18",12407896,12432238,24342
"7438","ENSG00000101166","ENSG00000101166","PRELID3B","20",59033145,59042809,9664
"7439","ENSG00000188783","ENSG00000188783","PRELP","1",203475806,203491352,15546
"7440","ENSG00000085377","ENSG00000085377","PREP","6",105273218,105454062,180844
"7441","ENSG00000138078","ENSG00000138078","PREPL","2",44316281,44361862,45581
"7442","ENSG00000046889","ENSG00000046889","PREX2","8",67952046,68237032,284986
"7443","ENSG00000186652","ENSG00000186652","PRG2","11",57386780,57390650,3870
"7444","ENSG00000116690","ENSG00000116690","PRG4","1",186296279,186314567,18288
"7445","ENSG00000275679","ENSG00000275679","PRH2","HSCHR12_3_CTG2",127942,131047,3105
"7446","ENSG00000012211","ENSG00000012211","PRICKLE3","X",49174802,49186528,11726
"7447","ENSG00000198056","ENSG00000198056","PRIM1","12",56730438,56752374,21936
"7448","ENSG00000146143","ENSG00000146143","PRIM2","6",57314805,57646850,332045
"7449","ENSG00000132356","ENSG00000132356","PRKAA1","5",40759389,40798374,38985
"7450","ENSG00000162409","ENSG00000162409","PRKAA2","1",56645314,56715335,70021
"7451","ENSG00000111725","ENSG00000111725","PRKAB1","12",119667864,119681624,13760
"7452","ENSG00000131791","ENSG00000131791","PRKAB2","1",147155106,147172550,17444
"7453","ENSG00000072062","ENSG00000072062","PRKACA","19",14091688,14118084,26396
"7454","ENSG00000142875","ENSG00000142875","PRKACB","1",84078062,84238498,160436
"7455","ENSG00000181929","ENSG00000181929","PRKAG1","12",49002274,49018807,16533
"7456","ENSG00000106617","ENSG00000106617","PRKAG2","7",151556124,151877214,321090
"7457","ENSG00000108946","ENSG00000108946","PRKAR1A","17",68511780,68551319,39539
"7458","ENSG00000188191","ENSG00000188191","PRKAR1B","7",549197,727650,178453
"7459","ENSG00000114302","ENSG00000114302","PRKAR2A","3",48744597,48847874,103277
"7460","ENSG00000005249","ENSG00000005249","PRKAR2B","7",107044705,107161811,117106
"7461","ENSG00000154229","ENSG00000154229","PRKCA","17",66302613,66810743,508130
"7462","ENSG00000166501","ENSG00000166501","PRKCB","16",23835983,24220611,384628
"7463","ENSG00000163932","ENSG00000163932","PRKCD","3",53156009,53192717,36708
"7464","ENSG00000126583","ENSG00000126583","PRKCG","19",53879190,53907652,28462
"7465","ENSG00000027075","ENSG00000027075","PRKCH","14",61187559,61550976,363417
"7466","ENSG00000163558","ENSG00000163558","PRKCI","3",170222424,170305977,83553
"7467","ENSG00000065675","ENSG00000065675","PRKCQ","10",6427143,6580301,153158
"7468","ENSG00000130175","ENSG00000130175","PRKCSH","19",11435284,11450968,15684
"7469","ENSG00000067606","ENSG00000067606","PRKCZ","1",2050411,2185395,134984
"7470","ENSG00000184304","ENSG00000184304","PRKD1","14",29576479,30191898,615419
"7471","ENSG00000105287","ENSG00000105287","PRKD2","19",46674275,46717127,42852
"7472","ENSG00000115825","ENSG00000115825","PRKD3","2",37250502,37324833,74331
"7473","ENSG00000253729","ENSG00000253729","PRKDC","8",47773111,47960178,187067
"7474","ENSG00000185532","ENSG00000185532","PRKG1","10",50990888,52298423,1307535
"7475","ENSG00000138669","ENSG00000138669","PRKG2","4",81087370,81215222,127852
"7476","ENSG00000180228","ENSG00000180228","PRKRA","2",178431292,178451512,20220
"7477","ENSG00000128563","ENSG00000128563","PRKRIP1","7",102363872,102426676,62804
"7478","ENSG00000183943","ENSG00000183943","PRKX","X",3604340,3713649,109309
"7479","ENSG00000099725","ENSG00000099725","PRKY","Y",7274313,7371868,97555
"7480","ENSG00000172179","ENSG00000172179","PRL","6",22287244,22302826,15582
"7481","ENSG00000113494","ENSG00000113494","PRLR","5",35048756,35230487,181731
"7482","ENSG00000126457","ENSG00000126457","PRMT1","19",49675786,49689029,13243
"7483","ENSG00000160310","ENSG00000160310","PRMT2","21",46635595,46665124,29529
"7484","ENSG00000100462","ENSG00000100462","PRMT5","14",22920525,22929408,8883
"7485","ENSG00000132600","ENSG00000132600","PRMT7","16",68310951,68360852,49901
"7486","ENSG00000111218","ENSG00000111218","PRMT8","12",3381349,3593973,212624
"7487","ENSG00000171864","ENSG00000171864","PRND","20",4721909,4728460,6551
"7488","ENSG00000171867","ENSG00000171867","PRNP","20",4686350,4701590,15240
"7489","ENSG00000115718","ENSG00000115718","PROC","2",127418427,127429242,10815
"7490","ENSG00000101000","ENSG00000101000","PROCR","20",35172072,35216240,44168
"7491","ENSG00000100033","ENSG00000100033","PRODH","22",18912777,18936553,23776
"7492","ENSG00000250799","ENSG00000250799","PRODH2","19",35799988,35813299,13311
"7493","ENSG00000007062","ENSG00000007062","PROM1","4",15963076,16084378,121302
"7494","ENSG00000184500","ENSG00000184500","PROS1","3",93873051,93980003,106952
"7495","ENSG00000120685","ENSG00000120685","PROSER1","13",39009865,39038089,28224
"7496","ENSG00000117707","ENSG00000117707","PROX1","1",213983181,214041510,58329
"7497","ENSG00000126231","ENSG00000126231","PROZ","13",113158648,113172386,13738
"7498","ENSG00000165630","ENSG00000165630","PRPF18","10",13586939,13668445,81506
"7499","ENSG00000110107","ENSG00000110107","PRPF19","11",60890547,60906585,16038
"7500","ENSG00000117360","ENSG00000117360","PRPF3","1",150321479,150353233,31754
"7501","ENSG00000275885","ENSG00000275885","PRPF31","HSCHR19_4_CTG3_1",89903,106263,16360
"7502","ENSG00000134186","ENSG00000134186","PRPF38B","1",108692310,108702928,10618
"7503","ENSG00000185246","ENSG00000185246","PRPF39","14",45084107,45116282,32175
"7504","ENSG00000136875","ENSG00000136875","PRPF4","9",113275642,113294009,18367
"7505","ENSG00000196504","ENSG00000196504","PRPF40A","2",152651593,152718012,66419
"7506","ENSG00000112739","ENSG00000112739","PRPF4B","6",4021267,4064983,43716
"7507","ENSG00000101161","ENSG00000101161","PRPF6","20",63981132,64033100,51968
"7508","ENSG00000274442","ENSG00000274442","PRPF8","HSCHR17_1_CTG2",80657,114910,34253
"7509","ENSG00000135406","ENSG00000135406","PRPH","12",49295147,49298686,3539
"7510","ENSG00000112619","ENSG00000112619","PRPH2","6",42696598,42722597,25999
"7511","ENSG00000147224","ENSG00000147224","PRPS1","X",107628428,107651993,23565
"7512","ENSG00000101911","ENSG00000101911","PRPS2","X",12791355,12824222,32867
"7513","ENSG00000161542","ENSG00000161542","PRPSAP1","17",76309478,76384521,75043
"7514","ENSG00000141127","ENSG00000141127","PRPSAP2","17",18840085,18931287,91202
"7515","ENSG00000068489","ENSG00000068489","PRR11","17",59155732,59206709,50977
"7516","ENSG00000205352","ENSG00000205352","PRR13","12",53441678,53446645,4967
"7517","ENSG00000156858","ENSG00000156858","PRR14","16",30650717,30656413,5696
"7518","ENSG00000167183","ENSG00000167183","PRR15L","17",47951967,47957883,5916
"7519","ENSG00000184838","ENSG00000184838","PRR16","5",120464300,120687332,223032
"7520","ENSG00000233564","ENSG00000233564","PRR3","HSCHR6_MHC_MCF_CTG1",1900932,1907769,6837
"7521","ENSG00000282269","ENSG00000282269","PRR4","HSCHR12_3_CTG2",44555,366553,321998
"7522","ENSG00000186654","ENSG00000186654","PRR5","22",44668547,44737681,69134
"7523","ENSG00000248405","ENSG00000248405","PRR5-ARHGAP8","22",44702233,44862706,160473
"7524","ENSG00000135362","ENSG00000135362","PRR5L","11",36296288,36465204,168916
"7525","ENSG00000131188","ENSG00000131188","PRR7","5",177446445,177456286,9841
"7526","ENSG00000231825","ENSG00000231825","PRRC2A","HSCHR6_MHC_SSTO_CTG1",2920002,2937052,17050
"7527","ENSG00000117523","ENSG00000117523","PRRC2C","1",171485530,171593511,107981
"7528","ENSG00000130962","ENSG00000130962","PRRG1","X",37349309,37457292,107983
"7529","ENSG00000126460","ENSG00000126460","PRRG2","19",49580646,49591004,10358
"7530","ENSG00000130032","ENSG00000130032","PRRG3","X",151694607,151705924,11317
"7531","ENSG00000135378","ENSG00000135378","PRRG4","11",32829927,32858120,28193
"7532","ENSG00000116132","ENSG00000116132","PRRX1","1",170662728,170739421,76693
"7533","ENSG00000167157","ENSG00000167157","PRRX2","9",129665647,129722674,57027
"7534","ENSG00000274247","ENSG00000274247","PRSS1","HSCHR7_2_CTG6",752065,755673,3608
"7535","ENSG00000164099","ENSG00000164099","PRSS12","4",118280038,118353003,72965
"7536","ENSG00000112812","ENSG00000112812","PRSS16","6",27247701,27256624,8923
"7537","ENSG00000282049","ENSG00000282049","PRSS2","HSCHR7_2_CTG6",793943,797532,3589
"7538","ENSG00000007038","ENSG00000007038","PRSS21","16",2817180,2826304,9124
"7539","ENSG00000005001","ENSG00000005001","PRSS22","16",2852730,2858170,5440
"7540","ENSG00000150687","ENSG00000150687","PRSS23","11",86791059,86952910,161851
"7541","ENSG00000010438","ENSG00000010438","PRSS3","9",33750679,33799231,48552
"7542","ENSG00000052344","ENSG00000052344","PRSS8","16",31131433,31135727,4294
"7543","ENSG00000277804","ENSG00000277804","PRTN3","HSCHR19_5_CTG2",19803,27018,7215
"7544","ENSG00000143363","ENSG00000143363","PRUNE1","1",151008420,151035713,27293
"7545","ENSG00000106772","ENSG00000106772","PRUNE2","9",76611376,76906114,294738
"7546","ENSG00000105227","ENSG00000105227","PRX","19",40393766,40414793,21027
"7547","ENSG00000197746","ENSG00000197746","PSAP","10",71816298,71851251,34953
"7548","ENSG00000135069","ENSG00000135069","PSAT1","9",78297125,78330093,32968
"7549","ENSG00000167653","ENSG00000167653","PSCA","8",142670308,142682725,12417
"7550","ENSG00000059915","ENSG00000059915","PSD","10",102402617,102421539,18922
"7551","ENSG00000156011","ENSG00000156011","PSD3","8",18527303,19084730,557427
"7552","ENSG00000125637","ENSG00000125637","PSD4","2",113157325,113209396,52071
"7553","ENSG00000080815","ENSG00000080815","PSEN1","14",73136418,73223691,87273
"7554","ENSG00000143801","ENSG00000143801","PSEN2","1",226870184,226927726,57542
"7555","ENSG00000205155","ENSG00000205155","PSENEN","19",35745600,35747519,1919
"7556","ENSG00000231924","ENSG00000231924","PSG1","19",42866464,42879822,13358
"7557","ENSG00000243130","ENSG00000243130","PSG11","19",43007656,43026474,18818
"7558","ENSG00000243137","ENSG00000243137","PSG4","19",43192702,43207299,14597
"7559","ENSG00000170848","ENSG00000170848","PSG6","19",42902086,42919563,17477
"7560","ENSG00000164985","ENSG00000164985","PSIP1","9",15464066,15510995,46929
"7561","ENSG00000159792","ENSG00000159792","PSKH1","16",67893254,67929676,36422
"7562","ENSG00000129084","ENSG00000129084","PSMA1","11",14504874,14643635,138761
"7563","ENSG00000106588","ENSG00000106588","PSMA2","7",42916828,42932185,15357
"7564","ENSG00000100567","ENSG00000100567","PSMA3","14",58244843,58272012,27169
"7565","ENSG00000041357","ENSG00000041357","PSMA4","15",78540405,78552417,12012
"7566","ENSG00000143106","ENSG00000143106","PSMA5","1",109399042,109426448,27406
"7567","ENSG00000100902","ENSG00000100902","PSMA6","14",35278633,35317493,38860
"7568","ENSG00000008018","ENSG00000008018","PSMB1","6",170535120,170553307,18187
"7569","ENSG00000205220","ENSG00000205220","PSMB10","16",67934506,67936864,2358
"7570","ENSG00000126067","ENSG00000126067","PSMB2","1",35599541,35641526,41985
"7571","ENSG00000277791","ENSG00000277791","PSMB3","17",38752741,38764225,11484
"7572","ENSG00000159377","ENSG00000159377","PSMB4","1",151399560,151401937,2377
"7573","ENSG00000100804","ENSG00000100804","PSMB5","14",23016543,23035230,18687
"7574","ENSG00000136930","ENSG00000136930","PSMB7","9",124353465,124415444,61979
"7575","ENSG00000236443","ENSG00000236443","PSMB8","HSCHR6_MHC_MANN_CTG1",4260070,4264056,3986
"7576","ENSG00000243958","ENSG00000243958","PSMB9","HSCHR6_MHC_SSTO_CTG1",4243388,4278806,35418
"7577","ENSG00000100764","ENSG00000100764","PSMC1","14",90256527,90275429,18902
"7578","ENSG00000161057","ENSG00000161057","PSMC2","7",103328570,103370346,41776
"7579","ENSG00000165916","ENSG00000165916","PSMC3","11",47418769,47426473,7704
"7580","ENSG00000131470","ENSG00000131470","PSMC3IP","17",42572310,42577831,5521
"7581","ENSG00000013275","ENSG00000013275","PSMC4","19",39971165,39981764,10599
"7582","ENSG00000087191","ENSG00000087191","PSMC5","17",63827152,63832026,4874
"7583","ENSG00000100519","ENSG00000100519","PSMC6","14",52707178,52728590,21412
"7584","ENSG00000173692","ENSG00000173692","PSMD1","2",231056845,231173116,116271
"7585","ENSG00000101843","ENSG00000101843","PSMD10","X",108084207,108091549,7342
"7586","ENSG00000108671","ENSG00000108671","PSMD11","17",32444379,32483319,38940
"7587","ENSG00000197170","ENSG00000197170","PSMD12","17",67337916,67366605,28689
"7588","ENSG00000185627","ENSG00000185627","PSMD13","11",236966,252984,16018
"7589","ENSG00000115233","ENSG00000115233","PSMD14","2",161308425,161411717,103292
"7590","ENSG00000175166","ENSG00000175166","PSMD2","3",184299198,184309050,9852
"7591","ENSG00000108344","ENSG00000108344","PSMD3","17",39980807,39997959,17152
"7592","ENSG00000159352","ENSG00000159352","PSMD4","1",151254709,151267479,12770
"7593","ENSG00000095261","ENSG00000095261","PSMD5","9",120815496,120842951,27455
"7594","ENSG00000163636","ENSG00000163636","PSMD6","3",64010550,64024010,13460
"7595","ENSG00000103035","ENSG00000103035","PSMD7","16",74296814,74306288,9474
"7596","ENSG00000099341","ENSG00000099341","PSMD8","19",38374563,38383850,9287
"7597","ENSG00000110801","ENSG00000110801","PSMD9","12",121888732,121918297,29565
"7598","ENSG00000092010","ENSG00000092010","PSME1","14",24136163,24138967,2804
"7599","ENSG00000100911","ENSG00000100911","PSME2","14",24143362,24147570,4208
"7600","ENSG00000131467","ENSG00000131467","PSME3","17",42824385,42843760,19375
"7601","ENSG00000068878","ENSG00000068878","PSME4","2",53864069,53970993,106924
"7602","ENSG00000125818","ENSG00000125818","PSMF1","20",1113240,1189415,76175
"7603","ENSG00000183527","ENSG00000183527","PSMG1","21",39174769,39183488,8719
"7604","ENSG00000128789","ENSG00000128789","PSMG2","18",12658043,12728945,70902
"7605","ENSG00000235487","ENSG00000235487","PSORS1C1","HSCHR6_MHC_COX_CTG1",2597125,2622431,25306
"7606","ENSG00000234605","ENSG00000234605","PSORS1C2","HSCHR6_MHC_MANN_CTG1",2448059,2449875,1816
"7607","ENSG00000121390","ENSG00000121390","PSPC1","13",19674752,19783019,108267
"7608","ENSG00000146733","ENSG00000146733","PSPH","7",56011051,56051604,40553
"7609","ENSG00000125650","ENSG00000125650","PSPN","19",6375148,6379058,3910
"7610","ENSG00000140368","ENSG00000140368","PSTPIP1","15",76993359,77037475,44116
"7611","ENSG00000152229","ENSG00000152229","PSTPIP2","18",45983536,46072272,88736
"7612","ENSG00000169403","ENSG00000169403","PTAFR","1",28147166,28193936,46770
"7613","ENSG00000011304","ENSG00000011304","PTBP1","19",797075,812327,15252
"7614","ENSG00000117569","ENSG00000117569","PTBP2","1",96721665,96823738,102073
"7615","ENSG00000119314","ENSG00000119314","PTBP3","9",112217716,112333664,115948
"7616","ENSG00000106246","ENSG00000106246","PTCD1","7",99416739,99466163,49424
"7617","ENSG00000049883","ENSG00000049883","PTCD2","5",72320367,72368395,48028
"7618","ENSG00000132300","ENSG00000132300","PTCD3","2",86106223,86142157,35934
"7619","ENSG00000185920","ENSG00000185920","PTCH1","9",95442980,95517057,74077
"7620","ENSG00000117425","ENSG00000117425","PTCH2","1",44819844,44843253,23409
"7621","ENSG00000171611","ENSG00000171611","PTCRA","6",42915989,42925838,9849
"7622","ENSG00000156471","ENSG00000156471","PTDSS1","8",96261902,96336995,75093
"7623","ENSG00000282367","ENSG00000282367","PTDSS2","HSCHR11_1_CTG8",3536,21040,17504
"7624","ENSG00000171862","ENSG00000171862","PTEN","10",87862638,87971930,109292
"7625","ENSG00000237984","ENSG00000237984","PTENP1","9",33675437,33676651,1214
"7626","ENSG00000165983","ENSG00000165983","PTER","10",16436943,16513745,76802
"7627","ENSG00000168229","ENSG00000168229","PTGDR","14",52267698,52276724,9026
"7628","ENSG00000183134","ENSG00000183134","PTGDR2","11",60850933,60855950,5017
"7629","ENSG00000107317","ENSG00000107317","PTGDS","9",136975092,136981742,6650
"7630","ENSG00000160951","ENSG00000160951","PTGER1","19",14472466,14475354,2888
"7631","ENSG00000125384","ENSG00000125384","PTGER2","14",52314305,52328598,14293
"7632","ENSG00000050628","ENSG00000050628","PTGER3","1",70852353,71047816,195463
"7633","ENSG00000171522","ENSG00000171522","PTGER4","5",40679915,40693735,13820
"7634","ENSG00000148344","ENSG00000148344","PTGES","9",129738331,129753042,14711
"7635","ENSG00000148334","ENSG00000148334","PTGES2","9",128120693,128128462,7769
"7636","ENSG00000110958","ENSG00000110958","PTGES3","12",56663341,56688408,25067
"7637","ENSG00000108825","ENSG00000108825","PTGES3L-AARSD1","17",42950526,42980528,30002
"7638","ENSG00000122420","ENSG00000122420","PTGFR","1",78303884,78540701,236817
"7639","ENSG00000124212","ENSG00000124212","PTGIS","20",49503874,49568137,64263
"7640","ENSG00000095303","ENSG00000095303","PTGS1","9",122370530,122395703,25173
"7641","ENSG00000073756","ENSG00000073756","PTGS2","1",186671791,186680922,9131
"7642","ENSG00000160801","ENSG00000160801","PTH1R","3",46877721,46903799,26078
"7643","ENSG00000144407","ENSG00000144407","PTH2R","2",208359714,208854503,494789
"7644","ENSG00000087494","ENSG00000087494","PTHLH","12",27958084,27972733,14649
"7645","ENSG00000169398","ENSG00000169398","PTK2","8",140657900,141002216,344316
"7646","ENSG00000120899","ENSG00000120899","PTK2B","8",27311482,27459391,147909
"7647","ENSG00000101213","ENSG00000101213","PTK6","20",63528001,63537376,9375
"7648","ENSG00000112655","ENSG00000112655","PTK7","6",43076307,43161719,85412
"7649","ENSG00000187514","ENSG00000187514","PTMA","2",231706895,231713551,6656
"7650","ENSG00000159335","ENSG00000159335","PTMS","12",6765516,6770952,5436
"7651","ENSG00000105894","ENSG00000105894","PTN","7",137227341,137343774,116433
"7652","ENSG00000104960","ENSG00000104960","PTOV1","19",49850735,49860744,10009
"7653","ENSG00000112245","ENSG00000112245","PTP4A1","6",63521746,63583588,61842
"7654","ENSG00000184007","ENSG00000184007","PTP4A2","1",31906421,31944856,38435
"7655","ENSG00000275575","ENSG00000275575","PTP4A3","HSCHR8_5_CTG7",58545,104910,46365
"7656","ENSG00000119383","ENSG00000119383","PTPA","9",129110950,129148946,37996
"7657","ENSG00000196396","ENSG00000196396","PTPN1","20",50510321,50585241,74920
"7658","ENSG00000179295","ENSG00000179295","PTPN11","12",112418351,112509918,91567
"7659","ENSG00000127947","ENSG00000127947","PTPN12","7",77537295,77640069,102774
"7660","ENSG00000163629","ENSG00000163629","PTPN13","4",86594315,86815171,220856
"7661","ENSG00000152104","ENSG00000152104","PTPN14","1",214348700,214552449,203749
"7662","ENSG00000072135","ENSG00000072135","PTPN18","2",130356045,130375405,19360
"7663","ENSG00000175354","ENSG00000175354","PTPN2","18",12785478,12929643,144165
"7664","ENSG00000204179","ENSG00000204179","PTPN20","10",46911396,47002488,91092
"7665","ENSG00000070778","ENSG00000070778","PTPN21","14",88465778,88555007,89229
"7666","ENSG00000134242","ENSG00000134242","PTPN22","1",113813811,113871753,57942
"7667","ENSG00000070159","ENSG00000070159","PTPN3","9",109375466,109498313,122847
"7668","ENSG00000088179","ENSG00000088179","PTPN4","2",119759922,119984899,224977
"7669","ENSG00000111679","ENSG00000111679","PTPN6","12",6946468,6961316,14848
"7670","ENSG00000143851","ENSG00000143851","PTPN7","1",202147013,202161588,14575
"7671","ENSG00000169410","ENSG00000169410","PTPN9","15",75463251,75579315,116064
"7672","ENSG00000132670","ENSG00000132670","PTPRA","20",2873420,3039076,165656
"7673","ENSG00000127329","ENSG00000127329","PTPRB","12",70515870,70637440,121570
"7674","ENSG00000262418","ENSG00000262418","PTPRC","HSCHR1_3_CTG31",280076,363881,83805
"7675","ENSG00000213402","ENSG00000213402","PTPRCAP","11",67435510,67437682,2172
"7676","ENSG00000153707","ENSG00000153707","PTPRD","9",8314246,10613002,2298756
"7677","ENSG00000132334","ENSG00000132334","PTPRE","10",127907103,128085855,178752
"7678","ENSG00000142949","ENSG00000142949","PTPRF","1",43525187,43623666,98479
"7679","ENSG00000144724","ENSG00000144724","PTPRG","3",61561569,62297609,736040
"7680","ENSG00000080031","ENSG00000080031","PTPRH","19",55181247,55209506,28259
"7681","ENSG00000149177","ENSG00000149177","PTPRJ","11",47980425,48170839,190414
"7682","ENSG00000273993","ENSG00000273993","PTPRK","HSCHR6_1_CTG8",313977,870008,556031
"7683","ENSG00000173482","ENSG00000173482","PTPRM","18",7566782,8406861,840079
"7684","ENSG00000054356","ENSG00000054356","PTPRN","2",219289623,219309648,20025
"7685","ENSG00000155093","ENSG00000155093","PTPRN2","7",157539056,158587823,1048767
"7686","ENSG00000151490","ENSG00000151490","PTPRO","12",15322257,15602175,279918
"7687","ENSG00000153233","ENSG00000153233","PTPRR","12",70638073,70920738,282665
"7688","ENSG00000105426","ENSG00000105426","PTPRS","19",5158495,5340812,182317
"7689","ENSG00000196090","ENSG00000196090","PTPRT","20",42072752,43189970,1117218
"7690","ENSG00000060656","ENSG00000060656","PTPRU","1",29236516,29326813,90297
"7691","ENSG00000106278","ENSG00000106278","PTPRZ1","7",121873089,122062036,188947
"7692","ENSG00000141378","ENSG00000141378","PTRH2","17",59674636,59707626,32990
"7693","ENSG00000150787","ENSG00000150787","PTS","11",112226367,112269955,43588
"7694","ENSG00000164611","ENSG00000164611","PTTG1","5",160421855,160428739,6884
"7695","ENSG00000183255","ENSG00000183255","PTTG1IP","21",44849585,44873903,24318
"7696","ENSG00000163661","ENSG00000163661","PTX3","3",157436850,157443633,6783
"7697","ENSG00000130021","ENSG00000130021","PUDP","X",6667865,7148158,480293
"7698","ENSG00000179950","ENSG00000179950","PUF60","8",143816344,143830709,14365
"7699","ENSG00000134644","ENSG00000134644","PUM1","1",30931506,31065991,134485
"7700","ENSG00000055917","ENSG00000055917","PUM2","2",20248691,20352234,103543
"7701","ENSG00000080608","ENSG00000080608","PUM3","9",2720469,2844095,123626
"7702","ENSG00000185129","ENSG00000185129","PURA","5",140107777,140125619,17842
"7703","ENSG00000172733","ENSG00000172733","PURG","8",30995802,31033715,37913
"7704","ENSG00000177192","ENSG00000177192","PUS1","12",131929200,131945896,16696
"7705","ENSG00000110060","ENSG00000110060","PUS3","11",125893485,125903221,9736
"7706","ENSG00000091127","ENSG00000091127","PUS7","7",105439661,105522271,82610
"7707","ENSG00000129317","ENSG00000129317","PUS7L","12",43718992,43758793,39801
"7708","ENSG00000274665","ENSG00000274665","PVALB","HSCHR22_1_CTG5",21471,40266,18795
"7709","ENSG00000073008","ENSG00000073008","PVR","19",44643798,44666162,22364
"7710","ENSG00000213413","ENSG00000213413","PVRIG","7",100218241,100221490,3249
"7711","ENSG00000136045","ENSG00000136045","PWP1","12",107685799,107713162,27363
"7712","ENSG00000241945","ENSG00000241945","PWP2","21",44107373,44131181,23808
"7713","ENSG00000130508","ENSG00000130508","PXDN","2",1631887,1744852,112965
"7714","ENSG00000176894","ENSG00000176894","PXMP2","12",132687587,132704985,17398
"7715","ENSG00000101417","ENSG00000101417","PXMP4","20",33702758,33720319,17561
"7716","ENSG00000089159","ENSG00000089159","PXN","12",120210439,120265771,55332
"7717","ENSG00000103490","ENSG00000103490","PYCARD","16",31201486,31203450,1964
"7718","ENSG00000183010","ENSG00000183010","PYCR1","17",81932384,81942412,10028
"7719","ENSG00000100994","ENSG00000100994","PYGB","20",25248085,25298012,49927
"7720","ENSG00000100504","ENSG00000100504","PYGL","14",50857891,50944483,86592
"7721","ENSG00000068976","ENSG00000068976","PYGM","11",64746389,64759974,13585
"7722","ENSG00000121350","ENSG00000121350","PYROXD1","12",21437615,21471250,33635
"7723","ENSG00000131096","ENSG00000131096","PYY","17",43952733,44004469,51736
"7724","ENSG00000126838","ENSG00000126838","PZP","12",9148840,9208395,59555
"7725","ENSG00000151552","ENSG00000151552","QDPR","4",17460261,17512206,51945
"7726","ENSG00000112531","ENSG00000112531","QKI","6",163414000,163578592,164592
"7727","ENSG00000115828","ENSG00000115828","QPCT","2",37342827,37373322,30495
"7728","ENSG00000011478","ENSG00000011478","QPCTL","19",45692403,45703989,11586
"7729","ENSG00000103485","ENSG00000103485","QPRT","16",29663279,29698699,35420
"7730","ENSG00000198218","ENSG00000198218","QRICH1","3",49029707,49094363,64656
"7731","ENSG00000130348","ENSG00000130348","QRSL1","6",106629578,106668417,38839
"7732","ENSG00000060749","ENSG00000060749","QSER1","11",32892811,32993316,100505
"7733","ENSG00000116260","ENSG00000116260","QSOX1","1",180154869,180204030,49161
"7734","ENSG00000213339","ENSG00000213339","QTRT1","19",10701430,10713437,12007
"7735","ENSG00000151576","ENSG00000151576","QTRT2","3",114005833,114088422,82589
"7736","ENSG00000104679","ENSG00000104679","R3HCC1","8",23270120,23296279,26159
"7737","ENSG00000048991","ENSG00000048991","R3HDM1","2",135531455,135725270,193815
"7738","ENSG00000179912","ENSG00000179912","R3HDM2","12",57253762,57431043,177281
"7739","ENSG00000198858","ENSG00000198858","R3HDM4","19",896503,913245,16742
"7740","ENSG00000103769","ENSG00000103769","RAB11A","15",65726054,65891989,165935
"7741","ENSG00000185236","ENSG00000185236","RAB11B","19",8389981,8404434,14453
"7742","ENSG00000156675","ENSG00000156675","RAB11FIP1","8",37858618,37899497,40879
"7743","ENSG00000107560","ENSG00000107560","RAB11FIP2","10",118004916,118046941,42025
"7744","ENSG00000275338","ENSG00000275338","RAB11FIP3","HSCHR16_CTG2",24765,125679,100914
"7745","ENSG00000131242","ENSG00000131242","RAB11FIP4","17",31391675,31538211,146536
"7746","ENSG00000135631","ENSG00000135631","RAB11FIP5","2",73073382,73156721,83339
"7747","ENSG00000143545","ENSG00000143545","RAB13","1",153981617,153986358,4741
"7748","ENSG00000119396","ENSG00000119396","RAB14","9",121178133,121223014,44881
"7749","ENSG00000124839","ENSG00000124839","RAB17","2",237574322,237601614,27292
"7750","ENSG00000138069","ENSG00000138069","RAB1A","2",65070696,65130331,59635
"7751","ENSG00000174903","ENSG00000174903","RAB1B","11",66268590,66277492,8902
"7752","ENSG00000139832","ENSG00000139832","RAB20","13",110523066,110561722,38656
"7753","ENSG00000080371","ENSG00000080371","RAB21","12",71754863,71800286,45423
"7754","ENSG00000124209","ENSG00000124209","RAB22A","20",58309715,58367507,57792
"7755","ENSG00000112210","ENSG00000112210","RAB23","6",57186992,57222307,35315
"7756","ENSG00000132698","ENSG00000132698","RAB25","1",156061160,156070504,9344
"7757","ENSG00000167964","ENSG00000167964","RAB26","16",2140803,2154165,13362
"7758","ENSG00000069974","ENSG00000069974","RAB27A","15",55202966,55319113,116147
"7759","ENSG00000041353","ENSG00000041353","RAB27B","18",54717860,54895516,177656
"7760","ENSG00000157869","ENSG00000157869","RAB28","4",13361354,13484365,123011
"7761","ENSG00000117280","ENSG00000117280","RAB29","1",205767986,205775482,7496
"7762","ENSG00000104388","ENSG00000104388","RAB2A","8",60516936,60623644,106708
"7763","ENSG00000137502","ENSG00000137502","RAB30","11",82973133,83071923,98790
"7764","ENSG00000168461","ENSG00000168461","RAB31","18",9708275,9862551,154276
"7765","ENSG00000118508","ENSG00000118508","RAB32","6",146543833,146554953,11120
"7766","ENSG00000134594","ENSG00000134594","RAB33A","X",130171962,130184870,12908
"7767","ENSG00000172007","ENSG00000172007","RAB33B","4",139453232,139476609,23377
"7768","ENSG00000111737","ENSG00000111737","RAB35","12",120095099,120117502,22403
"7769","ENSG00000100228","ENSG00000100228","RAB36","22",23145366,23165663,20297
"7770","ENSG00000123892","ENSG00000123892","RAB38","11",88113251,88175443,62192
"7771","ENSG00000105649","ENSG00000105649","RAB3A","19",18196784,18204042,7258
"7772","ENSG00000169213","ENSG00000169213","RAB3B","1",51907956,51990700,82744
"7773","ENSG00000105514","ENSG00000105514","RAB3D","19",11322068,11346270,24202
"7774","ENSG00000115839","ENSG00000115839","RAB3GAP1","2",135052289,135176667,124378
"7775","ENSG00000118873","ENSG00000118873","RAB3GAP2","1",220148293,220272529,124236
"7776","ENSG00000167994","ENSG00000167994","RAB3IL1","11",61897301,61920269,22968
"7777","ENSG00000141542","ENSG00000141542","RAB40B","17",82654973,82698698,43725
"7778","ENSG00000197562","ENSG00000197562","RAB40C","16",589357,629272,39915
"7779","ENSG00000168118","ENSG00000168118","RAB4A","1",229271062,229305894,34832
"7780","ENSG00000167578","ENSG00000167578","RAB4B","19",40778216,40796942,18726
"7781","ENSG00000144566","ENSG00000144566","RAB5A","3",19947097,19985175,38078
"7782","ENSG00000111540","ENSG00000111540","RAB5B","12",55973913,55996683,22770
"7783","ENSG00000108774","ENSG00000108774","RAB5C","17",42124978,42155044,30066
"7784","ENSG00000175582","ENSG00000175582","RAB6A","11",73675638,73761137,85499
"7785","ENSG00000154917","ENSG00000154917","RAB6B","3",133824235,133895882,71647
"7786","ENSG00000222014","ENSG00000222014","RAB6C","2",129979666,129982738,3072
"7787","ENSG00000075785","ENSG00000075785","RAB7A","3",128693669,128825942,132273
"7788","ENSG00000167461","ENSG00000167461","RAB8A","19",16111889,16134234,22345
"7789","ENSG00000166128","ENSG00000166128","RAB8B","15",63189560,63267776,78216
"7790","ENSG00000123595","ENSG00000123595","RAB9A","X",13689128,13710504,21376
"7791","ENSG00000105404","ENSG00000105404","RABAC1","19",41956681,41959321,2640
"7792","ENSG00000029725","ENSG00000029725","RABEP1","17",5282265,5386340,104075
"7793","ENSG00000177548","ENSG00000177548","RABEP2","16",28904421,28936526,32105
"7794","ENSG00000136933","ENSG00000136933","RABEPK","9",125200542,125234161,33619
"7795","ENSG00000011454","ENSG00000011454","RABGAP1","9",122940833,123104866,164033
"7796","ENSG00000152061","ENSG00000152061","RABGAP1L","1",174159410,174995308,835898
"7797","ENSG00000154710","ENSG00000154710","RABGEF1","7",66682164,66811464,129300
"7798","ENSG00000100949","ENSG00000100949","RABGGTA","14",24265538,24271611,6073
"7799","ENSG00000137955","ENSG00000137955","RABGGTB","1",75786197,75795086,8889
"7800","ENSG00000183155","ENSG00000183155","RABIF","1",202878282,202889149,10867
"7801","ENSG00000144134","ENSG00000144134","RABL2A","2",113627229,113643396,16167
"7802","ENSG00000079974","ENSG00000079974","RABL2B","22",50767501,50783667,16166
"7803","ENSG00000144840","ENSG00000144840","RABL3","3",120684938,120742993,58055
"7804","ENSG00000196642","ENSG00000196642","RABL6","9",136807943,136841187,33244
"7805","ENSG00000136238","ENSG00000136238","RAC1","7",6374527,6403967,29440
"7806","ENSG00000128340","ENSG00000128340","RAC2","22",37225270,37259594,34324
"7807","ENSG00000169750","ENSG00000169750","RAC3","17",82031678,82034204,2526
"7808","ENSG00000161800","ENSG00000161800","RACGAP1","12",49976923,50033136,56213
"7809","ENSG00000204628","ENSG00000204628","RACK1","5",181236897,181248096,11199
"7810","ENSG00000113456","ENSG00000113456","RAD1","5",34905260,34918989,13729
"7811","ENSG00000276618","ENSG00000276618","RAD17","HSCHR5_2_CTG1_1",152489,198224,45735
"7812","ENSG00000164754","ENSG00000164754","RAD21","8",116845934,116874776,28842
"7813","ENSG00000179262","ENSG00000179262","RAD23A","19",12945855,12953642,7787
"7814","ENSG00000119318","ENSG00000119318","RAD23B","9",107283137,107332192,49055
"7815","ENSG00000113522","ENSG00000113522","RAD50","5",132556019,132646349,90330
"7816","ENSG00000051180","ENSG00000051180","RAD51","15",40694774,40732340,37566
"7817","ENSG00000111247","ENSG00000111247","RAD51AP1","12",4538798,4560047,21249
"7818","ENSG00000182185","ENSG00000182185","RAD51B","14",67819779,68730218,910439
"7819","ENSG00000185379","ENSG00000185379","RAD51D","17",35092221,35121522,29301
"7820","ENSG00000002016","ENSG00000002016","RAD52","12",911736,990053,78317
"7821","ENSG00000197275","ENSG00000197275","RAD54B","8",94371960,94475115,103155
"7822","ENSG00000085999","ENSG00000085999","RAD54L","1",46246461,46278480,32019
"7823","ENSG00000164080","ENSG00000164080","RAD54L2","3",51538719,51668667,129948
"7824","ENSG00000172613","ENSG00000172613","RAD9A","11",67317871,67398410,80539
"7825","ENSG00000101146","ENSG00000101146","RAE1","20",57351223,57379211,27988
"7826","ENSG00000132155","ENSG00000132155","RAF1","3",12582101,12664201,82100
"7827","ENSG00000175097","ENSG00000175097","RAG2","11",36575574,36598279,22705
"7828","ENSG00000108557","ENSG00000108557","RAI1","17",17681458,17811453,129995
"7829","ENSG00000039560","ENSG00000039560","RAI14","5",34656328,34832612,176284
"7830","ENSG00000131831","ENSG00000131831","RAI2","X",17800049,17861337,61288
"7831","ENSG00000006451","ENSG00000006451","RALA","7",39623565,39708120,84555
"7832","ENSG00000144118","ENSG00000144118","RALB","2",120240064,120294710,54646
"7833","ENSG00000017797","ENSG00000017797","RALBP1","18",9475009,9538114,63105
"7834","ENSG00000174373","ENSG00000174373","RALGAPA1","14",35538352,35809304,270952
"7835","ENSG00000170471","ENSG00000170471","RALGAPB","20",38472816,38578859,106043
"7836","ENSG00000160271","ENSG00000160271","RALGDS","9",133097720,133149334,51614
"7837","ENSG00000136828","ENSG00000136828","RALGPS1","9",126914774,127223166,308392
"7838","ENSG00000116191","ENSG00000116191","RALGPS2","1",178725165,178921842,196677
"7839","ENSG00000125970","ENSG00000125970","RALY","20",33993646,34108308,114662
"7840","ENSG00000132329","ENSG00000132329","RAMP1","2",237858893,237912106,53213
"7841","ENSG00000131477","ENSG00000131477","RAMP2","17",42758447,42763041,4594
"7842","ENSG00000122679","ENSG00000122679","RAMP3","7",45157791,45186302,28511
"7843","ENSG00000132341","ENSG00000132341","RAN","12",130872037,130877678,5641
"7844","ENSG00000099901","ENSG00000099901","RANBP1","22",20115938,20127355,11417
"7845","ENSG00000141084","ENSG00000141084","RANBP10","16",67723070,67806560,83490
"7846","ENSG00000204764","ENSG00000204764","RANBP17","5",170861870,171300015,438145
"7847","ENSG00000153201","ENSG00000153201","RANBP2","2",108719482,108785810,66328
"7848","ENSG00000031823","ENSG00000031823","RANBP3","19",5916139,5978142,62003
"7849","ENSG00000137040","ENSG00000137040","RANBP6","9",6011025,6015625,4600
"7850","ENSG00000010017","ENSG00000010017","RANBP9","6",13621498,13711835,90337
"7851","ENSG00000100401","ENSG00000100401","RANGAP1","22",41244779,41286187,41408
"7852","ENSG00000108961","ENSG00000108961","RANGRF","17",8288654,8290092,1438
"7853","ENSG00000116473","ENSG00000116473","RAP1A","1",111542218,111716691,174473
"7854","ENSG00000127314","ENSG00000127314","RAP1B","12",68610855,68671901,61046
"7855","ENSG00000076864","ENSG00000076864","RAP1GAP","1",21596221,21669357,73136
"7856","ENSG00000132359","ENSG00000132359","RAP1GAP2","17",2755705,3037741,282036
"7857","ENSG00000138698","ENSG00000138698","RAP1GDS1","4",98261384,98443858,182474
"7858","ENSG00000125249","ENSG00000125249","RAP2A","13",97434169,97469128,34959
"7859","ENSG00000181467","ENSG00000181467","RAP2B","3",153162226,153170627,8401
"7860","ENSG00000123728","ENSG00000123728","RAP2C","X",132203024,132219480,16456
"7861","ENSG00000107263","ENSG00000107263","RAPGEF1","9",131576770,131740076,163306
"7862","ENSG00000109756","ENSG00000109756","RAPGEF2","4",159103013,159360174,257161
"7863","ENSG00000079337","ENSG00000079337","RAPGEF3","12",47734363,47771040,36677
"7864","ENSG00000091428","ENSG00000091428","RAPGEF4","2",172735274,173052893,317619
"7865","ENSG00000136237","ENSG00000136237","RAPGEF5","7",22118236,22357154,238918
"7866","ENSG00000158987","ENSG00000158987","RAPGEF6","5",131423921,131635231,211310
"7867","ENSG00000108352","ENSG00000108352","RAPGEFL1","17",40177010,40195656,18646
"7868","ENSG00000165917","ENSG00000165917","RAPSN","11",47437764,47449143,11379
"7869","ENSG00000131759","ENSG00000131759","RARA","17",40309180,40357643,48463
"7870","ENSG00000077092","ENSG00000077092","RARB","3",24687887,25597932,910045
"7871","ENSG00000172819","ENSG00000172819","RARG","12",53210567,53232980,22413
"7872","ENSG00000118849","ENSG00000118849","RARRES1","3",158696892,158732489,35597
"7873","ENSG00000106538","ENSG00000106538","RARRES2","7",150338317,150341662,3345
"7874","ENSG00000146282","ENSG00000146282","RARS2","6",87513459,87590028,76569
"7875","ENSG00000145715","ENSG00000145715","RASA1","5",87267883,87391931,124048
"7876","ENSG00000155903","ENSG00000155903","RASA2","3",141487027,141615344,128317
"7877","ENSG00000280477","ENSG00000280477","RASA3","HG2288_HG2289_PATCH",40809,191714,150905
"7878","ENSG00000105808","ENSG00000105808","RASA4","7",102579646,102616756,37110
"7879","ENSG00000170667","ENSG00000170667","RASA4B","7",102479976,102517777,37801
"7880","ENSG00000111344","ENSG00000111344","RASAL1","12",113098819,113136239,37420
"7881","ENSG00000075391","ENSG00000075391","RASAL2","1",178094104,178484147,390043
"7882","ENSG00000058335","ENSG00000058335","RASGRF1","15",78959906,79090780,130874
"7883","ENSG00000172575","ENSG00000172575","RASGRP1","15",38488103,38565575,77472
"7884","ENSG00000068831","ENSG00000068831","RASGRP2","11",64726911,64745456,18545
"7885","ENSG00000152689","ENSG00000152689","RASGRP3","2",33436324,33564750,128426
"7886","ENSG00000105538","ENSG00000105538","RASIP1","19",48720585,48740610,20025
"7887","ENSG00000100276","ENSG00000100276","RASL10A","22",29312933,29319679,6746
"7888","ENSG00000128045","ENSG00000128045","RASL11B","4",52862317,52866835,4518
"7889","ENSG00000103710","ENSG00000103710","RASL12","15",65053337,65076690,23353
"7890","ENSG00000068028","ENSG00000068028","RASSF1","3",50329782,50340980,11198
"7891","ENSG00000101265","ENSG00000101265","RASSF2","20",4780023,4823608,43585
"7892","ENSG00000107551","ENSG00000107551","RASSF4","10",44959407,44995891,36484
"7893","ENSG00000273859","ENSG00000273859","RASSF7","HSCHR11_1_CTG8",90059,93677,3618
"7894","ENSG00000123094","ENSG00000123094","RASSF8","12",25958232,26079892,121660
"7895","ENSG00000198774","ENSG00000198774","RASSF9","12",85800703,85836409,35706
"7896","ENSG00000162437","ENSG00000162437","RAVER2","1",64745075,64833232,88157
"7897","ENSG00000134438","ENSG00000134438","RAX","18",59267035,59274086,7051
"7898","ENSG00000139687","ENSG00000139687","RB1","13",48303744,48599436,295692
"7899","ENSG00000023287","ENSG00000023287","RB1CC1","8",52622458,52745843,123385
"7900","ENSG00000162521","ENSG00000162521","RBBP4","1",32651142,32686211,35069
"7901","ENSG00000117222","ENSG00000117222","RBBP5","1",205086142,205122015,35873
"7902","ENSG00000122257","ENSG00000122257","RBBP6","16",24537693,24572863,35170
"7903","ENSG00000102054","ENSG00000102054","RBBP7","X",16839283,16870362,31079
"7904","ENSG00000101773","ENSG00000101773","RBBP8","18",22798261,23026488,228227
"7905","ENSG00000089050","ENSG00000089050","RBBP9","20",18486540,18497225,10685
"7906","ENSG00000125826","ENSG00000125826","RBCK1","20",407498,432139,24641
"7907","ENSG00000101546","ENSG00000101546","RBFA","18",80034389,80050651,16262
"7908","ENSG00000078328","ENSG00000078328","RBFOX1","16",5239802,7713340,2473538
"7909","ENSG00000277564","ENSG00000277564","RBFOX2","HSCHR22_1_CTG4",59734,259895,200161
"7910","ENSG00000171174","ENSG00000171174","RBKS","2",27781379,27890681,109302
"7911","ENSG00000080839","ENSG00000080839","RBL1","20",36996349,37095997,99648
"7912","ENSG00000103479","ENSG00000103479","RBL2","16",53433977,53491648,57671
"7913","ENSG00000182872","ENSG00000182872","RBM10","X",47145221,47186813,41592
"7914","ENSG00000239306","ENSG00000239306","RBM14","11",66616626,66629934,13308
"7915","ENSG00000162775","ENSG00000162775","RBM15","1",110338506,110346681,8175
"7916","ENSG00000259956","ENSG00000259956","RBM15B","3",51391285,51397908,6623
"7917","ENSG00000134453","ENSG00000134453","RBM17","10",6089034,6117457,28423
"7918","ENSG00000122965","ENSG00000122965","RBM19","12",113816738,113966325,149587
"7919","ENSG00000086589","ENSG00000086589","RBM22","5",150690792,150701077,10285
"7920","ENSG00000100461","ENSG00000100461","RBM23","14",22893204,22919182,25978
"7921","ENSG00000119707","ENSG00000119707","RBM25","14",73058532,73123899,65367
"7922","ENSG00000139746","ENSG00000139746","RBM26","13",79311824,79406477,94653
"7923","ENSG00000106344","ENSG00000106344","RBM28","7",128297685,128343908,46223
"7924","ENSG00000102317","ENSG00000102317","RBM3","X",48574449,48581162,6713
"7925","ENSG00000188739","ENSG00000188739","RBM34","1",235131183,235161283,30100
"7926","ENSG00000132819","ENSG00000132819","RBM38","20",57391396,57409333,17937
"7927","ENSG00000131051","ENSG00000131051","RBM39","20",35701347,35742312,40965
"7928","ENSG00000173933","ENSG00000173933","RBM4","11",66638667,66668374,29707
"7929","ENSG00000089682","ENSG00000089682","RBM41","X",107052095,107118823,66728
"7930","ENSG00000126254","ENSG00000126254","RBM42","19",35629030,35637686,8656
"7931","ENSG00000163694","ENSG00000163694","RBM47","4",40423267,40630875,207608
"7932","ENSG00000127993","ENSG00000127993","RBM48","7",92528773,92540481,11708
"7933","ENSG00000173914","ENSG00000173914","RBM4B","11",66664998,66677887,12889
"7934","ENSG00000003756","ENSG00000003756","RBM5","3",50088919,50119021,30102
"7935","ENSG00000004534","ENSG00000004534","RBM6","3",49940007,50100045,160038
"7936","ENSG00000076053","ENSG00000076053","RBM7","11",114400030,114414203,14173
"7937","ENSG00000265241","ENSG00000265241","RBM8A","1",145921556,145927678,6122
"7938","ENSG00000153250","ENSG00000153250","RBMS1","2",160272151,160493807,221656
"7939","ENSG00000076067","ENSG00000076067","RBMS2","12",56521820,56596193,74373
"7940","ENSG00000144642","ENSG00000144642","RBMS3","3",28574791,30010391,1435600
"7941","ENSG00000147274","ENSG00000147274","RBMX","X",136848004,136880764,32760
"7942","ENSG00000134597","ENSG00000134597","RBMX2","X",130401987,130413656,11669
"7943","ENSG00000114115","ENSG00000114115","RBP1","3",139517434,139539829,22395
"7944","ENSG00000265203","ENSG00000265203","RBP3","10",47348363,47357881,9518
"7945","ENSG00000138207","ENSG00000138207","RBP4","10",93591687,93601744,10057
"7946","ENSG00000168214","ENSG00000168214","RBPJ","4",26163455,26435131,271676
"7947","ENSG00000124232","ENSG00000124232","RBPJL","20",45306840,45317824,10984
"7948","ENSG00000157110","ENSG00000157110","RBPMS","8",30384511,30572256,187745
"7949","ENSG00000100387","ENSG00000100387","RBX1","22",40951347,40973309,21962
"7950","ENSG00000056586","ENSG00000056586","RC3H2","9",122844556,122905359,60803
"7951","ENSG00000159200","ENSG00000159200","RCAN1","21",34513142,34615113,101971
"7952","ENSG00000172348","ENSG00000172348","RCAN2","6",46220736,46491972,271236
"7953","ENSG00000117602","ENSG00000117602","RCAN3","1",24502351,24541040,38689
"7954","ENSG00000136144","ENSG00000136144","RCBTB1","13",49531946,49585558,53612
"7955","ENSG00000136161","ENSG00000136161","RCBTB2","13",48488963,48533256,44293
"7956","ENSG00000180198","ENSG00000180198","RCC1","1",28505943,28539300,33357
"7957","ENSG00000274523","ENSG00000274523","RCC1L","7",75027122,75074228,47106
"7958","ENSG00000173653","ENSG00000173653","RCE1","11",66842835,66846552,3717
"7959","ENSG00000163743","ENSG00000163743","RCHY1","4",75479033,75514764,35731
"7960","ENSG00000120158","ENSG00000120158","RCL1","9",4792944,4885917,92973
"7961","ENSG00000049449","ENSG00000049449","RCN1","11",32091074,32105722,14648
"7962","ENSG00000117906","ENSG00000117906","RCN2","15",76931738,76954393,22655
"7963","ENSG00000142552","ENSG00000142552","RCN3","19",49528003,49546962,18959
"7964","ENSG00000089902","ENSG00000089902","RCOR1","14",102592649,102730561,137912
"7965","ENSG00000117625","ENSG00000117625","RCOR3","1",211258377,211316385,58008
"7966","ENSG00000109047","ENSG00000109047","RCVRN","17",9896320,9905271,8951
"7967","ENSG00000072042","ENSG00000072042","RDH11","14",67676800,67695793,18993
"7968","ENSG00000240857","ENSG00000240857","RDH14","2",18554723,18560679,5956
"7969","ENSG00000139547","ENSG00000139547","RDH16","12",56951431,56959374,7943
"7970","ENSG00000135437","ENSG00000135437","RDH5","12",55720367,55724705,4338
"7971","ENSG00000080511","ENSG00000080511","RDH8","19",10013249,10022279,9030
"7972","ENSG00000137710","ENSG00000137710","RDX","11",109864295,110296712,432417
"7973","ENSG00000100918","ENSG00000100918","REC8","14",24171853,24180257,8404
"7974","ENSG00000122707","ENSG00000122707","RECK","9",36036913,36124455,87542
"7975","ENSG00000004700","ENSG00000004700","RECQL","12",21468910,21501669,32759
"7976","ENSG00000160957","ENSG00000160957","RECQL4","8",144511288,144517845,6557
"7977","ENSG00000108469","ENSG00000108469","RECQL5","17",75626845,75667189,40344
"7978","ENSG00000068615","ENSG00000068615","REEP1","2",86213993,86338083,124090
"7979","ENSG00000132563","ENSG00000132563","REEP2","5",138439057,138446969,7912
"7980","ENSG00000168476","ENSG00000168476","REEP4","8",22138020,22141951,3931
"7981","ENSG00000129625","ENSG00000129625","REEP5","5",112876385,112922289,45904
"7982","ENSG00000115386","ENSG00000115386","REG1A","2",79120362,79123409,3047
"7983","ENSG00000172023","ENSG00000172023","REG1B","2",79085023,79088019,2996
"7984","ENSG00000172016","ENSG00000172016","REG3A","2",79157003,79159753,2750
"7985","ENSG00000162924","ENSG00000162924","REL","2",60881491,60931612,50121
"7986","ENSG00000173039","ENSG00000173039","RELA","11",65653599,65663090,9491
"7987","ENSG00000104856","ENSG00000104856","RELB","19",45001461,45038192,36731
"7988","ENSG00000189056","ENSG00000189056","RELN","7",103471381,103989658,518277
"7989","ENSG00000088320","ENSG00000088320","REM1","20",31475288,31484895,9607
"7990","ENSG00000143839","ENSG00000143839","REN","1",204154819,204190324,35505
"7991","ENSG00000102032","ENSG00000102032","RENBP","X",153935269,153944687,9418
"7992","ENSG00000214022","ENSG00000214022","REPIN1","7",150368189,150374044,5855
"7993","ENSG00000135597","ENSG00000135597","REPS1","6",138903493,138988261,84768
"7994","ENSG00000169891","ENSG00000169891","REPS2","X",16946658,17153272,206614
"7995","ENSG00000157916","ENSG00000157916","RER1","1",2391775,2405442,13667
"7996","ENSG00000142599","ENSG00000142599","RERE","1",8352397,8848921,496524
"7997","ENSG00000111404","ENSG00000111404","RERGL","12",18080869,18320107,239238
"7998","ENSG00000084093","ENSG00000084093","REST","4",56907876,56966808,58932
"7999","ENSG00000165731","ENSG00000165731","RET","10",43077064,43130351,53287
"8000","ENSG00000104918","ENSG00000104918","RETN","19",7669049,7670455,1406
"8001","ENSG00000042445","ENSG00000042445","RETSAT","2",85341955,85354531,12576
"8002","ENSG00000135945","ENSG00000135945","REV1","2",99400475,99490035,89560
"8003","ENSG00000009413","ENSG00000009413","REV3L","6",111299028,111483715,184687
"8004","ENSG00000076043","ENSG00000076043","REXO2","11",114439435,114450279,10844
"8005","ENSG00000148300","ENSG00000148300","REXO4","9",133406059,133418096,12037
"8006","ENSG00000035928","ENSG00000035928","RFC1","4",39287456,39366375,78919
"8007","ENSG00000049541","ENSG00000049541","RFC2","7",74231499,74254458,22959
"8008","ENSG00000133119","ENSG00000133119","RFC3","13",33818069,33966558,148489
"8009","ENSG00000163918","ENSG00000163918","RFC4","3",186789880,186807058,17178
"8010","ENSG00000111445","ENSG00000111445","RFC5","12",118013588,118033130,19542
"8011","ENSG00000135002","ENSG00000135002","RFK","9",76385526,76394517,8991
"8012","ENSG00000169733","ENSG00000169733","RFNG","17",82047902,82051831,3929
"8013","ENSG00000128250","ENSG00000128250","RFPL1","22",29438583,29442455,3872
"8014","ENSG00000128253","ENSG00000128253","RFPL2","22",32190435,32205073,14638
"8015","ENSG00000131378","ENSG00000131378","RFTN1","3",16313574,16514026,200452
"8016","ENSG00000168411","ENSG00000168411","RFWD3","16",74621399,74666877,45478
"8017","ENSG00000132005","ENSG00000132005","RFX1","19",13961530,14007039,45509
"8018","ENSG00000087903","ENSG00000087903","RFX2","19",5993164,6199572,206408
"8019","ENSG00000080298","ENSG00000080298","RFX3","9",3218297,3526004,307707
"8020","ENSG00000111783","ENSG00000111783","RFX4","12",106583004,106762803,179799
"8021","ENSG00000143390","ENSG00000143390","RFX5","1",151340640,151347326,6686
"8022","ENSG00000181827","ENSG00000181827","RFX7","15",56087280,56245082,157802
"8023","ENSG00000064490","ENSG00000064490","RFXANK","19",19192229,19201869,9640
"8024","ENSG00000133111","ENSG00000133111","RFXAP","13",36819222,36829104,9882
"8025","ENSG00000102760","ENSG00000102760","RGCC","13",41457550,41470871,13321
"8026","ENSG00000143344","ENSG00000143344","RGL1","1",183636085,183928532,292447
"8027","ENSG00000237825","ENSG00000237825","RGL2","HSCHR6_MHC_DBB_CTG1",4535172,4542842,7670
"8028","ENSG00000205517","ENSG00000205517","RGL3","19",11384341,11419328,34987
"8029","ENSG00000130988","ENSG00000130988","RGN","X",47078355,47093314,14959
"8030","ENSG00000107185","ENSG00000107185","RGP1","9",35749287,35758585,9298
"8031","ENSG00000015568","ENSG00000015568","RGPD5","2",109792758,109857705,64947
"8032","ENSG00000148604","ENSG00000148604","RGR","10",84230666,84259960,29294
"8033","ENSG00000090104","ENSG00000090104","RGS1","1",192575763,192580024,4261
"8034","ENSG00000148908","ENSG00000148908","RGS10","10",119499817,119542719,42902
"8035","ENSG00000076344","ENSG00000076344","RGS11","16",268301,275980,7679
"8036","ENSG00000159788","ENSG00000159788","RGS12","4",3293021,3439913,146892
"8037","ENSG00000127074","ENSG00000127074","RGS13","1",192636138,192660311,24173
"8038","ENSG00000169220","ENSG00000169220","RGS14","5",177357924,177372596,14672
"8039","ENSG00000143333","ENSG00000143333","RGS16","1",182598623,182604389,5766
"8040","ENSG00000091844","ENSG00000091844","RGS17","6",153004459,153131282,126823
"8041","ENSG00000171700","ENSG00000171700","RGS19","20",64073181,64079988,6807
"8042","ENSG00000116741","ENSG00000116741","RGS2","1",192809039,192812275,3236
"8043","ENSG00000147509","ENSG00000147509","RGS20","8",53851795,53959303,107508
"8044","ENSG00000138835","ENSG00000138835","RGS3","9",113444731,113597743,153012
"8045","ENSG00000117152","ENSG00000117152","RGS4","1",163068775,163076802,8027
"8046","ENSG00000143248","ENSG00000143248","RGS5","1",163111121,163321791,210670
"8047","ENSG00000182732","ENSG00000182732","RGS6","14",71932429,72566530,634101
"8048","ENSG00000182901","ENSG00000182901","RGS7","1",240767636,241357374,589738
"8049","ENSG00000108370","ENSG00000108370","RGS9","17",65100812,65227703,126891
"8050","ENSG00000121446","ENSG00000121446","RGSL1","1",182409192,182560599,151407
"8051","ENSG00000112077","ENSG00000112077","RHAG","6",49605175,49636839,31664
"8052","ENSG00000100263","ENSG00000100263","RHBDD3","22",29259872,29268209,8337
"8053","ENSG00000007384","ENSG00000007384","RHBDF1","16",58059,76355,18296
"8054","ENSG00000129667","ENSG00000129667","RHBDF2","17",76470891,76501790,30899
"8055","ENSG00000103269","ENSG00000103269","RHBDL1","16",675671,678268,2597
"8056","ENSG00000158315","ENSG00000158315","RHBDL2","1",38885807,38941830,56023
"8057","ENSG00000132677","ENSG00000132677","RHBG","1",156369211,156385219,16008
"8058","ENSG00000188672","ENSG00000188672","RHCE","1",25362249,25430192,67943
"8059","ENSG00000140519","ENSG00000140519","RHCG","15",89471398,89496589,25191
"8060","ENSG00000187010","ENSG00000187010","RHD","1",25272393,25330445,58052
"8061","ENSG00000106615","ENSG00000106615","RHEB","7",151466012,151520120,54108
"8062","ENSG00000067560","ENSG00000067560","RHOA","3",49359139,49412998,53859
"8063","ENSG00000143878","ENSG00000143878","RHOB","2",20447074,20449440,2366
"8064","ENSG00000072422","ENSG00000072422","RHOBTB1","10",60869438,61001440,132002
"8065","ENSG00000008853","ENSG00000008853","RHOBTB2","8",22987417,23020509,33092
"8066","ENSG00000164292","ENSG00000164292","RHOBTB3","5",95713522,95824383,110861
"8067","ENSG00000155366","ENSG00000155366","RHOC","1",112701127,112707434,6307
"8068","ENSG00000173156","ENSG00000173156","RHOD","11",67056847,67072017,15170
"8069","ENSG00000139725","ENSG00000139725","RHOF","12",121777754,121803403,25649
"8070","ENSG00000177105","ENSG00000177105","RHOG","11",3826978,3840959,13981
"8071","ENSG00000168421","ENSG00000168421","RHOH","4",40191011,40246967,55956
"8072","ENSG00000119729","ENSG00000119729","RHOQ","2",46541806,46584688,42882
"8073","ENSG00000126858","ENSG00000126858","RHOT1","17",32142454,32253374,110920
"8074","ENSG00000140983","ENSG00000140983","RHOT2","16",668100,674174,6074
"8075","ENSG00000128408","ENSG00000128408","RIBC2","22",45413693,45432509,18816
"8076","ENSG00000166405","ENSG00000166405","RIC3","11",8106056,8169055,62999
"8077","ENSG00000177963","ENSG00000177963","RIC8A","11",207708,215113,7405
"8078","ENSG00000111785","ENSG00000111785","RIC8B","12",106774621,106889316,114695
"8079","ENSG00000132541","ENSG00000132541","RIDA","8",98102344,98117171,14827
"8080","ENSG00000080345","ENSG00000080345","RIF1","2",151409883,151508013,98130
"8081","ENSG00000060709","ENSG00000060709","RIMBP2","12",130396133,130768228,372095
"8082","ENSG00000079841","ENSG00000079841","RIMS1","6",71886550,72403150,516600
"8083","ENSG00000176406","ENSG00000176406","RIMS2","8",103500610,104254430,753820
"8084","ENSG00000117016","ENSG00000117016","RIMS3","1",40620680,40665682,45002
"8085","ENSG00000174791","ENSG00000174791","RIN1","11",66330241,66336840,6599
"8086","ENSG00000132669","ENSG00000132669","RIN2","20",19757606,20002457,244851
"8087","ENSG00000100599","ENSG00000100599","RIN3","14",92513781,92688994,175213
"8088","ENSG00000235107","ENSG00000235107","RING1","HSCHR6_MHC_MANN_CTG1",4627972,4632199,4227
"8089","ENSG00000135249","ENSG00000135249","RINT1","7",105532169,105567677,35508
"8090","ENSG00000058729","ENSG00000058729","RIOK2","5",97160867,97183247,22380
"8091","ENSG00000101782","ENSG00000101782","RIOK3","18",23453287,23486603,33316
"8092","ENSG00000104312","ENSG00000104312","RIPK2","8",89757806,89791064,33258
"8093","ENSG00000183421","ENSG00000183421","RIPK4","21",41739369,41767089,27720
"8094","ENSG00000183145","ENSG00000183145","RIPPLY3","21",37006150,37019662,13512
"8095","ENSG00000143622","ENSG00000143622","RIT1","1",155897808,155911404,13596
"8096","ENSG00000152214","ENSG00000152214","RIT2","18",42743227,43115691,372464
"8097","ENSG00000139405","ENSG00000139405","RITA1","12",113185526,113192368,6842
"8098","ENSG00000140522","ENSG00000140522","RLBP1","15",89209869,89221614,11745
"8099","ENSG00000117000","ENSG00000117000","RLF","1",40161387,40240921,79534
"8100","ENSG00000131263","ENSG00000131263","RLIM","X",74582976,74614624,31648
"8101","ENSG00000107014","ENSG00000107014","RLN2","9",5299864,5304716,4852
"8102","ENSG00000176623","ENSG00000176623","RMDN1","8",86468257,86514357,46100
"8103","ENSG00000137824","ENSG00000137824","RMDN3","15",40735884,40755851,19967
"8104","ENSG00000178966","ENSG00000178966","RMI1","9",83980798,84004074,23276
"8105","ENSG00000155906","ENSG00000155906","RMND1","6",151398898,151452158,53260
"8106","ENSG00000153561","ENSG00000153561","RMND5A","2",86720291,86778041,57750
"8107","ENSG00000145916","ENSG00000145916","RMND5B","5",178130996,178150568,19572
"8108","ENSG00000129538","ENSG00000129538","RNASE1","14",20801228,20802855,1627
"8109","ENSG00000169385","ENSG00000169385","RNASE2","14",20955487,20956436,949
"8110","ENSG00000169397","ENSG00000169397","RNASE3","14",20891385,20892348,963
"8111","ENSG00000258818","ENSG00000258818","RNASE4","14",20684560,20701216,16656
"8112","ENSG00000169413","ENSG00000169413","RNASE6","14",20781268,20782467,1199
"8113","ENSG00000171865","ENSG00000171865","RNASEH1","2",3541430,3558333,16903
"8114","ENSG00000104889","ENSG00000104889","RNASEH2A","19",12806584,12813640,7056
"8115","ENSG00000136104","ENSG00000136104","RNASEH2B","13",50909747,51024120,114373
"8116","ENSG00000135828","ENSG00000135828","RNASEL","1",182573634,182589256,15622
"8117","ENSG00000026297","ENSG00000026297","RNASET2","6",166922113,166957191,35078
"8118","ENSG00000172602","ENSG00000172602","RND1","12",48857145,48865870,8725
"8119","ENSG00000108830","ENSG00000108830","RND2","17",43025231,43032041,6810
"8120","ENSG00000115963","ENSG00000115963","RND3","2",150468195,150539011,70816
"8121","ENSG00000022840","ENSG00000022840","RNF10","12",120533480,120577588,44108
"8122","ENSG00000239305","ENSG00000239305","RNF103","2",86603398,86623866,20468
"8123","ENSG00000123091","ENSG00000123091","RNF11","1",51236273,51273447,37174
"8124","ENSG00000157450","ENSG00000157450","RNF111","15",58865175,59097419,232244
"8125","ENSG00000125352","ENSG00000125352","RNF113A","X",119870475,119871733,1258
"8126","ENSG00000124226","ENSG00000124226","RNF114","20",49936336,49953885,17549
"8127","ENSG00000265491","ENSG00000265491","RNF115","1",145738868,145824095,85227
"8128","ENSG00000137522","ENSG00000137522","RNF121","11",71929018,71997597,68579
"8129","ENSG00000133874","ENSG00000133874","RNF122","8",33547754,33567128,19374
"8130","ENSG00000164068","ENSG00000164068","RNF123","3",49689538,49721529,31991
"8131","ENSG00000101695","ENSG00000101695","RNF125","18",32018825,32073219,54394
"8132","ENSG00000070423","ENSG00000070423","RNF126","19",647526,663233,15707
"8133","ENSG00000133135","ENSG00000133135","RNF128","X",106693794,106797016,103222
"8134","ENSG00000082996","ENSG00000082996","RNF13","3",149812770,149962139,149369
"8135","ENSG00000113269","ENSG00000113269","RNF130","5",179911651,180072113,160462
"8136","ENSG00000134758","ENSG00000134758","RNF138","18",32091874,32131561,39687
"8137","ENSG00000170881","ENSG00000170881","RNF139","8",124474880,124488618,13738
"8138","ENSG00000013561","ENSG00000013561","RNF14","5",141958328,141990292,31964
"8139","ENSG00000110315","ENSG00000110315","RNF141","11",10511673,10541230,29557
"8140","ENSG00000151692","ENSG00000151692","RNF144A","2",6917412,7068286,150874
"8141","ENSG00000118518","ENSG00000118518","RNF146","6",127266726,127288567,21841
"8142","ENSG00000108523","ENSG00000108523","RNF167","17",4940008,4945222,5214
"8143","ENSG00000132972","ENSG00000132972","RNF17","13",24764169,24879921,115752
"8144","ENSG00000120925","ENSG00000120925","RNF170","8",42849637,42897290,47653
"8145","ENSG00000178828","ENSG00000178828","RNF186","1",19814029,19815283,1254
"8146","ENSG00000034677","ENSG00000034677","RNF19A","8",100257060,100336218,79158
"8147","ENSG00000121481","ENSG00000121481","RNF2","1",185045497,185102603,57106
"8148","ENSG00000212864","ENSG00000212864","RNF208","9",137220247,137222240,1993
"8149","ENSG00000011275","ENSG00000011275","RNF216","7",5620047,5781696,161649
"8150","ENSG00000187147","ENSG00000187147","RNF220","1",44405194,44651723,246529
"8151","ENSG00000101236","ENSG00000101236","RNF24","20",3927309,4015558,88249
"8152","ENSG00000163481","ENSG00000163481","RNF25","2",218663892,218672002,8110
"8153","ENSG00000092098","ENSG00000092098","RNF31","14",24146683,24160660,13977
"8154","ENSG00000105982","ENSG00000105982","RNF32","7",156640281,156677130,36849
"8155","ENSG00000170633","ENSG00000170633","RNF34","12",121400083,121430623,30540
"8156","ENSG00000137075","ENSG00000137075","RNF38","9",36336396,36487548,151152
"8157","ENSG00000237733","ENSG00000237733","RNF39","HSCHR6_MHC_MANN_CTG1",1331016,1336637,5621
"8158","ENSG00000063978","ENSG00000063978","RNF4","4",2462220,2515857,53637
"8159","ENSG00000103549","ENSG00000103549","RNF40","16",30761745,30776307,14562
"8160","ENSG00000181852","ENSG00000181852","RNF41","12",56202179,56221933,19754
"8161","ENSG00000108375","ENSG00000108375","RNF43","17",58353676,58417595,63919
"8162","ENSG00000146083","ENSG00000146083","RNF44","5",176526712,176538025,11313
"8163","ENSG00000228907","ENSG00000228907","RNF5","HSCHR6_MHC_MANN_CTG1",3483335,3485774,2439
"8164","ENSG00000127870","ENSG00000127870","RNF6","13",26132115,26222314,90199
"8165","ENSG00000114125","ENSG00000114125","RNF7","3",141738249,141747560,9311
"8166","ENSG00000112130","ENSG00000112130","RNF8","6",37353979,37394734,40755
"8167","ENSG00000189050","ENSG00000189050","RNFT1","17",59952240,59964761,12521
"8168","ENSG00000135119","ENSG00000135119","RNFT2","12",116738178,116853631,115453
"8169","ENSG00000111880","ENSG00000111880","RNGTT","6",88609897,88963618,353721
"8170","ENSG00000276230","ENSG00000276230","RNH1","HSCHR11_1_CTG8",24153,36941,12788
"8171","ENSG00000184719","ENSG00000184719","RNLS","10",88273864,88584530,310666
"8172","ENSG00000101654","ENSG00000101654","RNMT","18",13726660,13764556,37896
"8173","ENSG00000176393","ENSG00000176393","RNPEP","1",201982372,202006147,23775
"8174","ENSG00000205937","ENSG00000205937","RNPS1","16",2253116,2268397,15281
"8175","ENSG00000169855","ENSG00000169855","ROBO1","3",78597239,79767998,1170759
"8176","ENSG00000154134","ENSG00000154134","ROBO3","11",124865432,124881471,16039
"8177","ENSG00000154133","ENSG00000154133","ROBO4","11",124883691,124898500,14809
"8178","ENSG00000067900","ENSG00000067900","ROCK1","18",20944612,21111813,167201
"8179","ENSG00000134318","ENSG00000134318","ROCK2","2",11179759,11348330,168571
"8180","ENSG00000067836","ENSG00000067836","ROGDI","16",4796968,4802880,5912
"8181","ENSG00000149489","ENSG00000149489","ROM1","11",62611722,62615116,3394
"8182","ENSG00000065371","ENSG00000065371","ROPN1","3",123968521,123992178,23657
"8183","ENSG00000185483","ENSG00000185483","ROR1","1",63774017,64181498,407481
"8184","ENSG00000169071","ENSG00000169071","ROR2","9",91563091,91950228,387137
"8185","ENSG00000069667","ENSG00000069667","RORA","15",60488284,61229302,741018
"8186","ENSG00000198963","ENSG00000198963","RORB","9",74497335,74693177,195842
"8187","ENSG00000143365","ENSG00000143365","RORC","1",151806071,151831845,25774
"8188","ENSG00000047936","ENSG00000047936","ROS1","6",117287353,117425942,138589
"8189","ENSG00000102218","ENSG00000102218","RP2","X",46837043,46882358,45315
"8190","ENSG00000132383","ENSG00000132383","RPA1","17",1829702,1900082,70380
"8191","ENSG00000117748","ENSG00000117748","RPA2","1",27891524,27914746,23222
"8192","ENSG00000106399","ENSG00000106399","RPA3","7",7636518,7718607,82089
"8193","ENSG00000204086","ENSG00000204086","RPA4","X",96883908,96885467,1559
"8194","ENSG00000129197","ENSG00000129197","RPAIN","17",5419641,5432877,13236
"8195","ENSG00000103932","ENSG00000103932","RPAP1","15",41517176,41544269,27093
"8196","ENSG00000122484","ENSG00000122484","RPAP2","1",92299059,92402056,102997
"8197","ENSG00000005175","ENSG00000005175","RPAP3","12",47661249,47706030,44781
"8198","ENSG00000197713","ENSG00000197713","RPE","2",210002565,210022260,19695
"8199","ENSG00000116745","ENSG00000116745","RPE65","1",68428822,68451103,22281
"8200","ENSG00000117133","ENSG00000117133","RPF1","1",84479259,84498352,19093
"8201","ENSG00000156313","ENSG00000156313","RPGR","X",38269163,38327544,58381
"8202","ENSG00000092200","ENSG00000092200","RPGRIP1","14",21280083,21351301,71218
"8203","ENSG00000103494","ENSG00000103494","RPGRIP1L","16",53598153,53703938,105785
"8204","ENSG00000089169","ENSG00000089169","RPH3A","12",112570380,112898881,328501
"8205","ENSG00000262334","ENSG00000262334","RPH3AL","HSCHR17_1_CTG1",157541,359308,201767
"8206","ENSG00000153574","ENSG00000153574","RPIA","2",88691673,88750929,59256
"8207","ENSG00000198755","ENSG00000198755","RPL10A","6",35468401,35470785,2384
"8208","ENSG00000142676","ENSG00000142676","RPL11","1",23691742,23696835,5093
"8209","ENSG00000197958","ENSG00000197958","RPL12","9",127447674,127451406,3732
"8210","ENSG00000142541","ENSG00000142541","RPL13A","19",49487510,49493057,5547
"8211","ENSG00000188846","ENSG00000188846","RPL14","3",40457292,40468587,11295
"8212","ENSG00000174748","ENSG00000174748","RPL15","3",23916591,23924374,7783
"8213","ENSG00000265681","ENSG00000265681","RPL17","18",49488453,49492508,4055
"8214","ENSG00000105640","ENSG00000105640","RPL18A","19",17859910,17864153,4243
"8215","ENSG00000108298","ENSG00000108298","RPL19","17",39200283,39204840,4557
"8216","ENSG00000122026","ENSG00000122026","RPL21","13",27251362,27256691,5329
"8217","ENSG00000116251","ENSG00000116251","RPL22","1",6185020,6209389,24369
"8218","ENSG00000125691","ENSG00000125691","RPL23","17",38847860,38853764,5904
"8219","ENSG00000198242","ENSG00000198242","RPL23A","17",28719985,28724359,4374
"8220","ENSG00000114391","ENSG00000114391","RPL24","3",101681091,101686733,5642
"8221","ENSG00000037241","ENSG00000037241","RPL26L1","5",172958729,172969771,11042
"8222","ENSG00000131469","ENSG00000131469","RPL27","17",42998273,43002959,4686
"8223","ENSG00000166441","ENSG00000166441","RPL27A","11",8682788,8714759,31971
"8224","ENSG00000108107","ENSG00000108107","RPL28","19",55385932,55403250,17318
"8225","ENSG00000162244","ENSG00000162244","RPL29","3",51993522,51995895,2373
"8226","ENSG00000100316","ENSG00000100316","RPL3","22",39312882,39320389,7507
"8227","ENSG00000156482","ENSG00000156482","RPL30","8",98024851,98046469,21618
"8228","ENSG00000144713","ENSG00000144713","RPL32","3",12834485,12841582,7097
"8229","ENSG00000109475","ENSG00000109475","RPL34","4",108620569,108630412,9843
"8230","ENSG00000136942","ENSG00000136942","RPL35","9",124857880,124861981,4101
"8231","ENSG00000182899","ENSG00000182899","RPL35A","3",197950190,197956610,6420
"8232","ENSG00000130255","ENSG00000130255","RPL36","19",5674947,5691875,16928
"8233","ENSG00000241343","ENSG00000241343","RPL36A","X",101390824,101396155,5331
"8234","ENSG00000165502","ENSG00000165502","RPL36AL","14",49618530,49620626,2096
"8235","ENSG00000145592","ENSG00000145592","RPL37","5",40825262,40835222,9960
"8236","ENSG00000197756","ENSG00000197756","RPL37A","2",216498825,216579180,80355
"8237","ENSG00000172809","ENSG00000172809","RPL38","17",74203582,74210655,7073
"8238","ENSG00000198918","ENSG00000198918","RPL39","X",119786504,119791630,5126
"8239","ENSG00000163923","ENSG00000163923","RPL39L","3",187120948,187180908,59960
"8240","ENSG00000140986","ENSG00000140986","RPL3L","16",1943974,1957606,13632
"8241","ENSG00000174444","ENSG00000174444","RPL4","15",66498015,66524532,26517
"8242","ENSG00000229117","ENSG00000229117","RPL41","12",56116590,56117967,1377
"8243","ENSG00000122406","ENSG00000122406","RPL5","1",92832013,92841924,9911
"8244","ENSG00000089009","ENSG00000089009","RPL6","12",112405189,112418838,13649
"8245","ENSG00000147604","ENSG00000147604","RPL7","8",73290242,73295789,5547
"8246","ENSG00000280858","ENSG00000280858","RPL7A","HG2030_PATCH",174312,177520,3208
"8247","ENSG00000161016","ENSG00000161016","RPL8","8",144789765,144792587,2822
"8248","ENSG00000089157","ENSG00000089157","RPLP0","12",120196699,120201235,4536
"8249","ENSG00000137818","ENSG00000137818","RPLP1","15",69452814,69456205,3391
"8250","ENSG00000177600","ENSG00000177600","RPLP2","11",809965,812880,2915
"8251","ENSG00000163902","ENSG00000163902","RPN1","3",128619969,128681075,61106
"8252","ENSG00000118705","ENSG00000118705","RPN2","20",37178410,37241619,63209
"8253","ENSG00000163684","ENSG00000163684","RPP14","3",58306245,58324695,18450
"8254","ENSG00000243009","ENSG00000243009","RPP21","HSCHR6_MHC_DBB_CTG1",1585152,1602730,17578
"8255","ENSG00000178718","ENSG00000178718","RPP25","15",74954418,74956772,2354
"8256","ENSG00000148688","ENSG00000148688","RPP30","10",90871952,90908553,36601
"8257","ENSG00000152464","ENSG00000152464","RPP38","10",15097180,15139818,42638
"8258","ENSG00000124787","ENSG00000124787","RPP40","6",4994717,5004063,9346
"8259","ENSG00000141425","ENSG00000141425","RPRD1A","18",35984387,36067576,83189
"8260","ENSG00000163125","ENSG00000163125","RPRD2","1",150363091,150476566,113475
"8261","ENSG00000177519","ENSG00000177519","RPRM","2",153477338,153478762,1424
"8262","ENSG00000124614","ENSG00000124614","RPS10","6",34417454,34426069,8615
"8263","ENSG00000142534","ENSG00000142534","RPS11","19",49496365,49499708,3343
"8264","ENSG00000112306","ENSG00000112306","RPS12","6",132814569,132817564,2995
"8265","ENSG00000110700","ENSG00000110700","RPS13","11",17074388,17077715,3327
"8266","ENSG00000164587","ENSG00000164587","RPS14","5",150442635,150449739,7104
"8267","ENSG00000134419","ENSG00000134419","RPS15A","16",18781295,18790383,9088
"8268","ENSG00000105193","ENSG00000105193","RPS16","19",39433137,39435949,2812
"8269","ENSG00000278229","ENSG00000278229","RPS17","HSCHR15_5_CTG8",325859,329670,3811
"8270","ENSG00000235650","ENSG00000235650","RPS18","HSCHR6_MHC_COX_CTG1",4683491,4687991,4500
"8271","ENSG00000105372","ENSG00000105372","RPS19","19",41860255,41872925,12670
"8272","ENSG00000140988","ENSG00000140988","RPS2","16",1962058,1964841,2783
"8273","ENSG00000008988","ENSG00000008988","RPS20","8",56067254,56074510,7256
"8274","ENSG00000186468","ENSG00000186468","RPS23","5",82273320,82278396,5076
"8275","ENSG00000138326","ENSG00000138326","RPS24","10",78033760,78056813,23053
"8276","ENSG00000280831","ENSG00000280831","RPS25","HG2217_PATCH",37312,40291,2979
"8277","ENSG00000197728","ENSG00000197728","RPS26","12",56041351,56044697,3346
"8278","ENSG00000177954","ENSG00000177954","RPS27","1",153990762,153992155,1393
"8279","ENSG00000185088","ENSG00000185088","RPS27L","15",63125872,63158021,32149
"8280","ENSG00000233927","ENSG00000233927","RPS28","19",8321158,8323340,2182
"8281","ENSG00000213741","ENSG00000213741","RPS29","14",49570984,49599164,28180
"8282","ENSG00000149273","ENSG00000149273","RPS3","11",75399515,75422280,22765
"8283","ENSG00000145425","ENSG00000145425","RPS3A","4",151099624,151104642,5018
"8284","ENSG00000198034","ENSG00000198034","RPS4X","X",72255679,72277248,21569
"8285","ENSG00000129824","ENSG00000129824","RPS4Y1","Y",2841602,2932000,90398
"8286","ENSG00000083845","ENSG00000083845","RPS5","19",58386400,58394806,8406
"8287","ENSG00000281877","ENSG00000281877","RPS6KA1","HG2058_PATCH",17379,62648,45269
"8288","ENSG00000071242","ENSG00000071242","RPS6KA2","6",166409364,166906451,497087
"8289","ENSG00000177189","ENSG00000177189","RPS6KA3","X",20149911,20267519,117608
"8290","ENSG00000162302","ENSG00000162302","RPS6KA4","11",64359148,64372215,13067
"8291","ENSG00000100784","ENSG00000100784","RPS6KA5","14",90847861,91060641,212780
"8292","ENSG00000072133","ENSG00000072133","RPS6KA6","X",84058346,84206356,148010
"8293","ENSG00000108443","ENSG00000108443","RPS6KB1","17",59893046,59950574,57528
"8294","ENSG00000175634","ENSG00000175634","RPS6KB2","11",67428460,67435401,6941
"8295","ENSG00000136643","ENSG00000136643","RPS6KC1","1",213051233,213274774,223541
"8296","ENSG00000171863","ENSG00000171863","RPS7","2",3575260,3580920,5660
"8297","ENSG00000142937","ENSG00000142937","RPS8","1",44775251,44778779,3528
"8298","ENSG00000278270","ENSG00000278270","RPS9","HSCHR19_4_CTG3_1",175724,223976,48252
"8299","ENSG00000168028","ENSG00000168028","RPSA","3",39406716,39426255,19539
"8300","ENSG00000166133","ENSG00000166133","RPUSD2","15",40569299,40574949,5650
"8301","ENSG00000166592","ENSG00000166592","RRAD","16",66921685,66925535,3850
"8302","ENSG00000155876","ENSG00000155876","RRAGA","9",19049427,19051025,1598
"8303","ENSG00000083750","ENSG00000083750","RRAGB","X",55717749,55758774,41025
"8304","ENSG00000116954","ENSG00000116954","RRAGC","1",38838198,38859772,21574
"8305","ENSG00000025039","ENSG00000025039","RRAGD","6",89364616,89412273,47657
"8306","ENSG00000126458","ENSG00000126458","RRAS","19",49635292,49640143,4851
"8307","ENSG00000133818","ENSG00000133818","RRAS2","11",14277922,14364506,86584
"8308","ENSG00000125844","ENSG00000125844","RRBP1","20",17613678,17682295,68617
"8309","ENSG00000124782","ENSG00000124782","RREB1","6",7107597,7251980,144383
"8310","ENSG00000180245","ENSG00000180245","RRH","4",109827972,109849123,21151
"8311","ENSG00000167325","ENSG00000167325","RRM1","11",4094707,4138932,44225
"8312","ENSG00000171848","ENSG00000171848","RRM2","2",10120698,10211725,91027
"8313","ENSG00000160214","ENSG00000160214","RRP1","21",43789513,43805293,15780
"8314","ENSG00000052749","ENSG00000052749","RRP12","10",97356358,97426076,69718
"8315","ENSG00000067533","ENSG00000067533","RRP15","1",218285293,218337983,52690
"8316","ENSG00000160208","ENSG00000160208","RRP1B","21",43659560,43696079,36519
"8317","ENSG00000189306","ENSG00000189306","RRP7A","22",42508344,42519796,11452
"8318","ENSG00000132275","ENSG00000132275","RRP8","11",6595072,6603616,8544
"8319","ENSG00000114767","ENSG00000114767","RRP9","3",51933429,51941904,8475
"8320","ENSG00000179041","ENSG00000179041","RRS1","8",66429014,66430733,1719
"8321","ENSG00000136444","ENSG00000136444","RSAD1","17",50478860,50485974,7114
"8322","ENSG00000134321","ENSG00000134321","RSAD2","2",6865557,6898239,32682
"8323","ENSG00000081019","ENSG00000081019","RSBN1","1",113761832,113812476,50644
"8324","ENSG00000048649","ENSG00000048649","RSF1","11",77660009,77820869,160860
"8325","ENSG00000171490","ENSG00000171490","RSL1D1","16",11833850,11851580,17730
"8326","ENSG00000137876","ENSG00000137876","RSL24D1","15",55180806,55197049,16243
"8327","ENSG00000100218","ENSG00000100218","RSPH14","22",23059415,23145021,85606
"8328","ENSG00000104941","ENSG00000104941","RSPH6A","19",45795713,45815308,19595
"8329","ENSG00000174891","ENSG00000174891","RSRC1","3",158105855,158545730,439875
"8330","ENSG00000111011","ENSG00000111011","RSRC2","12",122503454,122527000,23546
"8331","ENSG00000117616","ENSG00000117616","RSRP1","1",25242249,25338213,95964
"8332","ENSG00000148484","ENSG00000148484","RSU1","10",16590611,16817463,226852
"8333","ENSG00000137996","ENSG00000137996","RTCA","1",100266216,100292769,26553
"8334","ENSG00000100220","ENSG00000100220","RTCB","22",32387582,32412248,24666
"8335","ENSG00000258366","ENSG00000258366","RTEL1","20",63657810,63696253,38443
"8336","ENSG00000137815","ENSG00000137815","RTF1","15",41408408,41483563,75155
"8337","ENSG00000139970","ENSG00000139970","RTN1","14",59595976,59870776,274800
"8338","ENSG00000125744","ENSG00000125744","RTN2","19",45485294,45497055,11761
"8339","ENSG00000133318","ENSG00000133318","RTN3","11",63681446,63759891,78445
"8340","ENSG00000115310","ENSG00000115310","RTN4","2",54972187,55112621,140434
"8341","ENSG00000136514","ENSG00000136514","RTP4","3",187368385,187372076,3691
"8342","ENSG00000145016","ENSG00000145016","RUBCN","3",197668867,197749727,80860
"8343","ENSG00000176783","ENSG00000176783","RUFY1","5",179550554,179610012,59458
"8344","ENSG00000204130","ENSG00000204130","RUFY2","10",68341107,68407294,66187
"8345","ENSG00000018189","ENSG00000018189","RUFY3","4",70704204,70808619,104415
"8346","ENSG00000108309","ENSG00000108309","RUNDC3A","17",44308413,44318670,10257
"8347","ENSG00000159216","ENSG00000159216","RUNX1","21",34787801,36004667,1216866
"8348","ENSG00000079102","ENSG00000079102","RUNX1T1","8",91954972,92103385,148413
"8349","ENSG00000124813","ENSG00000124813","RUNX2","6",45328157,45664349,336192
"8350","ENSG00000020633","ENSG00000020633","RUNX3","1",24899511,24965121,65610
"8351","ENSG00000160753","ENSG00000160753","RUSC1","1",155320894,155331114,10220
"8352","ENSG00000198853","ENSG00000198853","RUSC2","9",35490111,35561898,71787
"8353","ENSG00000175792","ENSG00000175792","RUVBL1","3",128064778,128153914,89136
"8354","ENSG00000183207","ENSG00000183207","RUVBL2","19",48993562,49015970,22408
"8355","ENSG00000111832","ENSG00000111832","RWDD1","6",116571409,116597675,26266
"8356","ENSG00000013392","ENSG00000013392","RWDD2A","6",83193357,83198935,5578
"8357","ENSG00000156253","ENSG00000156253","RWDD2B","21",29004384,29019360,14976
"8358","ENSG00000122481","ENSG00000122481","RWDD3","1",95234210,95247225,13015
"8359","ENSG00000186350","ENSG00000186350","RXRA","9",134317098,134440585,123487
"8360","ENSG00000235712","ENSG00000235712","RXRB","HSCHR6_MHC_MCF_CTG1",4629544,4636641,7097
"8361","ENSG00000143171","ENSG00000143171","RXRG","1",165400922,165445355,44433
"8362","ENSG00000281766","ENSG00000281766","RYBP","HG126_PATCH",49076,122044,72968
"8363","ENSG00000163785","ENSG00000163785","RYK","3",134065303,134250859,185556
"8364","ENSG00000196218","ENSG00000196218","RYR1","19",38433691,38595273,161582
"8365","ENSG00000198626","ENSG00000198626","RYR2","1",237042184,237833988,791804
"8366","ENSG00000198838","ENSG00000198838","RYR3","15",33310962,33866121,555159
"8367","ENSG00000160678","ENSG00000160678","S100A1","1",153627926,153632039,4113
"8368","ENSG00000197747","ENSG00000197747","S100A10","1",151982915,151993859,10944
"8369","ENSG00000163191","ENSG00000163191","S100A11","1",152032506,152047907,15401
"8370","ENSG00000163221","ENSG00000163221","S100A12","1",153373711,153375621,1910
"8371","ENSG00000189171","ENSG00000189171","S100A13","1",153618787,153631360,12573
"8372","ENSG00000189334","ENSG00000189334","S100A14","1",153614255,153616986,2731
"8373","ENSG00000196754","ENSG00000196754","S100A2","1",153561108,153567890,6782
"8374","ENSG00000188015","ENSG00000188015","S100A3","1",153547329,153549258,1929
"8375","ENSG00000196154","ENSG00000196154","S100A4","1",153543613,153550136,6523
"8376","ENSG00000197956","ENSG00000197956","S100A6","1",153534599,153536244,1645
"8377","ENSG00000143556","ENSG00000143556","S100A7","1",153457744,153460651,2907
"8378","ENSG00000143546","ENSG00000143546","S100A8","1",153390032,153391073,1041
"8379","ENSG00000163220","ENSG00000163220","S100A9","1",153357854,153361023,3169
"8380","ENSG00000160307","ENSG00000160307","S100B","21",46598604,46605208,6604
"8381","ENSG00000163993","ENSG00000163993","S100P","4",6693878,6697170,3292
"8382","ENSG00000116497","ENSG00000116497","S100PBP","1",32816767,32858875,42108
"8383","ENSG00000170989","ENSG00000170989","S1PR1","1",101236865,101243713,6848
"8384","ENSG00000267534","ENSG00000267534","S1PR2","19",10221433,10231331,9898
"8385","ENSG00000125910","ENSG00000125910","S1PR4","19",3172346,3180332,7986
"8386","ENSG00000180739","ENSG00000180739","S1PR5","19",10512742,10517931,5189
"8387","ENSG00000173432","ENSG00000173432","SAA1","11",18266260,18269977,3717
"8388","ENSG00000134339","ENSG00000134339","SAA2","11",18239223,18248668,9445
"8389","ENSG00000255071","ENSG00000255071","SAA2-SAA4","11",18231423,18248635,17212
"8390","ENSG00000148965","ENSG00000148965","SAA4","11",18231355,18236802,5447
"8391","ENSG00000211456","ENSG00000211456","SACM1L","3",45689056,45745412,56356
"8392","ENSG00000151835","ENSG00000151835","SACS","13",23288689,23433763,145074
"8393","ENSG00000142230","ENSG00000142230","SAE1","19",47113274,47210636,97362
"8394","ENSG00000160633","ENSG00000160633","SAFB","19",5623035,5668478,45443
"8395","ENSG00000130254","ENSG00000130254","SAFB2","19",5586999,5624046,37047
"8396","ENSG00000281857","ENSG00000281857","SAG","HG2232_PATCH",253154,292393,39239
"8397","ENSG00000181433","ENSG00000181433","SAGE1","X",135890182,135913062,22880
"8398","ENSG00000103449","ENSG00000103449","SALL1","16",51135982,51152334,16352
"8399","ENSG00000165821","ENSG00000165821","SALL2","14",21521080,21537216,16136
"8400","ENSG00000167100","ENSG00000167100","SAMD14","17",50110040,50130160,20120
"8401","ENSG00000020577","ENSG00000020577","SAMD4A","14",54566117,54793315,227198
"8402","ENSG00000205413","ENSG00000205413","SAMD9","7",93099513,93118023,18510
"8403","ENSG00000101347","ENSG00000101347","SAMHD1","20",36890229,36951893,61664
"8404","ENSG00000100347","ENSG00000100347","SAMM50","22",43955442,44010531,55089
"8405","ENSG00000155307","ENSG00000155307","SAMSN1","21",14485228,14658821,173593
"8406","ENSG00000136715","ENSG00000136715","SAP130","2",127941217,128028120,86903
"8407","ENSG00000150459","ENSG00000150459","SAP18","13",21140119,21149097,8978
"8408","ENSG00000164105","ENSG00000164105","SAP30","4",173369969,173377532,7563
"8409","ENSG00000161526","ENSG00000161526","SAP30BP","17",75667251,75708062,40811
"8410","ENSG00000164576","ENSG00000164576","SAP30L","5",154445997,154461053,15056
"8411","ENSG00000237918","ENSG00000237918","SAPCD1","HSCHR6_MHC_SSTO_CTG1",3062091,3064143,2052
"8412","ENSG00000079332","ENSG00000079332","SAR1A","10",70147289,70170523,23234
"8413","ENSG00000152700","ENSG00000152700","SAR1B","5",134601149,134649271,48122
"8414","ENSG00000133872","ENSG00000133872","SARAF","8",30063003,30083208,20205
"8415","ENSG00000123453","ENSG00000123453","SARDH","9",133663560,133739955,76395
"8416","ENSG00000004139","ENSG00000004139","SARM1","17",28364356,28404049,39693
"8417","ENSG00000104835","ENSG00000104835","SARS2","19",38915266,38930763,15497
"8418","ENSG00000175467","ENSG00000175467","SART1","11",65961728,65980137,18409
"8419","ENSG00000075856","ENSG00000075856","SART3","12",108522214,108561400,39186
"8420","ENSG00000111961","ENSG00000111961","SASH1","6",148272304,148552044,279740
"8421","ENSG00000122122","ENSG00000122122","SASH3","X",129779949,129795201,15252
"8422","ENSG00000130066","ENSG00000130066","SAT1","X",23783173,23786210,3037
"8423","ENSG00000182568","ENSG00000182568","SATB1","3",18345377,18445621,100244
"8424","ENSG00000119042","ENSG00000119042","SATB2","2",199269505,199471266,201761
"8425","ENSG00000151748","ENSG00000151748","SAV1","14",50632058,50668306,36248
"8426","ENSG00000112167","ENSG00000112167","SAYSD1","6",39104063,39115193,11130
"8427","ENSG00000100241","ENSG00000100241","SBF1","22",50443219,50483923,40704
"8428","ENSG00000139697","ENSG00000139697","SBNO1","12",123289109,123364847,75738
"8429","ENSG00000278788","ENSG00000278788","SBNO2","HSCHR19_4_CTG2",222,49566,49344
"8430","ENSG00000164764","ENSG00000164764","SBSPON","8",73064543,73124088,59545
"8431","ENSG00000109929","ENSG00000109929","SC5D","11",121292681,121313410,20729
"8432","ENSG00000139218","ENSG00000139218","SCAF11","12",45919131,45992120,72989
"8433","ENSG00000156304","ENSG00000156304","SCAF4","21",31671000,31732118,61118
"8434","ENSG00000213079","ENSG00000213079","SCAF8","6",154733378,154834244,100866
"8435","ENSG00000173611","ENSG00000173611","SCAI","9",124942608,125143528,200920
"8436","ENSG00000085365","ENSG00000085365","SCAMP1","5",78360611,78480739,120128
"8437","ENSG00000140497","ENSG00000140497","SCAMP2","15",74843730,74873365,29635
"8438","ENSG00000263290","ENSG00000263290","SCAMP3","HSCHR1_2_CTG31",61002,67453,6451
"8439","ENSG00000198794","ENSG00000198794","SCAMP5","15",74957219,75021495,64276
"8440","ENSG00000114650","ENSG00000114650","SCAP","3",47413681,47477126,63445
"8441","ENSG00000140386","ENSG00000140386","SCAPER","15",76347904,76905444,557540
"8442","ENSG00000168077","ENSG00000168077","SCARA3","8",27633868,27676776,42908
"8443","ENSG00000073060","ENSG00000073060","SCARB1","12",124776856,124882668,105812
"8444","ENSG00000276336","ENSG00000276336","SCARF1","HSCHR17_1_CTG2",63886,75775,11889
"8445","ENSG00000143653","ENSG00000143653","SCCPDH","1",246724409,246768137,43728
"8446","ENSG00000099194","ENSG00000099194","SCD","10",100347233,100364826,17593
"8447","ENSG00000145284","ENSG00000145284","SCD5","4",82629539,82798796,169257
"8448","ENSG00000136155","ENSG00000136155","SCEL","13",77535674,77645263,109589
"8449","ENSG00000092108","ENSG00000092108","SCFD1","14",30622291,30737694,115403
"8450","ENSG00000171951","ENSG00000171951","SCG2","2",223596940,223602361,5421
"8451","ENSG00000104112","ENSG00000104112","SCG3","15",51681492,51721026,39534
"8452","ENSG00000281931","ENSG00000281931","SCG5","HSCHR15_6_CTG8",2160040,2215515,55475
"8453","ENSG00000149021","ENSG00000149021","SCGB1A1","11",62405103,62423195,18092
"8454","ENSG00000124935","ENSG00000124935","SCGB1D2","11",62242239,62244812,2573
"8455","ENSG00000124939","ENSG00000124939","SCGB2A1","11",62208673,62213943,5270
"8456","ENSG00000110484","ENSG00000110484","SCGB2A2","11",62270158,62273160,3002
"8457","ENSG00000079689","ENSG00000079689","SCGN","6",25652201,25701783,49582
"8458","ENSG00000151967","ENSG00000151967","SCHIP1","3",159273244,159897629,624385
"8459","ENSG00000006747","ENSG00000006747","SCIN","7",12570577,12660182,89605
"8460","ENSG00000132330","ENSG00000132330","SCLY","2",238060924,238099413,38489
"8461","ENSG00000010803","ENSG00000010803","SCMH1","1",41027202,41242306,215104
"8462","ENSG00000047634","ENSG00000047634","SCML1","X",17737449,17754988,17539
"8463","ENSG00000102098","ENSG00000102098","SCML2","X",18239313,18354688,115375
"8464","ENSG00000105711","ENSG00000105711","SCN1B","19",35030470,35040449,9979
"8465","ENSG00000136531","ENSG00000136531","SCN2A","2",165194993,165392310,197317
"8466","ENSG00000149575","ENSG00000149575","SCN2B","11",118162806,118176639,13833
"8467","ENSG00000166257","ENSG00000166257","SCN3B","11",123629187,123655244,26057
"8468","ENSG00000007314","ENSG00000007314","SCN4A","17",63938554,63972918,34364
"8469","ENSG00000183873","ENSG00000183873","SCN5A","3",38548057,38649743,101686
"8470","ENSG00000136546","ENSG00000136546","SCN7A","2",166403573,166611482,207909
"8471","ENSG00000196876","ENSG00000196876","SCN8A","12",51590266,51812864,222598
"8472","ENSG00000163156","ENSG00000163156","SCNM1","1",151156664,151170296,13632
"8473","ENSG00000111319","ENSG00000111319","SCNN1A","12",6346843,6377730,30887
"8474","ENSG00000168447","ENSG00000168447","SCNN1B","16",23278231,23381294,103063
"8475","ENSG00000162572","ENSG00000162572","SCNN1D","1",1280436,1292029,11593
"8476","ENSG00000166828","ENSG00000166828","SCNN1G","16",23182745,23216883,34138
"8477","ENSG00000116171","ENSG00000116171","SCP2","1",52927276,53051698,124422
"8478","ENSG00000121064","ENSG00000121064","SCPEP1","17",56978129,57006768,28639
"8479","ENSG00000164106","ENSG00000164106","SCRG1","4",173384701,173406380,21679
"8480","ENSG00000136193","ENSG00000136193","SCRN1","7",29920104,29990289,70185
"8481","ENSG00000144306","ENSG00000144306","SCRN3","2",174395730,174429575,33845
"8482","ENSG00000261678","ENSG00000261678","SCRT1","8",144330565,144336482,5917
"8483","ENSG00000080293","ENSG00000080293","SCTR","2",119439843,119525301,85458
"8484","ENSG00000175356","ENSG00000175356","SCUBE2","11",9019476,9138114,118638
"8485","ENSG00000136021","ENSG00000136021","SCYL2","12",100267140,100341715,74575
"8486","ENSG00000000457","ENSG00000000457","SCYL3","1",169849631,169894267,44636
"8487","ENSG00000198301","ENSG00000198301","SDAD1","4",75940950,75990962,50012
"8488","ENSG00000115884","ENSG00000115884","SDC1","2",20200797,20225433,24636
"8489","ENSG00000169439","ENSG00000169439","SDC2","8",96493813,96611790,117977
"8490","ENSG00000162512","ENSG00000162512","SDC3","1",30869466,30908758,39292
"8491","ENSG00000124145","ENSG00000124145","SDC4","20",45325288,45348424,23136
"8492","ENSG00000137575","ENSG00000137575","SDCBP","8",58552924,58582859,29935
"8493","ENSG00000132581","ENSG00000132581","SDF2","17",28648346,28662189,13843
"8494","ENSG00000128228","ENSG00000128228","SDF2L1","22",21642302,21644299,1997
"8495","ENSG00000078808","ENSG00000078808","SDF4","1",1216931,1232031,15100
"8496","ENSG00000073578","ENSG00000073578","SDHA","5",218303,257082,38779
"8497","ENSG00000196636","ENSG00000196636","SDHAF3","7",97117698,97181763,64065
"8498","ENSG00000117118","ENSG00000117118","SDHB","1",17018664,17054151,35487
"8499","ENSG00000143252","ENSG00000143252","SDHC","1",161314381,161363206,48825
"8500","ENSG00000204370","ENSG00000204370","SDHD","11",112086824,112120016,33192
"8501","ENSG00000069188","ENSG00000069188","SDK2","17",73334384,73644445,310061
"8502","ENSG00000100445","ENSG00000100445","SDR39U1","14",24439766,24442905,3139
"8503","ENSG00000135094","ENSG00000135094","SDS","12",113392445,113426301,33856
"8504","ENSG00000140612","ENSG00000140612","SEC11A","15",84669538,84716460,46922
"8505","ENSG00000157020","ENSG00000157020","SEC13","3",10293131,10321112,27981
"8506","ENSG00000129657","ENSG00000129657","SEC14L1","17",77088749,77217101,128352
"8507","ENSG00000100003","ENSG00000100003","SEC14L2","22",30396941,30425303,28362
"8508","ENSG00000103184","ENSG00000103184","SEC14L5","16",4958330,5019157,60827
"8509","ENSG00000148396","ENSG00000148396","SEC16A","9",136440096,136483759,43663
"8510","ENSG00000121542","ENSG00000121542","SEC22A","3",123201927,123274136,72209
"8511","ENSG00000265808","ENSG00000265808","SEC22B","1",120150898,120176520,25622
"8512","ENSG00000100934","ENSG00000100934","SEC23A","14",39031919,39109646,77727
"8513","ENSG00000101310","ENSG00000101310","SEC23B","20",18507520,18561415,53895
"8514","ENSG00000107651","ENSG00000107651","SEC23IP","10",119892707,119944657,51950
"8515","ENSG00000113615","ENSG00000113615","SEC24A","5",134648785,134727909,79124
"8516","ENSG00000138802","ENSG00000138802","SEC24B","4",109433772,109540896,107124
"8517","ENSG00000176986","ENSG00000176986","SEC24C","10",73744372,73772161,27789
"8518","ENSG00000150961","ENSG00000150961","SEC24D","4",118722823,118838683,115860
"8519","ENSG00000138674","ENSG00000138674","SEC31A","4",82818509,82901166,82657
"8520","ENSG00000075826","ENSG00000075826","SEC31B","10",100486646,100519864,33218
"8521","ENSG00000058262","ENSG00000058262","SEC61A1","3",128051641,128071705,20064
"8522","ENSG00000065665","ENSG00000065665","SEC61A2","10",12129637,12169961,40324
"8523","ENSG00000106803","ENSG00000106803","SEC61B","9",99222064,99230615,8551
"8524","ENSG00000132432","ENSG00000132432","SEC61G","7",54752250,54759974,7724
"8525","ENSG00000008952","ENSG00000008952","SEC62","3",169966635,169998373,31738
"8526","ENSG00000025796","ENSG00000025796","SEC63","6",107867756,107958208,90452
"8527","ENSG00000187742","ENSG00000187742","SECISBP2","9",89318500,89359663,41163
"8528","ENSG00000138593","ENSG00000138593","SECISBP2L","15",48988476,49046447,57971
"8529","ENSG00000141574","ENSG00000141574","SECTM1","17",82321024,82334074,13050
"8530","ENSG00000085415","ENSG00000085415","SEH1L","18",12947133,12987536,40403
"8531","ENSG00000091490","ENSG00000091490","SEL1L3","4",25747433,25863760,116327
"8532","ENSG00000007908","ENSG00000007908","SELE","1",169722640,169764705,42065
"8533","ENSG00000143416","ENSG00000143416","SELENBP1","1",151364304,151372707,8403
"8534","ENSG00000188404","ENSG00000188404","SELL","1",169690665,169711702,21037
"8535","ENSG00000174175","ENSG00000174175","SELP","1",169588849,169630193,41344
"8536","ENSG00000110876","ENSG00000110876","SELPLG","12",108621895,108633894,11999
"8537","ENSG00000075213","ENSG00000075213","SEMA3A","7",83955777,84492724,536947
"8538","ENSG00000012171","ENSG00000012171","SEMA3B","3",50267558,50277546,9988
"8539","ENSG00000075223","ENSG00000075223","SEMA3C","7",80742538,80922359,179821
"8540","ENSG00000170381","ENSG00000170381","SEMA3E","7",83363238,83649139,285901
"8541","ENSG00000001617","ENSG00000001617","SEMA3F","3",50155045,50189075,34030
"8542","ENSG00000010319","ENSG00000010319","SEMA3G","3",52433035,52445103,12068
"8543","ENSG00000196189","ENSG00000196189","SEMA4A","1",156147366,156177752,30386
"8544","ENSG00000168758","ENSG00000168758","SEMA4C","2",96859718,96870757,11039
"8545","ENSG00000187764","ENSG00000187764","SEMA4D","9",89360787,89498130,137343
"8546","ENSG00000135622","ENSG00000135622","SEMA4F","2",74654228,74683853,29625
"8547","ENSG00000095539","ENSG00000095539","SEMA4G","10",100969504,100985871,16367
"8548","ENSG00000112902","ENSG00000112902","SEMA5A","5",9035033,9546075,511042
"8549","ENSG00000092421","ENSG00000092421","SEMA6A","5",116443555,116574823,131268
"8550","ENSG00000167680","ENSG00000167680","SEMA6B","19",4542593,4581776,39183
"8551","ENSG00000143434","ENSG00000143434","SEMA6C","1",151131685,151146631,14946
"8552","ENSG00000137872","ENSG00000137872","SEMA6D","15",47184101,47774228,590127
"8553","ENSG00000138623","ENSG00000138623","SEMA7A","15",74409289,74433958,24669
"8554","ENSG00000124233","ENSG00000124233","SEMG1","20",45207033,45209768,2735
"8555","ENSG00000161956","ENSG00000161956","SENP3","17",7561919,7571969,10050
"8556","ENSG00000119231","ENSG00000119231","SENP5","3",196867856,196934714,66858
"8557","ENSG00000112701","ENSG00000112701","SENP6","6",75601509,75718281,116772
"8558","ENSG00000138468","ENSG00000138468","SENP7","3",101324205,101513241,189036
"8559","ENSG00000086475","ENSG00000086475","SEPHS1","10",13317428,13348298,30870
"8560","ENSG00000179918","ENSG00000179918","SEPHS2","16",30443631,30445874,2243
"8561","ENSG00000142864","ENSG00000142864","SERBP1","1",67407810,67430415,22605
"8562","ENSG00000275581","ENSG00000275581","SERF1A","HSCHR5_1_CTG1_1",449073,466963,17890
"8563","ENSG00000278839","ENSG00000278839","SERF1B","HSCHR5_2_CTG1_1",492256,510143,17887
"8564","ENSG00000140264","ENSG00000140264","SERF2","15",43777087,43804427,27340
"8565","ENSG00000129158","ENSG00000129158","SERGEF","11",17788048,18013047,224999
"8566","ENSG00000183569","ENSG00000183569","SERHL2","22",42553617,42574382,20765
"8567","ENSG00000111897","ENSG00000111897","SERINC1","6",122443351,122471807,28456
"8568","ENSG00000168528","ENSG00000168528","SERINC2","1",31409565,31434680,25115
"8569","ENSG00000132824","ENSG00000132824","SERINC3","20",44496221,44522085,25864
"8570","ENSG00000164300","ENSG00000164300","SERINC5","5",80111651,80256048,144397
"8571","ENSG00000120742","ENSG00000120742","SERP1","3",150541998,150603228,61230
"8572","ENSG00000277377","ENSG00000277377","SERPINA1","HSCHR14_7_CTG1",1493319,1507265,13946
"8573","ENSG00000278767","ENSG00000278767","SERPINA10","HSCHR14_7_CTG1",1395022,1407833,12811
"8574","ENSG00000100665","ENSG00000100665","SERPINA4","14",94561442,94569913,8471
"8575","ENSG00000188488","ENSG00000188488","SERPINA5","14",94561442,94593118,31676
"8576","ENSG00000277405","ENSG00000277405","SERPINA6","HSCHR14_7_CTG1",1418810,1437956,19146
"8577","ENSG00000123561","ENSG00000123561","SERPINA7","X",106032435,106038727,6292
"8578","ENSG00000021355","ENSG00000021355","SERPINB1","6",2832332,2841959,9627
"8579","ENSG00000197641","ENSG00000197641","SERPINB13","18",63586989,63604639,17650
"8580","ENSG00000197632","ENSG00000197632","SERPINB2","18",63871692,63903888,32196
"8581","ENSG00000057149","ENSG00000057149","SERPINB3","18",63655197,63661893,6696
"8582","ENSG00000206075","ENSG00000206075","SERPINB5","18",63476958,63505085,28127
"8583","ENSG00000124570","ENSG00000124570","SERPINB6","6",2948159,2972165,24006
"8584","ENSG00000166396","ENSG00000166396","SERPINB7","18",63752935,63805376,52441
"8585","ENSG00000166401","ENSG00000166401","SERPINB8","18",63970029,64019779,49750
"8586","ENSG00000170542","ENSG00000170542","SERPINB9","6",2887270,2903309,16039
"8587","ENSG00000117601","ENSG00000117601","SERPINC1","1",173903800,173917327,13527
"8588","ENSG00000099937","ENSG00000099937","SERPIND1","22",20774113,20787720,13607
"8589","ENSG00000106366","ENSG00000106366","SERPINE1","7",101127104,101139247,12143
"8590","ENSG00000135919","ENSG00000135919","SERPINE2","2",223975045,224039318,64273
"8591","ENSG00000132386","ENSG00000132386","SERPINF1","17",1762029,1777565,15536
"8592","ENSG00000276838","ENSG00000276838","SERPINF2","HSCHR17_1_CTG2",171788,184217,12429
"8593","ENSG00000149131","ENSG00000149131","SERPING1","11",57597387,57619171,21784
"8594","ENSG00000149257","ENSG00000149257","SERPINH1","11",75562056,75572783,10727
"8595","ENSG00000163536","ENSG00000163536","SERPINI1","3",167735243,167825569,90326
"8596","ENSG00000114204","ENSG00000114204","SERPINI2","3",167441914,167478972,37058
"8597","ENSG00000179833","ENSG00000179833","SERTAD2","2",64631621,64751005,119384
"8598","ENSG00000167565","ENSG00000167565","SERTAD3","19",40440844,40444335,3491
"8599","ENSG00000080546","ENSG00000080546","SESN1","6",108984309,109094846,110537
"8600","ENSG00000119335","ENSG00000119335","SET","9",128683424,128696400,12976
"8601","ENSG00000152217","ENSG00000152217","SETBP1","18",44680173,45068510,388337
"8602","ENSG00000099381","ENSG00000099381","SETD1A","16",30957294,30984664,27370
"8603","ENSG00000139718","ENSG00000139718","SETD1B","12",121804009,121832656,28647
"8604","ENSG00000181555","ENSG00000181555","SETD2","3",47016428,47164113,147685
"8605","ENSG00000183576","ENSG00000183576","SETD3","14",99397748,99480889,83141
"8606","ENSG00000185917","ENSG00000185917","SETD4","21",36034541,36079389,44848
"8607","ENSG00000168137","ENSG00000168137","SETD5","3",9397615,9479240,81625
"8608","ENSG00000103037","ENSG00000103037","SETD6","16",58515479,58523842,8363
"8609","ENSG00000143379","ENSG00000143379","SETDB1","1",150926263,150964744,38481
"8610","ENSG00000170364","ENSG00000170364","SETMAR","3",4303332,4317265,13933
"8611","ENSG00000107290","ENSG00000107290","SETX","9",132261356,132354986,93630
"8612","ENSG00000100095","ENSG00000100095","SEZ6L","22",26169462,26383597,214135
"8613","ENSG00000174938","ENSG00000174938","SEZ6L2","16",29871159,29899550,28391
"8614","ENSG00000168066","ENSG00000168066","SF1","11",64764606,64778786,14180
"8615","ENSG00000099995","ENSG00000099995","SF3A1","22",30331988,30356919,24931
"8616","ENSG00000104897","ENSG00000104897","SF3A2","19",2236824,2248655,11831
"8617","ENSG00000183431","ENSG00000183431","SF3A3","1",37956975,37990075,33100
"8618","ENSG00000115524","ENSG00000115524","SF3B1","2",197388515,197435079,46564
"8619","ENSG00000087365","ENSG00000087365","SF3B2","11",66050729,66069308,18579
"8620","ENSG00000189091","ENSG00000189091","SF3B3","16",70523791,70577670,53879
"8621","ENSG00000143368","ENSG00000143368","SF3B4","1",149923317,149927803,4486
"8622","ENSG00000169976","ENSG00000169976","SF3B5","6",144094884,144095573,689
"8623","ENSG00000198089","ENSG00000198089","SFI1","22",31488688,31618588,129900
"8624","ENSG00000163935","ENSG00000163935","SFMBT1","3",52903572,53046750,143178
"8625","ENSG00000175793","ENSG00000175793","SFN","1",26863149,26864456,1307
"8626","ENSG00000116560","ENSG00000116560","SFPQ","1",35176378,35193446,17068
"8627","ENSG00000104332","ENSG00000104332","SFRP1","8",41261962,41309473,47511
"8628","ENSG00000106483","ENSG00000106483","SFRP4","7",37905932,38025695,119763
"8629","ENSG00000120057","ENSG00000120057","SFRP5","10",97766751,97771999,5248
"8630","ENSG00000061936","ENSG00000061936","SFSWAP","12",131711081,131799738,88657
"8631","ENSG00000213064","ENSG00000213064","SFT2D2","1",168225938,168253021,27083
"8632","ENSG00000185303","ENSG00000185303","SFTPA2","10",79555852,79560407,4555
"8633","ENSG00000168878","ENSG00000168878","SFTPB","2",85657314,85668741,11427
"8634","ENSG00000168484","ENSG00000168484","SFTPC","8",22156913,22164479,7566
"8635","ENSG00000133661","ENSG00000133661","SFTPD","10",79937467,79982614,45147
"8636","ENSG00000164466","ENSG00000164466","SFXN1","5",175477062,175529742,52680
"8637","ENSG00000107819","ENSG00000107819","SFXN3","10",101031234,101041241,10007
"8638","ENSG00000108823","ENSG00000108823","SGCA","17",50164214,50175928,11714
"8639","ENSG00000163069","ENSG00000163069","SGCB","4",52020706,52038299,17593
"8640","ENSG00000170624","ENSG00000170624","SGCD","5",155870344,156767788,897444
"8641","ENSG00000127990","ENSG00000127990","SGCE","7",94524204,94656572,132368
"8642","ENSG00000102683","ENSG00000102683","SGCG","13",23180979,23325162,144183
"8643","ENSG00000176476","ENSG00000176476","SGF29","16",28553915,28591790,37875
"8644","ENSG00000118515","ENSG00000118515","SGK1","6",134169248,134318112,148864
"8645","ENSG00000101049","ENSG00000101049","SGK2","20",43558968,43588237,29269
"8646","ENSG00000104205","ENSG00000104205","SGK3","8",66712734,66862022,149288
"8647","ENSG00000198964","ENSG00000198964","SGMS1","10",50305586,50625163,319577
"8648","ENSG00000166224","ENSG00000166224","SGPL1","10",70815905,70895816,79911
"8649","ENSG00000126821","ENSG00000126821","SGPP1","14",63684216,63728065,43849
"8650","ENSG00000181523","ENSG00000181523","SGSH","17",80206716,80220923,14207
"8651","ENSG00000141258","ENSG00000141258","SGSM2","17",2337498,2381058,43560
"8652","ENSG00000100359","ENSG00000100359","SGSM3","22",40370591,40410289,39698
"8653","ENSG00000104969","ENSG00000104969","SGTA","19",2754715,2783362,28647
"8654","ENSG00000178188","ENSG00000178188","SH2B1","16",28846600,28874212,27612
"8655","ENSG00000160999","ENSG00000160999","SH2B2","7",102285091,102321711,36620
"8656","ENSG00000111252","ENSG00000111252","SH2B3","12",111405923,111451623,45700
"8657","ENSG00000183918","ENSG00000183918","SH2D1A","X",124227868,124373197,145329
"8658","ENSG00000027869","ENSG00000027869","SH2D2A","1",156806243,156816848,10605
"8659","ENSG00000125731","ENSG00000125731","SH2D3A","19",6752160,6767463,15303
"8660","ENSG00000095370","ENSG00000095370","SH2D3C","9",127738317,127778710,40393
"8661","ENSG00000104611","ENSG00000104611","SH2D4A","8",19313693,19396218,82525
"8662","ENSG00000185437","ENSG00000185437","SH3BGR","21",39445855,39515506,69651
"8663","ENSG00000131171","ENSG00000131171","SH3BGRL","X",81202102,81298547,96445
"8664","ENSG00000142669","ENSG00000142669","SH3BGRL3","1",26280086,26281522,1436
"8665","ENSG00000100092","ENSG00000100092","SH3BP1","22",37634654,37656117,21463
"8666","ENSG00000087266","ENSG00000087266","SH3BP2","4",2793023,2841291,48268
"8667","ENSG00000130147","ENSG00000130147","SH3BP4","2",234952017,235055714,103697
"8668","ENSG00000131370","ENSG00000131370","SH3BP5","3",15254353,15341368,87015
"8669","ENSG00000214193","ENSG00000214193","SH3D21","1",36306368,36329340,22972
"8670","ENSG00000141985","ENSG00000141985","SH3GL1","19",4360370,4400547,40177
"8671","ENSG00000107295","ENSG00000107295","SH3GL2","9",17579066,17797124,218058
"8672","ENSG00000140600","ENSG00000140600","SH3GL3","15",83447228,83618743,171515
"8673","ENSG00000097033","ENSG00000097033","SH3GLB1","1",86704570,86748184,43614
"8674","ENSG00000148341","ENSG00000148341","SH3GLB2","9",129007036,129028331,21295
"8675","ENSG00000107957","ENSG00000107957","SH3PXD2A","10",103594027,103855584,261557
"8676","ENSG00000125089","ENSG00000125089","SH3TC1","4",8182072,8241803,59731
"8677","ENSG00000169247","ENSG00000169247","SH3TC2","5",148923639,149063163,139524
"8678","ENSG00000035115","ENSG00000035115","SH3YL1","2",217730,266398,48668
"8679","ENSG00000162105","ENSG00000162105","SHANK2","11",70467854,71252577,784723
"8680","ENSG00000179526","ENSG00000179526","SHARPIN","8",144098633,144108124,9491
"8681","ENSG00000107338","ENSG00000107338","SHB","9",37915898,38069227,153329
"8682","ENSG00000129214","ENSG00000129214","SHBG","17",7613946,7633382,19436
"8683","ENSG00000160691","ENSG00000160691","SHC1","1",154962298,154974395,12097
"8684","ENSG00000129946","ENSG00000129946","SHC2","19",416589,461033,44444
"8685","ENSG00000148082","ENSG00000148082","SHC3","9",89005771,89178818,173047
"8686","ENSG00000171241","ENSG00000171241","SHCBP1","16",46578591,46621379,42788
"8687","ENSG00000176974","ENSG00000176974","SHMT1","17",18327873,18363550,35677
"8688","ENSG00000182199","ENSG00000182199","SHMT2","12",57229573,57234935,5362
"8689","ENSG00000108061","ENSG00000108061","SHOC2","10",110919367,111017307,97940
"8690","ENSG00000185960","ENSG00000185960","SHOX","X",624344,659411,35067
"8691","ENSG00000197417","ENSG00000197417","SHPK","17",3608240,3636250,28010
"8692","ENSG00000144736","ENSG00000144736","SHQ1","3",72749277,72861914,112637
"8693","ENSG00000146950","ENSG00000146950","SHROOM2","X",9786429,9949443,163014
"8694","ENSG00000187164","ENSG00000187164","SHTN1","10",116881477,117126586,245109
"8695","ENSG00000090402","ENSG00000090402","SI","3",164978898,165078496,99598
"8696","ENSG00000196470","ENSG00000196470","SIAH1","16",48356364,48448402,92038
"8697","ENSG00000181788","ENSG00000181788","SIAH2","3",150741125,150763477,22352
"8698","ENSG00000072858","ENSG00000072858","SIDT1","3",113532555,113629575,97020
"8699","ENSG00000149577","ENSG00000149577","SIDT2","11",117178736,117197445,18709
"8700","ENSG00000185187","ENSG00000185187","SIGIRR","11",405715,417455,11740
"8701","ENSG00000088827","ENSG00000088827","SIGLEC1","20",3686970,3712600,25630
"8702","ENSG00000197046","ENSG00000197046","SIGLEC15","18",45825675,45844094,18419
"8703","ENSG00000105492","ENSG00000105492","SIGLEC6","19",51517819,51531856,14037
"8704","ENSG00000168995","ENSG00000168995","SIGLEC7","19",51142299,51153526,11227
"8705","ENSG00000105366","ENSG00000105366","SIGLEC8","19",51450847,51458456,7609
"8706","ENSG00000129450","ENSG00000129450","SIGLEC9","19",51124906,51136651,11745
"8707","ENSG00000147955","ENSG00000147955","SIGMAR1","9",34634722,34637844,3122
"8708","ENSG00000142178","ENSG00000142178","SIK1","21",43414483,43427131,12648
"8709","ENSG00000170145","ENSG00000170145","SIK2","11",111602449,111730855,128406
"8710","ENSG00000160584","ENSG00000160584","SIK3","11",116843402,117098437,255035
"8711","ENSG00000052723","ENSG00000052723","SIKE1","1",114769479,114780685,11206
"8712","ENSG00000120725","ENSG00000120725","SIL1","5",138946724,139293557,346833
"8713","ENSG00000112246","ENSG00000112246","SIM1","6",100385009,100464921,79912
"8714","ENSG00000159263","ENSG00000159263","SIM2","21",36699115,36749917,50802
"8715","ENSG00000127511","ENSG00000127511","SIN3B","19",16829398,16880353,50955
"8716","ENSG00000213445","ENSG00000213445","SIPA1","11",65638101,65650918,12817
"8717","ENSG00000197555","ENSG00000197555","SIPA1L1","14",71320449,71741229,420780
"8718","ENSG00000105738","ENSG00000105738","SIPA1L3","19",37907208,38208369,301161
"8719","ENSG00000198053","ENSG00000198053","SIRPA","20",1894167,1940592,46425
"8720","ENSG00000101307","ENSG00000101307","SIRPB1","20",1561385,1620061,58676
"8721","ENSG00000089012","ENSG00000089012","SIRPG","20",1629152,1657779,28627
"8722","ENSG00000096717","ENSG00000096717","SIRT1","10",67884656,67918390,33734
"8723","ENSG00000068903","ENSG00000068903","SIRT2","19",38878555,38899862,21307
"8724","ENSG00000142082","ENSG00000142082","SIRT3","11",215030,236931,21901
"8725","ENSG00000089163","ENSG00000089163","SIRT4","12",120302316,120313249,10933
"8726","ENSG00000124523","ENSG00000124523","SIRT5","6",13574227,13615158,40931
"8727","ENSG00000077463","ENSG00000077463","SIRT6","19",4174109,4182566,8457
"8728","ENSG00000187531","ENSG00000187531","SIRT7","17",81911939,81921323,9384
"8729","ENSG00000137078","ENSG00000137078","SIT1","9",35649295,35650931,1636
"8730","ENSG00000184990","ENSG00000184990","SIVA1","14",104753147,104768494,15347
"8731","ENSG00000126778","ENSG00000126778","SIX1","14",60643421,60658259,14838
"8732","ENSG00000170577","ENSG00000170577","SIX2","2",45005182,45009452,4270
"8733","ENSG00000138083","ENSG00000138083","SIX3","2",44941702,44946071,4369
"8734","ENSG00000177045","ENSG00000177045","SIX5","19",45764785,45769252,4467
"8735","ENSG00000184302","ENSG00000184302","SIX6","14",60509146,60512850,3704
"8736","ENSG00000141293","ENSG00000141293","SKAP1","17",48133442,48430275,296833
"8737","ENSG00000005020","ENSG00000005020","SKAP2","7",26667068,26995239,328171
"8738","ENSG00000157933","ENSG00000157933","SKI","1",2227388,2310213,82825
"8739","ENSG00000136603","ENSG00000136603","SKIL","3",170357342,170396835,39493
"8740","ENSG00000113558","ENSG00000113558","SKP1","5",134148935,134176964,28029
"8741","ENSG00000145604","ENSG00000145604","SKP2","5",36151989,36196849,44860
"8742","ENSG00000155926","ENSG00000155926","SLA","8",133036728,133102912,66184
"8743","ENSG00000117090","ENSG00000117090","SLAMF1","1",160608106,160647044,38938
"8744","ENSG00000026751","ENSG00000026751","SLAMF7","1",160739057,160754821,15764
"8745","ENSG00000158714","ENSG00000158714","SLAMF8","1",159826811,159837492,10681
"8746","ENSG00000163950","ENSG00000163950","SLBP","4",1692731,1712344,19613
"8747","ENSG00000100652","ENSG00000100652","SLC10A1","14",69775416,69797241,21825
"8748","ENSG00000125255","ENSG00000125255","SLC10A2","13",103043998,103066417,22419
"8749","ENSG00000126903","ENSG00000126903","SLC10A3","X",154487306,154490690,3384
"8750","ENSG00000018280","ENSG00000018280","SLC11A1","2",218382029,218396894,14865
"8751","ENSG00000110911","ENSG00000110911","SLC11A2","12",50979401,51028566,49165
"8752","ENSG00000074803","ENSG00000074803","SLC12A1","15",48178438,48304078,125640
"8753","ENSG00000064651","ENSG00000064651","SLC12A2","5",128083766,128189677,105911
"8754","ENSG00000070915","ENSG00000070915","SLC12A3","16",56865207,56915850,50643
"8755","ENSG00000124067","ENSG00000124067","SLC12A4","16",67943474,67969601,26127
"8756","ENSG00000124140","ENSG00000124140","SLC12A5","20",46021690,46060150,38460
"8757","ENSG00000140199","ENSG00000140199","SLC12A6","15",34229784,34338060,108276
"8758","ENSG00000276482","ENSG00000276482","SLC12A7","HSCHR5_4_CTG1",68885,129717,60832
"8759","ENSG00000221955","ENSG00000221955","SLC12A8","3",125082636,125212864,130228
"8760","ENSG00000146828","ENSG00000146828","SLC12A9","7",100826820,100867010,40190
"8761","ENSG00000081800","ENSG00000081800","SLC13A1","7",123113531,123199972,86441
"8762","ENSG00000007216","ENSG00000007216","SLC13A2","17",28473293,28497781,24488
"8763","ENSG00000158296","ENSG00000158296","SLC13A3","20",46557823,46684467,126644
"8764","ENSG00000164707","ENSG00000164707","SLC13A4","7",135681231,135729258,48027
"8765","ENSG00000141469","ENSG00000141469","SLC14A1","18",45687025,45752520,65495
"8766","ENSG00000132874","ENSG00000132874","SLC14A2","18",45212995,45683688,470693
"8767","ENSG00000088386","ENSG00000088386","SLC15A1","13",98683801,98752672,68871
"8768","ENSG00000163406","ENSG00000163406","SLC15A2","3",121894401,121944188,49787
"8769","ENSG00000110446","ENSG00000110446","SLC15A3","11",60937060,60952653,15593
"8770","ENSG00000281917","ENSG00000281917","SLC16A1","HG2104_PATCH",2426,47592,45166
"8771","ENSG00000112394","ENSG00000112394","SLC16A10","6",111087503,111231194,143691
"8772","ENSG00000147100","ENSG00000147100","SLC16A2","X",74421493,74533917,112424
"8773","ENSG00000141526","ENSG00000141526","SLC16A3","17",82217934,82261129,43195
"8774","ENSG00000168679","ENSG00000168679","SLC16A4","1",110362851,110391082,28231
"8775","ENSG00000170190","ENSG00000170190","SLC16A5","17",75087727,75106162,18435
"8776","ENSG00000108932","ENSG00000108932","SLC16A6","17",68267026,68291267,24241
"8777","ENSG00000118596","ENSG00000118596","SLC16A7","12",59596029,59789855,193826
"8778","ENSG00000100156","ENSG00000100156","SLC16A8","22",38078134,38084184,6050
"8779","ENSG00000124568","ENSG00000124568","SLC17A1","6",25782915,25832052,49137
"8780","ENSG00000112337","ENSG00000112337","SLC17A2","6",25912754,25930691,17937
"8781","ENSG00000124564","ENSG00000124564","SLC17A3","6",25833066,25882286,49220
"8782","ENSG00000146039","ENSG00000146039","SLC17A4","6",25754699,25781199,26500
"8783","ENSG00000119899","ENSG00000119899","SLC17A5","6",73593379,73653992,60613
"8784","ENSG00000091664","ENSG00000091664","SLC17A6","11",22338381,22379503,41122
"8785","ENSG00000104888","ENSG00000104888","SLC17A7","19",49429401,49442360,12959
"8786","ENSG00000101194","ENSG00000101194","SLC17A9","20",62952707,62969585,16878
"8787","ENSG00000036565","ENSG00000036565","SLC18A1","8",20144855,20183206,38351
"8788","ENSG00000165646","ENSG00000165646","SLC18A2","10",117241093,117279430,38337
"8789","ENSG00000187714","ENSG00000187714","SLC18A3","10",49610310,49612720,2410
"8790","ENSG00000173638","ENSG00000173638","SLC19A1","21",45493572,45573365,79793
"8791","ENSG00000117479","ENSG00000117479","SLC19A2","1",169463909,169485944,22035
"8792","ENSG00000135917","ENSG00000135917","SLC19A3","2",227683763,227718028,34265
"8793","ENSG00000106688","ENSG00000106688","SLC1A1","9",4490468,4587469,97001
"8794","ENSG00000110436","ENSG00000110436","SLC1A2","11",35251205,35420063,168858
"8795","ENSG00000079215","ENSG00000079215","SLC1A3","5",36596588,36688334,91746
"8796","ENSG00000115902","ENSG00000115902","SLC1A4","2",64988477,65023865,35388
"8797","ENSG00000105281","ENSG00000105281","SLC1A5","19",46774883,46788594,13711
"8798","ENSG00000105143","ENSG00000105143","SLC1A6","19",14950033,15022990,72957
"8799","ENSG00000162383","ENSG00000162383","SLC1A7","1",53087179,53142638,55459
"8800","ENSG00000144136","ENSG00000144136","SLC20A1","2",112645939,112663825,17886
"8801","ENSG00000168575","ENSG00000168575","SLC20A2","8",42416475,42541926,125451
"8802","ENSG00000175003","ENSG00000175003","SLC22A1","6",160121815,160158718,36903
"8803","ENSG00000168065","ENSG00000168065","SLC22A11","11",64555690,64572875,17185
"8804","ENSG00000172940","ENSG00000172940","SLC22A13","3",38265812,38278757,12945
"8805","ENSG00000144671","ENSG00000144671","SLC22A14","3",38282294,38318575,36281
"8806","ENSG00000092096","ENSG00000092096","SLC22A17","14",23346314,23352912,6598
"8807","ENSG00000276130","ENSG00000276130","SLC22A18","HSCHR11_1_CTG7",131932,157362,25430
"8808","ENSG00000274454","ENSG00000274454","SLC22A18AS","HSCHR11_1_CTG7",119991,135956,15965
"8809","ENSG00000112499","ENSG00000112499","SLC22A2","6",160171061,160277638,106577
"8810","ENSG00000146477","ENSG00000146477","SLC22A3","6",160348378,160452577,104199
"8811","ENSG00000197208","ENSG00000197208","SLC22A4","5",132294394,132344190,49796
"8812","ENSG00000197375","ENSG00000197375","SLC22A5","5",132369710,132395613,25903
"8813","ENSG00000197901","ENSG00000197901","SLC22A6","11",62936385,62984967,48582
"8814","ENSG00000137204","ENSG00000137204","SLC22A7","6",43295694,43305538,9844
"8815","ENSG00000149452","ENSG00000149452","SLC22A8","11",62989154,63015841,26687
"8816","ENSG00000089057","ENSG00000089057","SLC23A2","20",4852356,5010293,157937
"8817","ENSG00000074621","ENSG00000074621","SLC24A1","15",65611366,65660995,49629
"8818","ENSG00000155886","ENSG00000155886","SLC24A2","9",19507452,19789037,281585
"8819","ENSG00000185052","ENSG00000185052","SLC24A3","20",19212642,19722926,510284
"8820","ENSG00000100075","ENSG00000100075","SLC25A1","22",19175581,19178739,3158
"8821","ENSG00000183048","ENSG00000183048","SLC25A10","17",81712236,81721016,8780
"8822","ENSG00000108528","ENSG00000108528","SLC25A11","17",4937130,4940053,2923
"8823","ENSG00000115840","ENSG00000115840","SLC25A12","2",171783405,171999859,216454
"8824","ENSG00000004864","ENSG00000004864","SLC25A13","7",96120220,96322147,201927
"8825","ENSG00000102078","ENSG00000102078","SLC25A14","X",130339888,130373361,33473
"8826","ENSG00000102743","ENSG00000102743","SLC25A15","13",40789412,40812460,23048
"8827","ENSG00000122912","ENSG00000122912","SLC25A16","10",68477998,68527523,49525
"8828","ENSG00000100372","ENSG00000100372","SLC25A17","22",40769630,40819399,49769
"8829","ENSG00000178537","ENSG00000178537","SLC25A20","3",48856926,48898904,41978
"8830","ENSG00000183032","ENSG00000183032","SLC25A21","14",36677921,37172606,494685
"8831","ENSG00000177542","ENSG00000177542","SLC25A22","11",790475,798281,7806
"8832","ENSG00000125648","ENSG00000125648","SLC25A23","19",6436079,6465203,29124
"8833","ENSG00000085491","ENSG00000085491","SLC25A24","1",108134043,108200849,66806
"8834","ENSG00000155287","ENSG00000155287","SLC25A28","10",99610519,99622793,12274
"8835","ENSG00000075415","ENSG00000075415","SLC25A3","12",98593591,98606379,12788
"8836","ENSG00000164933","ENSG00000164933","SLC25A32","8",103398635,103415189,16554
"8837","ENSG00000114120","ENSG00000114120","SLC25A36","3",140941830,140980995,39165
"8838","ENSG00000147454","ENSG00000147454","SLC25A37","8",23528956,23575463,46507
"8839","ENSG00000144659","ENSG00000144659","SLC25A38","3",39383370,39397351,13981
"8840","ENSG00000151729","ENSG00000151729","SLC25A4","4",185143266,185150382,7116
"8841","ENSG00000075303","ENSG00000075303","SLC25A40","7",87833568,87876360,42792
"8842","ENSG00000181035","ENSG00000181035","SLC25A42","19",19063994,19113030,49036
"8843","ENSG00000160785","ENSG00000160785","SLC25A44","1",156193932,156212796,18864
"8844","ENSG00000164209","ENSG00000164209","SLC25A46","5",110738136,110765161,27025
"8845","ENSG00000005022","ENSG00000005022","SLC25A5","X",119468422,119471396,2974
"8846","ENSG00000145217","ENSG00000145217","SLC26A1","4",979073,993440,14367
"8847","ENSG00000155850","ENSG00000155850","SLC26A2","5",149960758,149993455,32697
"8848","ENSG00000091138","ENSG00000091138","SLC26A3","7",107765467,107803225,37758
"8849","ENSG00000091137","ENSG00000091137","SLC26A4","7",107660828,107717809,56981
"8850","ENSG00000225697","ENSG00000225697","SLC26A6","3",48625723,48635493,9770
"8851","ENSG00000140284","ENSG00000140284","SLC27A2","15",50182196,50236385,54189
"8852","ENSG00000263163","ENSG00000263163","SLC27A3","HSCHR1_1_CTG31",91055,96858,5803
"8853","ENSG00000083807","ENSG00000083807","SLC27A5","19",58479512,58512413,32901
"8854","ENSG00000113396","ENSG00000113396","SLC27A6","5",128538013,129033642,495629
"8855","ENSG00000156222","ENSG00000156222","SLC28A1","15",84884654,84945798,61144
"8856","ENSG00000137860","ENSG00000137860","SLC28A2","15",45252234,45277846,25612
"8857","ENSG00000197506","ENSG00000197506","SLC28A3","9",84275457,84340758,65301
"8858","ENSG00000112759","ENSG00000112759","SLC29A1","6",44219553,44234142,14589
"8859","ENSG00000174669","ENSG00000174669","SLC29A2","11",66362521,66372214,9693
"8860","ENSG00000198246","ENSG00000198246","SLC29A3","10",71319259,71381423,62164
"8861","ENSG00000117394","ENSG00000117394","SLC2A1","1",42925353,42958893,33540
"8862","ENSG00000197496","ENSG00000197496","SLC2A10","20",46709649,46736347,26698
"8863","ENSG00000275744","ENSG00000275744","SLC2A11","HSCHR22_1_CTG7",93065,122671,29606
"8864","ENSG00000173262","ENSG00000173262","SLC2A14","12",7812512,7891148,78636
"8865","ENSG00000163581","ENSG00000163581","SLC2A2","3",170996347,171026743,30396
"8866","ENSG00000059804","ENSG00000059804","SLC2A3","12",7919230,8019007,99777
"8867","ENSG00000181856","ENSG00000181856","SLC2A4","17",7281718,7288257,6539
"8868","ENSG00000125520","ENSG00000125520","SLC2A4RG","20",63739776,63744050,4274
"8869","ENSG00000142583","ENSG00000142583","SLC2A5","1",9035106,9088478,53372
"8870","ENSG00000160326","ENSG00000160326","SLC2A6","9",133471094,133479127,8033
"8871","ENSG00000136856","ENSG00000136856","SLC2A8","9",127397138,127408424,11286
"8872","ENSG00000109667","ENSG00000109667","SLC2A9","4",9771153,10054936,283783
"8873","ENSG00000170385","ENSG00000170385","SLC30A1","1",211571568,211579161,7593
"8874","ENSG00000196660","ENSG00000196660","SLC30A10","1",219685427,219959018,273591
"8875","ENSG00000115194","ENSG00000115194","SLC30A3","2",27253684,27275817,22133
"8876","ENSG00000104154","ENSG00000104154","SLC30A4","15",45479606,45522755,43149
"8877","ENSG00000145740","ENSG00000145740","SLC30A5","5",69093991,69131069,37078
"8878","ENSG00000152683","ENSG00000152683","SLC30A6","2",32165841,32224379,58538
"8879","ENSG00000014824","ENSG00000014824","SLC30A9","4",41990502,42090461,99959
"8880","ENSG00000136868","ENSG00000136868","SLC31A1","9",113221544,113264492,42948
"8881","ENSG00000136867","ENSG00000136867","SLC31A2","9",113150976,113164140,13164
"8882","ENSG00000169359","ENSG00000169359","SLC33A1","3",155821024,155854456,33432
"8883","ENSG00000131183","ENSG00000131183","SLC34A1","5",177379235,177398848,19613
"8884","ENSG00000157765","ENSG00000157765","SLC34A2","4",25648011,25678748,30737
"8885","ENSG00000164414","ENSG00000164414","SLC35A1","6",87470623,87512336,41713
"8886","ENSG00000102100","ENSG00000102100","SLC35A2","X",48903180,48911958,8778
"8887","ENSG00000117620","ENSG00000117620","SLC35A3","1",99969351,100035634,66283
"8888","ENSG00000138459","ENSG00000138459","SLC35A5","3",112561709,112585579,23870
"8889","ENSG00000121073","ENSG00000121073","SLC35B1","17",49700934,49709014,8080
"8890","ENSG00000181830","ENSG00000181830","SLC35C1","11",45804072,45813016,8944
"8891","ENSG00000080189","ENSG00000080189","SLC35C2","20",46345980,46364458,18478
"8892","ENSG00000116704","ENSG00000116704","SLC35D1","1",66999350,67054148,54798
"8893","ENSG00000130958","ENSG00000130958","SLC35D2","9",96313444,96383711,70267
"8894","ENSG00000127526","ENSG00000127526","SLC35E1","19",16549831,16572415,22584
"8895","ENSG00000175782","ENSG00000175782","SLC35E3","12",68746125,68793964,47839
"8896","ENSG00000110660","ENSG00000110660","SLC35F2","11",107790991,107928293,137302
"8897","ENSG00000115084","ENSG00000115084","SLC35F5","2",113705011,113756693,51682
"8898","ENSG00000213699","ENSG00000213699","SLC35F6","2",26764284,26781231,16947
"8899","ENSG00000168917","ENSG00000168917","SLC35G2","3",136818647,136855888,37241
"8900","ENSG00000123643","ENSG00000123643","SLC36A1","5",151437046,151492379,55333
"8901","ENSG00000160190","ENSG00000160190","SLC37A1","21",42496008,42581440,85432
"8902","ENSG00000137700","ENSG00000137700","SLC37A4","11",119023751,119030906,7155
"8903","ENSG00000111371","ENSG00000111371","SLC38A1","12",46183063,46270017,86954
"8904","ENSG00000157637","ENSG00000157637","SLC38A10","17",81244811,81295547,50736
"8905","ENSG00000134294","ENSG00000134294","SLC38A2","12",46358188,46372773,14585
"8906","ENSG00000188338","ENSG00000188338","SLC38A3","3",50205246,50221486,16240
"8907","ENSG00000139209","ENSG00000139209","SLC38A4","12",46764761,46832408,67647
"8908","ENSG00000139974","ENSG00000139974","SLC38A6","14",60981114,61114316,133202
"8909","ENSG00000103042","ENSG00000103042","SLC38A7","16",58665109,58684770,19661
"8910","ENSG00000143570","ENSG00000143570","SLC39A1","1",153959099,153968184,9085
"8911","ENSG00000104635","ENSG00000104635","SLC39A14","8",22367278,22434129,66851
"8912","ENSG00000165794","ENSG00000165794","SLC39A2","14",20999255,21001871,2616
"8913","ENSG00000147804","ENSG00000147804","SLC39A4","8",144409742,144416844,7102
"8914","ENSG00000141424","ENSG00000141424","SLC39A6","18",36108531,36129385,20854
"8915","ENSG00000229802","ENSG00000229802","SLC39A7","HSCHR6_MHC_DBB_CTG1",4443944,4447938,3994
"8916","ENSG00000138821","ENSG00000138821","SLC39A8","4",102251080,102431258,180178
"8917","ENSG00000029364","ENSG00000029364","SLC39A9","14",69398015,69462390,64375
"8918","ENSG00000138079","ENSG00000138079","SLC3A1","2",44275458,44321494,46036
"8919","ENSG00000168003","ENSG00000168003","SLC3A2","11",62856004,62888880,32876
"8920","ENSG00000114544","ENSG00000114544","SLC41A3","3",126006357,126101561,95204
"8921","ENSG00000149150","ENSG00000149150","SLC43A1","11",57484534,57515780,31246
"8922","ENSG00000134802","ENSG00000134802","SLC43A3","11",57406954,57427580,20626
"8923","ENSG00000070214","ENSG00000070214","SLC44A1","9",105244622,105439171,194549
"8924","ENSG00000235336","ENSG00000235336","SLC44A4","HSCHR6_MHC_APD_CTG1",3195808,3211661,15853
"8925","ENSG00000281919","ENSG00000281919","SLC45A2","HSCHR5_6_CTG1",145938,155826,9888
"8926","ENSG00000139508","ENSG00000139508","SLC46A3","13",28700064,28718970,18906
"8927","ENSG00000142494","ENSG00000142494","SLC47A1","17",19495385,19579034,83649
"8928","ENSG00000211584","ENSG00000211584","SLC48A1","12",47753916,47782751,28835
"8929","ENSG00000004939","ENSG00000004939","SLC4A1","17",44248390,44268141,19751
"8930","ENSG00000144290","ENSG00000144290","SLC4A10","2",161424332,161985282,560950
"8931","ENSG00000163798","ENSG00000163798","SLC4A1AP","2",27663426,27695366,31940
"8932","ENSG00000164889","ENSG00000164889","SLC4A2","7",151057210,151076526,19316
"8933","ENSG00000114923","ENSG00000114923","SLC4A3","2",219627394,219641980,14586
"8934","ENSG00000080493","ENSG00000080493","SLC4A4","4",71062667,71572087,509420
"8935","ENSG00000033867","ENSG00000033867","SLC4A7","3",27372723,27484420,111697
"8936","ENSG00000050438","ENSG00000050438","SLC4A8","12",51391317,51515763,124446
"8937","ENSG00000169241","ENSG00000169241","SLC50A1","1",155135344,155138857,3513
"8938","ENSG00000132517","ENSG00000132517","SLC52A1","17",5032600,5052009,19409
"8939","ENSG00000185803","ENSG00000185803","SLC52A2","8",144333957,144361286,27329
"8940","ENSG00000100170","ENSG00000100170","SLC5A1","22",32043261,32113029,69768
"8941","ENSG00000148942","ENSG00000148942","SLC5A12","11",26667020,26723427,56407
"8942","ENSG00000140675","ENSG00000140675","SLC5A2","16",31483002,31490860,7858
"8943","ENSG00000198743","ENSG00000198743","SLC5A3","21",34073578,34106260,32682
"8944","ENSG00000100191","ENSG00000100191","SLC5A4","22",32218464,32255347,36883
"8945","ENSG00000105641","ENSG00000105641","SLC5A5","19",17871945,17895174,23229
"8946","ENSG00000138074","ENSG00000138074","SLC5A6","2",27199587,27212958,13371
"8947","ENSG00000157103","ENSG00000157103","SLC6A1","3",10992186,11039247,47061
"8948","ENSG00000132164","ENSG00000132164","SLC6A11","3",10816201,10940714,124513
"8949","ENSG00000111181","ENSG00000111181","SLC6A12","12",190077,214570,24493
"8950","ENSG00000010379","ENSG00000010379","SLC6A13","12",220621,262873,42252
"8951","ENSG00000268104","ENSG00000268104","SLC6A14","X",116436606,116461458,24852
"8952","ENSG00000072041","ENSG00000072041","SLC6A15","12",84859491,84913629,54138
"8953","ENSG00000063127","ENSG00000063127","SLC6A16","19",49289638,49325215,35577
"8954","ENSG00000103546","ENSG00000103546","SLC6A2","16",55655988,55707645,51657
"8955","ENSG00000276996","ENSG00000276996","SLC6A3","HSCHR5_3_CTG1",64343,121219,56876
"8956","ENSG00000108576","ENSG00000108576","SLC6A4","17",30194319,30236002,41683
"8957","ENSG00000165970","ENSG00000165970","SLC6A5","11",20599594,20659285,59691
"8958","ENSG00000131389","ENSG00000131389","SLC6A6","3",14402576,14489349,86773
"8959","ENSG00000011083","ENSG00000011083","SLC6A7","5",150190062,150222788,32726
"8960","ENSG00000130821","ENSG00000130821","SLC6A8","X",153687926,153696588,8662
"8961","ENSG00000196517","ENSG00000196517","SLC6A9","1",43991500,44031467,39967
"8962","ENSG00000139514","ENSG00000139514","SLC7A1","13",29509414,29595688,86274
"8963","ENSG00000130876","ENSG00000130876","SLC7A10","19",33208664,33225850,17186
"8964","ENSG00000151012","ENSG00000151012","SLC7A11","4",138164097,138242349,78252
"8965","ENSG00000003989","ENSG00000003989","SLC7A2","8",17497088,17570573,73485
"8966","ENSG00000099960","ENSG00000099960","SLC7A4","22",21028718,21032840,4122
"8967","ENSG00000103257","ENSG00000103257","SLC7A5","16",87830023,87869507,39484
"8968","ENSG00000103064","ENSG00000103064","SLC7A6","16",68264516,68301823,37307
"8969","ENSG00000155465","ENSG00000155465","SLC7A7","14",22773222,22829820,56598
"8970","ENSG00000092068","ENSG00000092068","SLC7A8","14",23125295,23183674,58379
"8971","ENSG00000021488","ENSG00000021488","SLC7A9","19",32830509,32869767,39258
"8972","ENSG00000183023","ENSG00000183023","SLC8A1","2",40097270,40611053,513783
"8973","ENSG00000118160","ENSG00000118160","SLC8A2","19",47428017,47471893,43876
"8974","ENSG00000089060","ENSG00000089060","SLC8B1","12",113298759,113359493,60734
"8975","ENSG00000090020","ENSG00000090020","SLC9A1","1",27098809,27166981,68172
"8976","ENSG00000066230","ENSG00000066230","SLC9A3","5",470456,524449,53993
"8977","ENSG00000135740","ENSG00000135740","SLC9A5","16",67237683,67272191,34508
"8978","ENSG00000198689","ENSG00000198689","SLC9A6","X",135973841,136047269,73428
"8979","ENSG00000065923","ENSG00000065923","SLC9A7","X",46599251,46759118,159867
"8980","ENSG00000197818","ENSG00000197818","SLC9A8","20",49812713,49892242,79529
"8981","ENSG00000084453","ENSG00000084453","SLCO1A2","12",21264600,21419594,154994
"8982","ENSG00000134538","ENSG00000134538","SLCO1B1","12",21131194,21239796,108602
"8983","ENSG00000111700","ENSG00000111700","SLCO1B3","12",20810702,20916911,106209
"8984","ENSG00000139155","ENSG00000139155","SLCO1C1","12",20695332,20753386,58054
"8985","ENSG00000174640","ENSG00000174640","SLCO2A1","3",133932701,134052184,119483
"8986","ENSG00000137491","ENSG00000137491","SLCO2B1","11",75100563,75206549,105986
"8987","ENSG00000176463","ENSG00000176463","SLCO3A1","15",91853708,92172435,318727
"8988","ENSG00000101187","ENSG00000101187","SLCO4A1","20",62642503,62685785,43282
"8989","ENSG00000173930","ENSG00000173930","SLCO4C1","5",102233986,102296284,62298
"8990","ENSG00000137571","ENSG00000137571","SLCO5A1","8",69667046,69834978,167932
"8991","ENSG00000119906","ENSG00000119906","SLF2","10",100912963,100965134,52171
"8992","ENSG00000172123","ENSG00000172123","SLFN12","17",35409465,35433475,24010
"8993","ENSG00000119705","ENSG00000119705","SLIRP","14",77708071,77761104,53033
"8994","ENSG00000187122","ENSG00000187122","SLIT1","10",96998038,97185959,187921
"8995","ENSG00000145147","ENSG00000145147","SLIT2","4",20251905,20620561,368656
"8996","ENSG00000184347","ENSG00000184347","SLIT3","5",168661740,169301139,639399
"8997","ENSG00000121871","ENSG00000121871","SLITRK3","3",165186720,165197109,10389
"8998","ENSG00000165300","ENSG00000165300","SLITRK5","13",87671371,87696272,24901
"8999","ENSG00000065613","ENSG00000065613","SLK","10",103967140,104029233,62093
"9000","ENSG00000170290","ENSG00000170290","SLN","11",107707378,107719693,12315
"9001","ENSG00000124107","ENSG00000124107","SLPI","20",45252239,45254564,2325
"9002","ENSG00000137776","ENSG00000137776","SLTM","15",58879050,58933679,54629
"9003","ENSG00000132207","ENSG00000132207","SLX1A","16",30193875,30197561,3686
"9004","ENSG00000181625","ENSG00000181625","SLX1B","16",29454533,29458219,3686
"9005","ENSG00000170365","ENSG00000170365","SMAD1","4",145481194,145559176,77982
"9006","ENSG00000175387","ENSG00000175387","SMAD2","18",47808957,47931146,122189
"9007","ENSG00000166949","ENSG00000166949","SMAD3","15",67063763,67195173,131410
"9008","ENSG00000141646","ENSG00000141646","SMAD4","18",51028528,51085045,56517
"9009","ENSG00000113658","ENSG00000113658","SMAD5","5",136132845,136188747,55902
"9010","ENSG00000137834","ENSG00000137834","SMAD6","15",66702236,66782849,80613
"9011","ENSG00000101665","ENSG00000101665","SMAD7","18",48919853,48950965,31112
"9012","ENSG00000170545","ENSG00000170545","SMAGP","12",51244558,51270415,25857
"9013","ENSG00000112305","ENSG00000112305","SMAP1","6",70667776,70862011,194235
"9014","ENSG00000102038","ENSG00000102038","SMARCA1","X",129446501,129523500,76999
"9015","ENSG00000080503","ENSG00000080503","SMARCA2","9",1980290,2193624,213334
"9016","ENSG00000127616","ENSG00000127616","SMARCA4","19",10960932,11079426,118494
"9017","ENSG00000153147","ENSG00000153147","SMARCA5","4",143513702,143557486,43784
"9018","ENSG00000138375","ENSG00000138375","SMARCAL1","2",216412383,216483053,70670
"9019","ENSG00000275837","ENSG00000275837","SMARCB1","HSCHR22_1_CTG7",23325,70878,47553
"9020","ENSG00000173473","ENSG00000173473","SMARCC1","3",47585269,47782106,196837
"9021","ENSG00000139613","ENSG00000139613","SMARCC2","12",56162359,56189567,27208
"9022","ENSG00000066117","ENSG00000066117","SMARCD1","12",50085200,50100707,15507
"9023","ENSG00000108604","ENSG00000108604","SMARCD2","17",63832081,63843065,10984
"9024","ENSG00000082014","ENSG00000082014","SMARCD3","7",151238764,151277896,39132
"9025","ENSG00000073584","ENSG00000073584","SMARCE1","17",40624962,40648654,23692
"9026","ENSG00000072501","ENSG00000072501","SMC1A","X",53374149,53422728,48579
"9027","ENSG00000136824","ENSG00000136824","SMC2","9",104094260,104141419,47159
"9028","ENSG00000108055","ENSG00000108055","SMC3","10",110567684,110606048,38364
"9029","ENSG00000113810","ENSG00000113810","SMC4","3",160399274,160434954,35680
"9030","ENSG00000198887","ENSG00000198887","SMC5","9",70258978,70354873,95895
"9031","ENSG00000163029","ENSG00000163029","SMC6","2",17663812,17800242,136430
"9032","ENSG00000101596","ENSG00000101596","SMCHD1","18",2655726,2805017,149291
"9033","ENSG00000166002","ENSG00000166002","SMCO4","11",93478472,93543391,64919
"9034","ENSG00000157106","ENSG00000157106","SMG1","16",18804860,18926408,121548
"9035","ENSG00000198952","ENSG00000198952","SMG5","1",156249224,156282825,33601
"9036","ENSG00000070366","ENSG00000070366","SMG6","17",2059839,2303785,243946
"9037","ENSG00000116698","ENSG00000116698","SMG7","1",183472216,183598246,126030
"9038","ENSG00000167447","ENSG00000167447","SMG8","17",59209400,59215239,5839
"9039","ENSG00000105771","ENSG00000105771","SMG9","19",43727983,43754962,26979
"9040","ENSG00000163683","ENSG00000163683","SMIM14","4",39546336,39638902,92566
"9041","ENSG00000214046","ENSG00000214046","SMIM7","19",16630751,16660442,29691
"9042","ENSG00000111850","ENSG00000111850","SMIM8","6",87322583,87399749,77166
"9043","ENSG00000275349","ENSG00000275349","SMN1","HSCHR5_1_CTG1_1",473491,501447,27956
"9044","ENSG00000277773","ENSG00000277773","SMN2","HSCHR5_2_CTG1_1",456849,485731,28882
"9045","ENSG00000119953","ENSG00000119953","SMNDC1","10",110290730,110304938,14208
"9046","ENSG00000128602","ENSG00000128602","SMO","7",129188633,129213545,24912
"9047","ENSG00000088826","ENSG00000088826","SMOX","20",4120980,4187747,66767
"9048","ENSG00000166311","ENSG00000166311","SMPD1","11",6390440,6394998,4558
"9049","ENSG00000135587","ENSG00000135587","SMPD2","6",109440724,109443919,3195
"9050","ENSG00000103056","ENSG00000103056","SMPD3","16",68358327,68448508,90181
"9051","ENSG00000136699","ENSG00000136699","SMPD4","2",130151392,130182750,31358
"9052","ENSG00000172594","ENSG00000172594","SMPDL3A","6",122789049,122809720,20671
"9053","ENSG00000130768","ENSG00000130768","SMPDL3B","1",27935000,27959157,24157
"9054","ENSG00000091482","ENSG00000091482","SMPX","X",21705978,21758116,52138
"9055","ENSG00000102172","ENSG00000102172","SMS","X",21940709,21994837,54128
"9056","ENSG00000183963","ENSG00000183963","SMTN","22",31064105,31104757,40652
"9057","ENSG00000122692","ENSG00000122692","SMU1","9",33041765,33076674,34909
"9058","ENSG00000123415","ENSG00000123415","SMUG1","12",54121277,54189008,67731
"9059","ENSG00000198742","ENSG00000198742","SMURF1","7",99027440,99144108,116668
"9060","ENSG00000108854","ENSG00000108854","SMURF2","17",64542282,64662307,120025
"9061","ENSG00000143499","ENSG00000143499","SMYD2","1",214281102,214337131,56029
"9062","ENSG00000185420","ENSG00000185420","SMYD3","1",245749342,246507312,757970
"9063","ENSG00000135632","ENSG00000135632","SMYD5","2",73214222,73227221,12999
"9064","ENSG00000124216","ENSG00000124216","SNAI1","20",49982980,49988886,5906
"9065","ENSG00000019549","ENSG00000019549","SNAI2","8",48917598,48921740,4142
"9066","ENSG00000092531","ENSG00000092531","SNAP23","15",42491233,42545356,54123
"9067","ENSG00000132639","ENSG00000132639","SNAP25","20",10172395,10308258,135863
"9068","ENSG00000099940","ENSG00000099940","SNAP29","22",20859007,20891214,32207
"9069","ENSG00000065609","ENSG00000065609","SNAP91","6",83552880,83709691,156811
"9070","ENSG00000023608","ENSG00000023608","SNAPC1","14",61762420,61796428,34008
"9071","ENSG00000104976","ENSG00000104976","SNAPC2","19",7920338,7923250,2912
"9072","ENSG00000164975","ENSG00000164975","SNAPC3","9",15422734,15465953,43219
"9073","ENSG00000165684","ENSG00000165684","SNAPC4","9",136375567,136400176,24609
"9074","ENSG00000174446","ENSG00000174446","SNAPC5","15",66490135,66497780,7645
"9075","ENSG00000145335","ENSG00000145335","SNCA","4",89700345,89838315,137970
"9076","ENSG00000064692","ENSG00000064692","SNCAIP","5",122311354,122464219,152865
"9077","ENSG00000074317","ENSG00000074317","SNCB","5",176620082,176630556,10474
"9078","ENSG00000173267","ENSG00000173267","SNCG","10",86958599,86963258,4659
"9079","ENSG00000197157","ENSG00000197157","SND1","7",127652194,128092609,440415
"9080","ENSG00000162804","ENSG00000162804","SNED1","2",240998618,241095568,96950
"9081","ENSG00000159210","ENSG00000159210","SNF8","17",48929316,48944842,15526
"9082","ENSG00000163877","ENSG00000163877","SNIP1","1",37534449,37554293,19844
"9083","ENSG00000184602","ENSG00000184602","SNN","16",11668455,11679152,10697
"9084","ENSG00000101298","ENSG00000101298","SNPH","20",1266280,1309328,43048
"9085","ENSG00000163788","ENSG00000163788","SNRK","3",43286512,43424764,138252
"9086","ENSG00000144028","ENSG00000144028","SNRNP200","2",96274338,96321271,46933
"9087","ENSG00000161981","ENSG00000161981","SNRNP25","16",53828,57669,3841
"9088","ENSG00000124380","ENSG00000124380","SNRNP27","2",69893956,69905575,11619
"9089","ENSG00000184209","ENSG00000184209","SNRNP35","12",123458088,123473154,15066
"9090","ENSG00000060688","ENSG00000060688","SNRNP40","1",31259568,31296788,37220
"9091","ENSG00000104852","ENSG00000104852","SNRNP70","19",49085419,49108605,23186
"9092","ENSG00000077312","ENSG00000077312","SNRPA","19",40750637,40765389,14752
"9093","ENSG00000131876","ENSG00000131876","SNRPA1","15",101281510,101295282,13772
"9094","ENSG00000125835","ENSG00000125835","SNRPB","20",2461634,2470853,9219
"9095","ENSG00000125870","ENSG00000125870","SNRPB2","20",16729961,16742564,12603
"9096","ENSG00000124562","ENSG00000124562","SNRPC","6",34757505,34773857,16352
"9097","ENSG00000167088","ENSG00000167088","SNRPD1","18",21612314,21633524,21210
"9098","ENSG00000125743","ENSG00000125743","SNRPD2","19",45687460,45692569,5109
"9099","ENSG00000100028","ENSG00000100028","SNRPD3","22",24555958,24582052,26094
"9100","ENSG00000182004","ENSG00000182004","SNRPE","1",203861599,203871152,9553
"9101","ENSG00000139343","ENSG00000139343","SNRPF","12",95858952,95903828,44876
"9102","ENSG00000143977","ENSG00000143977","SNRPG","2",70281362,70293740,12378
"9103","ENSG00000128739","ENSG00000128739","SNRPN","15",24823637,24978723,155086
"9104","ENSG00000101400","ENSG00000101400","SNTA1","20",33407957,33443763,35806
"9105","ENSG00000172164","ENSG00000172164","SNTB1","8",120535745,120813273,277528
"9106","ENSG00000168807","ENSG00000168807","SNTB2","16",69187147,69309052,121905
"9107","ENSG00000147481","ENSG00000147481","SNTG1","8",49909789,50796692,886903
"9108","ENSG00000100138","ENSG00000100138","SNU13","22",41673933,41690504,16571
"9109","ENSG00000169371","ENSG00000169371","SNUPN","15",75598083,75626469,28386
"9110","ENSG00000273173","ENSG00000273173","SNURF","15",24954987,24977850,22863
"9111","ENSG00000100603","ENSG00000100603","SNW1","14",77717599,77761207,43608
"9112","ENSG00000028528","ENSG00000028528","SNX1","15",64094123,64146090,51967
"9113","ENSG00000086300","ENSG00000086300","SNX10","7",26291862,26374383,82521
"9114","ENSG00000002919","ENSG00000002919","SNX11","17",48103357,48123601,20244
"9115","ENSG00000071189","ENSG00000071189","SNX13","7",17790761,17940501,149740
"9116","ENSG00000110025","ENSG00000110025","SNX15","11",65027439,65040572,13133
"9117","ENSG00000104497","ENSG00000104497","SNX16","8",81799581,81842866,43285
"9118","ENSG00000115234","ENSG00000115234","SNX17","2",27370496,27377535,7039
"9119","ENSG00000120451","ENSG00000120451","SNX19","11",130866250,130916479,50229
"9120","ENSG00000205302","ENSG00000205302","SNX2","5",122775079,122834543,59464
"9121","ENSG00000064652","ENSG00000064652","SNX24","5",122843439,123029354,185915
"9122","ENSG00000143376","ENSG00000143376","SNX27","1",151612006,151699091,87085
"9123","ENSG00000048471","ENSG00000048471","SNX29","16",11976734,12574287,597553
"9124","ENSG00000112335","ENSG00000112335","SNX3","6",108211222,108261246,50024
"9125","ENSG00000114520","ENSG00000114520","SNX4","3",125446650,125520202,73552
"9126","ENSG00000089006","ENSG00000089006","SNX5","20",17941597,17968980,27383
"9127","ENSG00000129515","ENSG00000129515","SNX6","14",34561093,34630160,69067
"9128","ENSG00000162627","ENSG00000162627","SNX7","1",98661701,98760500,98799
"9129","ENSG00000057252","ENSG00000057252","SOAT1","1",179293714,179358680,64966
"9130","ENSG00000167780","ENSG00000167780","SOAT2","12",53103486,53124535,21049
"9131","ENSG00000112320","ENSG00000112320","SOBP","6",107490106,107661306,171200
"9132","ENSG00000185338","ENSG00000185338","SOCS1","16",11254417,11256204,1787
"9133","ENSG00000120833","ENSG00000120833","SOCS2","12",93569814,93583487,13673
"9134","ENSG00000184557","ENSG00000184557","SOCS3","17",78356778,78360077,3299
"9135","ENSG00000171150","ENSG00000171150","SOCS5","2",46698952,46780245,81293
"9136","ENSG00000170677","ENSG00000170677","SOCS6","18",70289045,70330199,41154
"9137","ENSG00000274229","ENSG00000274229","SOCS7","HSCHR17_7_CTG4",2387176,2440912,53736
"9138","ENSG00000142168","ENSG00000142168","SOD1","21",31659666,31668931,9265
"9139","ENSG00000109610","ENSG00000109610","SOD3","4",24789912,24800842,10930
"9140","ENSG00000149639","ENSG00000149639","MTCL2","20",36777447,36863538,86091
"9141","ENSG00000120669","ENSG00000120669","SOHLH2","13",36168217,36214588,46371
"9142","ENSG00000159140","ENSG00000159140","SON","21",33543038,33577481,34443
"9143","ENSG00000095637","ENSG00000095637","SORBS1","10",95311771,95561414,249643
"9144","ENSG00000154556","ENSG00000154556","SORBS2","4",185585444,185956652,371208
"9145","ENSG00000120896","ENSG00000120896","SORBS3","8",22544986,22575788,30802
"9146","ENSG00000140263","ENSG00000140263","SORD","15",45023147,45077185,54038
"9147","ENSG00000137642","ENSG00000137642","SORL1","11",121452314,121633763,181449
"9148","ENSG00000134243","ENSG00000134243","SORT1","1",109309568,109397918,88350
"9149","ENSG00000115904","ENSG00000115904","SOS1","2",38962206,39124345,162139
"9150","ENSG00000100485","ENSG00000100485","SOS2","14",50117130,50231578,114448
"9151","ENSG00000171243","ENSG00000171243","SOSTDC1","7",16461481,16530580,69099
"9152","ENSG00000198142","ENSG00000198142","SOWAHC","2",109614364,109618990,4626
"9153","ENSG00000100146","ENSG00000100146","SOX10","22",37970686,37987422,16736
"9154","ENSG00000176887","ENSG00000176887","SOX11","2",5692384,5701385,9001
"9155","ENSG00000177732","ENSG00000177732","SOX12","20",325552,330224,4672
"9156","ENSG00000143842","ENSG00000143842","SOX13","1",204073115,204127743,54628
"9157","ENSG00000129194","ENSG00000129194","SOX15","17",7588178,7590094,1916
"9158","ENSG00000164736","ENSG00000164736","SOX17","8",54457935,54460892,2957
"9159","ENSG00000203883","ENSG00000203883","SOX18","20",64047582,64049639,2057
"9160","ENSG00000181449","ENSG00000181449","SOX2","3",181711925,181714436,2511
"9161","ENSG00000134595","ENSG00000134595","SOX3","X",140502985,140505069,2084
"9162","ENSG00000039600","ENSG00000039600","SOX30","5",157625679,157671480,45801
"9163","ENSG00000124766","ENSG00000124766","SOX4","6",21593751,21598619,4868
"9164","ENSG00000134532","ENSG00000134532","SOX5","12",23529504,24562544,1033040
"9165","ENSG00000125398","ENSG00000125398","SOX9","17",72121020,72126416,5396
"9166","ENSG00000185591","ENSG00000185591","SP1","12",53380176,53416446,36270
"9167","ENSG00000067066","ENSG00000067066","SP100","2",230415942,230545606,129664
"9168","ENSG00000135899","ENSG00000135899","SP110","2",230165186,230225729,60543
"9169","ENSG00000079263","ENSG00000079263","SP140","2",230203110,230313215,110105
"9170","ENSG00000185404","ENSG00000185404","SP140L","2",230327184,230403732,76548
"9171","ENSG00000167182","ENSG00000167182","SP2","17",47896150,47928957,32807
"9172","ENSG00000172845","ENSG00000172845","SP3","2",173880850,173965373,84523
"9173","ENSG00000105866","ENSG00000105866","SP4","7",21428043,21514822,86779
"9174","ENSG00000064199","ENSG00000064199","SPA17","11",124673844,124697518,23674
"9175","ENSG00000165698","ENSG00000165698","SPACA9","9",132878027,132890201,12174
"9176","ENSG00000104450","ENSG00000104450","SPAG1","8",100157906,100259278,101372
"9177","ENSG00000144451","ENSG00000144451","SPAG16","2",213284389,214410501,1126112
"9178","ENSG00000061656","ENSG00000061656","SPAG4","20",35615829,35621094,5265
"9179","ENSG00000076382","ENSG00000076382","SPAG5","17",28577565,28599025,21460
"9180","ENSG00000077327","ENSG00000077327","SPAG6","10",22345445,22454224,108779
"9181","ENSG00000091640","ENSG00000091640","SPAG7","17",4959226,4967817,8591
"9182","ENSG00000008294","ENSG00000008294","SPAG9","17",50962174,51120868,158694
"9183","ENSG00000227234","ENSG00000227234","SPANXB1","X",141002594,141003706,1112
"9184","ENSG00000198573","ENSG00000198573","SPANXC","X",141241463,141242517,1054
"9185","ENSG00000152583","ENSG00000152583","SPARCL1","4",87473335,87531061,57726
"9186","ENSG00000021574","ENSG00000021574","SPAST","2",32063556,32157637,94081
"9187","ENSG00000158480","ENSG00000158480","SPATA2","20",49903391,49915529,12138
"9188","ENSG00000006282","ENSG00000006282","SPATA20","17",50543058,50555852,12794
"9189","ENSG00000158792","ENSG00000158792","SPATA2L","16",89696357,89701705,5348
"9190","ENSG00000276040","ENSG00000276040","SPATA31A7","9",61190036,61196280,6244
"9191","ENSG00000132122","ENSG00000132122","SPATA6","1",48295373,48472208,176835
"9192","ENSG00000042317","ENSG00000042317","SPATA7","14",88384924,88470350,85426
"9193","ENSG00000123352","ENSG00000123352","SPATS2","12",49366584,49527425,160841
"9194","ENSG00000196141","ENSG00000196141","SPATS2L","2",200305881,200482264,176383
"9195","ENSG00000277909","ENSG00000277909","SPC25","HSCHR2_1_CTG7_2",3770,99998,96228
"9196","ENSG00000114902","ENSG00000114902","SPCS1","3",52704955,52711148,6193
"9197","ENSG00000118363","ENSG00000118363","SPCS2","11",74949261,74979033,29772
"9198","ENSG00000129128","ENSG00000129128","SPCS3","4",176319966,176332245,12279
"9199","ENSG00000124664","ENSG00000124664","SPDEF","6",34537802,34556333,18531
"9200","ENSG00000040275","ENSG00000040275","SPDL1","5",169583636,169604778,21142
"9201","ENSG00000100014","ENSG00000100014","SPECC1L","22",24270817,24417739,146922
"9202","ENSG00000101222","ENSG00000101222","SPEF1","20",3777504,3781448,3944
"9203","ENSG00000072195","ENSG00000072195","SPEG","2",219434843,219493629,58786
"9204","ENSG00000065526","ENSG00000065526","SPEN","1",15836095,15940456,104361
"9205","ENSG00000104133","ENSG00000104133","SPG11","15",44554818,44663688,108870
"9206","ENSG00000090487","ENSG00000090487","SPG21","15",64963022,64990310,27288
"9207","ENSG00000197912","ENSG00000197912","SPG7","16",89490719,89557766,67047
"9208","ENSG00000176170","ENSG00000176170","SPHK1","17",76376584,76387860,11276
"9209","ENSG00000063176","ENSG00000063176","SPHK2","19",48619291,48630717,11426
"9210","ENSG00000066336","ENSG00000066336","SPI1","11",47354860,47409369,54509
"9211","ENSG00000269404","ENSG00000269404","SPIB","19",50418938,50431314,12376
"9212","ENSG00000163611","ENSG00000163611","SPICE1","3",113442718,113515187,72469
"9213","ENSG00000164808","ENSG00000164808","SPIDR","8",47260878,47736306,475428
"9214","ENSG00000106723","ENSG00000106723","SPIN1","9",88388430,88478694,90264
"9215","ENSG00000147059","ENSG00000147059","SPIN2A","X",57134530,57137523,2993
"9216","ENSG00000164266","ENSG00000164266","SPINK1","5",147824572,147831671,7099
"9217","ENSG00000128040","ENSG00000128040","SPINK2","4",56809860,56821742,11882
"9218","ENSG00000122711","ENSG00000122711","SPINK4","9",33218365,33248567,30202
"9219","ENSG00000133710","ENSG00000133710","SPINK5","5",148025683,148137382,111699
"9220","ENSG00000166145","ENSG00000166145","SPINT1","15",40844018,40858207,14189
"9221","ENSG00000167642","ENSG00000167642","SPINT2","19",38244035,38292615,48580
"9222","ENSG00000197471","ENSG00000197471","SPN","16",29662979,29670876,7897
"9223","ENSG00000152377","ENSG00000152377","SPOCK1","5",136975298,137598379,623081
"9224","ENSG00000107742","ENSG00000107742","SPOCK2","10",72059034,72089032,29998
"9225","ENSG00000196104","ENSG00000196104","SPOCK3","4",166733384,167234796,501412
"9226","ENSG00000262655","ENSG00000262655","SPON1","11",13962723,14268133,305410
"9227","ENSG00000159674","ENSG00000159674","SPON2","4",1166932,1208962,42030
"9228","ENSG00000121067","ENSG00000121067","SPOP","17",49598884,49678163,79279
"9229","ENSG00000118785","ENSG00000118785","SPP1","4",87975667,87983532,7865
"9230","ENSG00000072080","ENSG00000072080","SPP2","2",234050679,234077134,26455
"9231","ENSG00000005206","ENSG00000005206","SPPL2B","19",2328615,2355095,26480
"9232","ENSG00000116096","ENSG00000116096","SPR","2",72887382,72892158,4776
"9233","ENSG00000198369","ENSG00000198369","SPRED2","2",65310851,65432637,121786
"9234","ENSG00000169474","ENSG00000169474","SPRR1A","1",152984081,152985814,1733
"9235","ENSG00000169469","ENSG00000169469","SPRR1B","1",153031203,153032900,1697
"9236","ENSG00000163216","ENSG00000163216","SPRR2D","1",153039732,153041931,2199
"9237","ENSG00000163209","ENSG00000163209","SPRR3","1",153001747,153003856,2109
"9238","ENSG00000164056","ENSG00000164056","SPRY1","4",123396795,123403760,6965
"9239","ENSG00000136158","ENSG00000136158","SPRY2","13",80335976,80341126,5150
"9240","ENSG00000123178","ENSG00000123178","SPRYD7","13",49912702,49936490,23788
"9241","ENSG00000171621","ENSG00000171621","SPSB1","1",9292894,9369532,76638
"9242","ENSG00000162032","ENSG00000162032","SPSB3","16",1776712,1793700,16988
"9243","ENSG00000197694","ENSG00000197694","SPTAN1","9",128552558,128633662,81104
"9244","ENSG00000070182","ENSG00000070182","SPTB","14",64746283,64879907,133624
"9245","ENSG00000115306","ENSG00000115306","SPTBN1","2",54456327,54671446,215119
"9246","ENSG00000173898","ENSG00000173898","SPTBN2","11",66682496,66744670,62174
"9247","ENSG00000160460","ENSG00000160460","SPTBN4","19",40466241,40576464,110223
"9248","ENSG00000137877","ENSG00000137877","SPTBN5","15",41848146,41894053,45907
"9249","ENSG00000090054","ENSG00000090054","SPTLC1","9",92000087,92115413,115326
"9250","ENSG00000100596","ENSG00000100596","SPTLC2","14",77505997,77616637,110640
"9251","ENSG00000172296","ENSG00000172296","SPTLC3","20",13008972,13169103,160131
"9252","ENSG00000165389","ENSG00000165389","SPTSSA","14",34432788,34462240,29452
"9253","ENSG00000134548","ENSG00000134548","SPX","12",21526296,21541249,14953
"9254","ENSG00000104549","ENSG00000104549","SQLE","8",124998497,125022283,23786
"9255","ENSG00000161011","ENSG00000161011","SQSTM1","5",179806398,179838078,31680
"9256","ENSG00000068784","ENSG00000068784","SRBD1","2",45388680,45612165,223485
"9257","ENSG00000197122","ENSG00000197122","SRC","20",37344685,37406050,61365
"9258","ENSG00000080603","ENSG00000080603","SRCAP","16",30698209,30741409,43200
"9259","ENSG00000145545","ENSG00000145545","SRD5A1","5",6633290,6676539,43249
"9260","ENSG00000277893","ENSG00000277893","SRD5A2","2",31522480,31580938,58458
"9261","ENSG00000128039","ENSG00000128039","SRD5A3","4",55346213,55373100,26887
"9262","ENSG00000072310","ENSG00000072310","SREBF1","17",17810399,17837002,26603
"9263","ENSG00000198911","ENSG00000198911","SREBF2","22",41833105,41907306,74201
"9264","ENSG00000153914","ENSG00000153914","SREK1","5",66139971,66183615,43644
"9265","ENSG00000153006","ENSG00000153006","SREK1IP1","5",64718148,64768691,50543
"9266","ENSG00000112658","ENSG00000112658","SRF","6",43171269,43181506,10237
"9267","ENSG00000266028","ENSG00000266028","SRGAP2","1",206203346,206464436,261090
"9268","ENSG00000196220","ENSG00000196220","SRGAP3","3",8980591,9363053,382462
"9269","ENSG00000122862","ENSG00000122862","SRGN","10",69088103,69104805,16702
"9270","ENSG00000075142","ENSG00000075142","SRI","7",88205115,88226993,21878
"9271","ENSG00000116649","ENSG00000116649","SRM","1",11054584,11060020,5436
"9272","ENSG00000140319","ENSG00000140319","SRP14","15",40035690,40039181,3491
"9273","ENSG00000153037","ENSG00000153037","SRP19","5",112861188,112898371,37183
"9274","ENSG00000100883","ENSG00000100883","SRP54","14",34981957,35029686,47729
"9275","ENSG00000174780","ENSG00000174780","SRP72","4",56467617,56503681,36064
"9276","ENSG00000143742","ENSG00000143742","SRP9","1",225777813,225790468,12655
"9277","ENSG00000096063","ENSG00000096063","SRPK1","6",35832966,35921342,88376
"9278","ENSG00000135250","ENSG00000135250","SRPK2","7",105110704,105399308,288604
"9279","ENSG00000184343","ENSG00000184343","SRPK3","X",153776412,153785732,9320
"9280","ENSG00000182934","ENSG00000182934","SRPRA","11",126262938,126269144,6206
"9281","ENSG00000144867","ENSG00000144867","SRPRB","3",133784023,133825772,41749
"9282","ENSG00000101955","ENSG00000101955","SRPX","X",38149336,38220924,71588
"9283","ENSG00000102359","ENSG00000102359","SRPX2","X",100644195,100675788,31593
"9284","ENSG00000167720","ENSG00000167720","SRR","17",2303383,2325260,21877
"9285","ENSG00000133226","ENSG00000133226","SRRM1","1",24631716,24673281,41565
"9286","ENSG00000167978","ENSG00000167978","SRRM2","16",2752626,2772538,19912
"9287","ENSG00000087087","ENSG00000087087","SRRT","7",100875103,100888664,13561
"9288","ENSG00000136450","ENSG00000136450","SRSF1","17",58000919,58007346,6427
"9289","ENSG00000188529","ENSG00000188529","SRSF10","1",23964347,23980927,16580
"9290","ENSG00000116754","ENSG00000116754","SRSF11","1",70205682,70253052,47370
"9291","ENSG00000161547","ENSG00000161547","SRSF2","17",76734115,76737333,3218
"9292","ENSG00000112081","ENSG00000112081","SRSF3","6",36594353,36605600,11247
"9293","ENSG00000116350","ENSG00000116350","SRSF4","1",29147743,29181900,34157
"9294","ENSG00000100650","ENSG00000100650","SRSF5","14",69726900,69772005,45105
"9295","ENSG00000124193","ENSG00000124193","SRSF6","20",43457893,43466046,8153
"9296","ENSG00000115875","ENSG00000115875","SRSF7","2",38743599,38751494,7895
"9297","ENSG00000263465","ENSG00000263465","SRSF8","11",95066919,95071225,4306
"9298","ENSG00000111786","ENSG00000111786","SRSF9","12",120461672,120495946,34274
"9299","ENSG00000141380","ENSG00000141380","SS18","18",26016253,26091217,74964
"9300","ENSG00000184402","ENSG00000184402","SS18L1","20",62143769,62182514,38745
"9301","ENSG00000008324","ENSG00000008324","SS18L2","3",42581840,42596934,15094
"9302","ENSG00000138385","ENSG00000138385","SSB","2",169791933,169812064,20131
"9303","ENSG00000262771","ENSG00000262771","SSBP1","HSCHR7_1_CTG6",110921,119126,8205
"9304","ENSG00000145687","ENSG00000145687","SSBP2","5",81412804,81751797,338993
"9305","ENSG00000157216","ENSG00000157216","SSBP3","1",54225432,54413479,188047
"9306","ENSG00000084112","ENSG00000084112","SSH1","12",108778191,108857590,79399
"9307","ENSG00000172830","ENSG00000172830","SSH3","11",67303478,67312607,9129
"9308","ENSG00000176101","ENSG00000176101","SSNA1","9",137188660,137190370,1710
"9309","ENSG00000123096","ENSG00000123096","SSPN","12",26121991,26299290,177299
"9310","ENSG00000124783","ENSG00000124783","SSR1","6",7268306,7347446,79140
"9311","ENSG00000163479","ENSG00000163479","SSR2","1",156009048,156020951,11903
"9312","ENSG00000114850","ENSG00000114850","SSR3","3",156539553,156555149,15596
"9313","ENSG00000180879","ENSG00000180879","SSR4","X",153793516,153798499,4983
"9314","ENSG00000149136","ENSG00000149136","SSRP1","11",57325986,57335892,9906
"9315","ENSG00000157005","ENSG00000157005","SST","3",187668912,187670394,1482
"9316","ENSG00000139874","ENSG00000139874","SSTR1","14",38207904,38213067,5163
"9317","ENSG00000180616","ENSG00000180616","SSTR2","17",73165010,73176633,11623
"9318","ENSG00000162009","ENSG00000162009","SSTR5","16",1063867,1081454,17587
"9319","ENSG00000125046","ENSG00000125046","SSUH2","3",8619386,8745040,125654
"9320","ENSG00000126752","ENSG00000126752","SSX1","X",48255392,48267444,12052
"9321","ENSG00000117155","ENSG00000117155","SSX2IP","1",84643706,84690803,47097
"9322","ENSG00000165584","ENSG00000165584","SSX3","X",48346427,48356707,10280
"9323","ENSG00000100380","ENSG00000100380","ST13","22",40824535,40856639,32104
"9324","ENSG00000149418","ENSG00000149418","ST14","11",130159782,130210362,50580
"9325","ENSG00000147488","ENSG00000147488","ST18","8",52110838,52460959,350121
"9326","ENSG00000180953","ENSG00000180953","ST20","15",79898840,79923702,24862
"9327","ENSG00000008513","ENSG00000008513","ST3GAL1","8",133454848,133571926,117078
"9328","ENSG00000157350","ENSG00000157350","ST3GAL2","16",70375977,70439237,63260
"9329","ENSG00000110080","ENSG00000110080","ST3GAL4","11",126355640,126440344,84704
"9330","ENSG00000115525","ENSG00000115525","ST3GAL5","2",85837120,85905199,68079
"9331","ENSG00000064225","ENSG00000064225","ST3GAL6","3",98732236,98821201,88965
"9332","ENSG00000073849","ENSG00000073849","ST6GAL1","3",186930325,187078553,148228
"9333","ENSG00000070731","ENSG00000070731","ST6GALNAC2","17",76565377,76586956,21579
"9334","ENSG00000136840","ENSG00000136840","ST6GALNAC4","9",127907886,127917041,9155
"9335","ENSG00000117069","ENSG00000117069","ST6GALNAC5","1",76867480,77067546,200066
"9336","ENSG00000004866","ENSG00000004866","ST7","7",116953238,117230176,276938
"9337","ENSG00000007341","ENSG00000007341","ST7L","1",112523514,112620825,97311
"9338","ENSG00000111728","ENSG00000111728","ST8SIA1","12",22063773,22437041,373268
"9339","ENSG00000177511","ENSG00000177511","ST8SIA3","18",57352557,57371731,19174
"9340","ENSG00000113532","ENSG00000113532","ST8SIA4","5",100806933,100903282,96349
"9341","ENSG00000101638","ENSG00000101638","ST8SIA5","18",46667821,46759257,91436
"9342","ENSG00000010327","ENSG00000010327","STAB1","3",52495338,52524495,29157
"9343","ENSG00000136011","ENSG00000136011","STAB2","12",103587273,103766719,179446
"9344","ENSG00000144681","ENSG00000144681","STAC","3",36380503,36548007,167504
"9345","ENSG00000118007","ENSG00000118007","STAG1","3",136336236,136752403,416167
"9346","ENSG00000101972","ENSG00000101972","STAG2","X",123960212,124422664,462452
"9347","ENSG00000066923","ENSG00000066923","STAG3","7",100177563,100214387,36824
"9348","ENSG00000136738","ENSG00000136738","STAM","10",17644151,17716824,72673
"9349","ENSG00000115145","ENSG00000115145","STAM2","2",152116801,152175763,58962
"9350","ENSG00000124356","ENSG00000124356","STAMBP","2",73828916,73873659,44743
"9351","ENSG00000035720","ENSG00000035720","STAP1","4",67558727,67607337,48610
"9352","ENSG00000178078","ENSG00000178078","STAP2","19",4324043,4342786,18743
"9353","ENSG00000147465","ENSG00000147465","STAR","8",38142700,38150992,8292
"9354","ENSG00000133121","ENSG00000133121","STARD13","13",33103137,33350630,247493
"9355","ENSG00000131748","ENSG00000131748","STARD3","17",39637090,39664201,27111
"9356","ENSG00000172345","ENSG00000172345","STARD5","15",81309053,81324183,15130
"9357","ENSG00000084090","ENSG00000084090","STARD7","2",96184859,96208827,23968
"9358","ENSG00000130052","ENSG00000130052","STARD8","X",68647666,68725842,78176
"9359","ENSG00000115415","ENSG00000115415","STAT1","2",190908460,191020960,112500
"9360","ENSG00000170581","ENSG00000170581","STAT2","12",56341597,56360203,18606
"9361","ENSG00000168610","ENSG00000168610","STAT3","17",42313324,42388568,75244
"9362","ENSG00000138378","ENSG00000138378","STAT4","2",191029576,191178435,148859
"9363","ENSG00000126561","ENSG00000126561","STAT5A","17",42287547,42311943,24396
"9364","ENSG00000173757","ENSG00000173757","STAT5B","17",42199176,42288633,89457
"9365","ENSG00000166888","ENSG00000166888","STAT6","12",57095408,57132139,36731
"9366","ENSG00000124214","ENSG00000124214","STAU1","20",49113339,49188367,75028
"9367","ENSG00000040341","ENSG00000040341","STAU2","8",73420369,73747708,327339
"9368","ENSG00000118804","ENSG00000118804","STBD1","4",76306733,76311130,4397
"9369","ENSG00000159167","ENSG00000159167","STC1","8",23841929,23854806,12877
"9370","ENSG00000113739","ENSG00000113739","STC2","5",173314723,173328447,13724
"9371","ENSG00000164647","ENSG00000164647","STEAP1","7",90154456,90164829,10373
"9372","ENSG00000105889","ENSG00000105889","STEAP1B","7",22419444,22727613,308169
"9373","ENSG00000115107","ENSG00000115107","STEAP3","2",119223831,119265652,41821
"9374","ENSG00000127954","ENSG00000127954","STEAP4","7",88270892,88306894,36002
"9375","ENSG00000123473","ENSG00000123473","STIL","1",47250139,47314892,64753
"9376","ENSG00000167323","ENSG00000167323","STIM1","11",3854527,4093210,238683
"9377","ENSG00000168439","ENSG00000168439","STIP1","11",64185272,64204543,19271
"9378","ENSG00000072786","ENSG00000072786","STK10","5",172042079,172188224,146145
"9379","ENSG00000118046","ENSG00000118046","STK11","19",1177558,1228431,50873
"9380","ENSG00000115661","ENSG00000115661","STK16","2",219245455,219250337,4882
"9381","ENSG00000164543","ENSG00000164543","STK17A","7",43582758,43650713,67955
"9382","ENSG00000081320","ENSG00000081320","STK17B","2",196133583,196176503,42920
"9383","ENSG00000236250","ENSG00000236250","STK19","HSCHR6_MHC_SSTO_CTG1",3272364,3282635,10271
"9384","ENSG00000102572","ENSG00000102572","STK24","13",98445185,98577940,132755
"9385","ENSG00000115694","ENSG00000115694","STK25","2",241492670,241509730,17060
"9386","ENSG00000134602","ENSG00000134602","STK26","X",132023302,132075943,52641
"9387","ENSG00000104375","ENSG00000104375","STK3","8",98371228,98942827,571599
"9388","ENSG00000152953","ENSG00000152953","STK32B","4",5051480,5500994,449514
"9389","ENSG00000112079","ENSG00000112079","STK38","6",36493892,36547479,53587
"9390","ENSG00000211455","ENSG00000211455","STK38L","12",27243968,27325959,81991
"9391","ENSG00000198648","ENSG00000198648","STK39","2",167954020,168247595,293575
"9392","ENSG00000101109","ENSG00000101109","STK4","20",44966494,45080021,113527
"9393","ENSG00000117632","ENSG00000117632","STMN1","1",25884181,25906991,22810
"9394","ENSG00000104435","ENSG00000104435","STMN2","8",79611117,79666158,55041
"9395","ENSG00000197457","ENSG00000197457","STMN3","20",63639705,63657682,17977
"9396","ENSG00000015592","ENSG00000015592","STMN4","8",27235308,27258420,23112
"9397","ENSG00000148175","ENSG00000148175","STOM","9",121338987,121370304,31317
"9398","ENSG00000067221","ENSG00000067221","STOML1","15",73978926,73994622,15696
"9399","ENSG00000165283","ENSG00000165283","STOML2","9",35099776,35103195,3419
"9400","ENSG00000243244","ENSG00000243244","STON1","2",48529383,48598513,69130
"9401","ENSG00000068781","ENSG00000068781","STON1-GTF2A1L","2",48529925,48776517,246592
"9402","ENSG00000137868","ENSG00000137868","STRA6","15",74179466,74212267,32801
"9403","ENSG00000266173","ENSG00000266173","STRADA","17",63682336,63741986,59650
"9404","ENSG00000023734","ENSG00000023734","STRAP","12",15882387,15903478,21091
"9405","ENSG00000165209","ENSG00000165209","STRBP","9",123109500,123268586,159086
"9406","ENSG00000115808","ENSG00000115808","STRN","2",36837698,36966536,128838
"9407","ENSG00000196792","ENSG00000196792","STRN3","14",30893799,31026401,132602
"9408","ENSG00000090372","ENSG00000090372","STRN4","19",46719511,46746994,27483
"9409","ENSG00000101846","ENSG00000101846","STS","X",7147237,7804358,657121
"9410","ENSG00000134910","ENSG00000134910","STT3A","11",125591712,125625215,33503
"9411","ENSG00000103266","ENSG00000103266","STUB1","16",680224,682870,2646
"9412","ENSG00000203685","ENSG00000203685","STUM","1",226548764,226609230,60466
"9413","ENSG00000104915","ENSG00000104915","STX10","19",13144058,13150383,6325
"9414","ENSG00000117758","ENSG00000117758","STX12","1",27773219,27824443,51224
"9415","ENSG00000124222","ENSG00000124222","STX16","20",58651272,58679526,28254
"9416","ENSG00000136874","ENSG00000136874","STX17","9",99906654,99974534,67880
"9417","ENSG00000168818","ENSG00000168818","STX18","4",4415742,4542346,126604
"9418","ENSG00000106089","ENSG00000106089","STX1A","7",73699206,73719672,20466
"9419","ENSG00000111450","ENSG00000111450","STX2","12",130789600,130839254,49654
"9420","ENSG00000166900","ENSG00000166900","STX3","11",59713456,59805882,92426
"9421","ENSG00000103496","ENSG00000103496","STX4","16",31032889,31042975,10086
"9422","ENSG00000162236","ENSG00000162236","STX5","11",62806860,62832051,25191
"9423","ENSG00000135823","ENSG00000135823","STX6","1",180972712,181023121,50409
"9424","ENSG00000079950","ENSG00000079950","STX7","6",132445867,132513198,67331
"9425","ENSG00000170310","ENSG00000170310","STX8","17",9250471,9576591,326120
"9426","ENSG00000136854","ENSG00000136854","STXBP1","9",127579370,127696027,116657
"9427","ENSG00000076944","ENSG00000076944","STXBP2","19",7636772,7647873,11101
"9428","ENSG00000116266","ENSG00000116266","STXBP3","1",108746674,108809523,62849
"9429","ENSG00000168952","ENSG00000168952","STXBP6","14",24809454,25050147,240693
"9430","ENSG00000060140","ENSG00000060140","STYK1","12",10618923,10674318,55395
"9431","ENSG00000127952","ENSG00000127952","STYXL1","7",75996338,76048004,51666
"9432","ENSG00000113387","ENSG00000113387","SUB1","5",32531633,32604079,72446
"9433","ENSG00000136143","ENSG00000136143","SUCLA2","13",47745736,48037968,292232
"9434","ENSG00000163541","ENSG00000163541","SUCLG1","2",84423528,84460045,36517
"9435","ENSG00000172340","ENSG00000172340","SUCLG2","3",67360460,67654612,294152
"9436","ENSG00000094975","ENSG00000094975","SUCO","1",172532349,172611833,79484
"9437","ENSG00000175600","ENSG00000175600","SUGCT","7",40135005,40860763,725758
"9438","ENSG00000105705","ENSG00000105705","SUGP1","19",19276018,19320509,44491
"9439","ENSG00000064607","ENSG00000064607","SUGP2","19",18990888,19034023,43135
"9440","ENSG00000137573","ENSG00000137573","SULF1","8",69466624,69660915,194291
"9441","ENSG00000196502","ENSG00000196502","SULT1A1","16",28605196,28610044,4848
"9442","ENSG00000197165","ENSG00000197165","SULT1A2","16",28591943,28597050,5107
"9443","ENSG00000261052","ENSG00000261052","SULT1A3","16",30199228,30204310,5082
"9444","ENSG00000213648","ENSG00000213648","SULT1A4","16",29459913,29464966,5053
"9445","ENSG00000173597","ENSG00000173597","SULT1B1","4",69721167,69787961,66794
"9446","ENSG00000198203","ENSG00000198203","SULT1C2","2",108288639,108309915,21276
"9447","ENSG00000198075","ENSG00000198075","SULT1C4","2",108377911,108388989,11078
"9448","ENSG00000109193","ENSG00000109193","SULT1E1","4",69841212,69860145,18933
"9449","ENSG00000105398","ENSG00000105398","SULT2A1","19",47870467,47886315,15848
"9450","ENSG00000088002","ENSG00000088002","SULT2B1","19",48552172,48599425,47253
"9451","ENSG00000130540","ENSG00000130540","SULT4A1","22",43824509,43862513,38004
"9452","ENSG00000116030","ENSG00000116030","SUMO1","2",202206182,202238599,32417
"9453","ENSG00000188612","ENSG00000188612","SUMO2","17",75165586,75182959,17373
"9454","ENSG00000184900","ENSG00000184900","SUMO3","21",44805617,44818779,13162
"9455","ENSG00000164828","ENSG00000164828","SUN1","7",816615,896435,79820
"9456","ENSG00000139531","ENSG00000139531","SUOX","12",55997180,56006641,9461
"9457","ENSG00000092201","ENSG00000092201","SUPT16H","14",21351476,21384019,32543
"9458","ENSG00000102710","ENSG00000102710","SUPT20H","13",37009312,37059713,50401
"9459","ENSG00000196284","ENSG00000196284","SUPT3H","6",44809317,45377953,568636
"9460","ENSG00000213246","ENSG00000213246","SUPT4H1","17",58345175,58353093,7918
"9461","ENSG00000196235","ENSG00000196235","SUPT5H","19",39436156,39476670,40514
"9462","ENSG00000109111","ENSG00000109111","SUPT6H","17",28662198,28702679,40481
"9463","ENSG00000119760","ENSG00000119760","SUPT7L","2",27650809,27663840,13031
"9464","ENSG00000156502","ENSG00000156502","SUPV3L1","10",69180234,69209099,28865
"9465","ENSG00000280627","ENSG00000280627","SURF1","HG2030_PATCH",177852,182770,4918
"9466","ENSG00000148291","ENSG00000148291","SURF2","9",133356550,133361158,4608
"9467","ENSG00000143502","ENSG00000143502","SUSD4","1",223220819,223364233,143414
"9468","ENSG00000173705","ENSG00000173705","SUSD5","3",33150043,33218810,68767
"9469","ENSG00000100647","ENSG00000100647","SUSD6","14",69611596,69715144,103548
"9470","ENSG00000101945","ENSG00000101945","SUV39H1","X",48695554,48709016,13462
"9471","ENSG00000152455","ENSG00000152455","SUV39H2","10",14878820,14904315,25495
"9472","ENSG00000178691","ENSG00000178691","SUZ12","17",31937007,32001038,64031
"9473","ENSG00000159164","ENSG00000159164","SV2A","1",149903318,149917844,14526
"9474","ENSG00000185518","ENSG00000185518","SV2B","15",91099950,91302565,202615
"9475","ENSG00000122012","ENSG00000122012","SV2C","5",76083383,76353939,270556
"9476","ENSG00000165124","ENSG00000165124","SVEP1","9",110365248,110579880,214632
"9477","ENSG00000197321","ENSG00000197321","SVIL","10",29457338,29736959,279621
"9478","ENSG00000133789","ENSG00000133789","SWAP70","11",9664077,9752993,88916
"9479","ENSG00000147642","ENSG00000147642","SYBU","8",109573978,109691791,117813
"9480","ENSG00000198765","ENSG00000198765","SYCP1","1",114854863,114995370,140507
"9481","ENSG00000196074","ENSG00000196074","SYCP2","20",59863564,59933655,70091
"9482","ENSG00000105137","ENSG00000105137","SYDE1","19",15107401,15114985,7584
"9483","ENSG00000117614","ENSG00000117614","SYF2","1",25222276,25232502,10226
"9484","ENSG00000165025","ENSG00000165025","SYK","9",90801787,90898549,96762
"9485","ENSG00000125755","ENSG00000125755","SYMPK","19",45815410,45863225,47815
"9486","ENSG00000008056","ENSG00000008056","SYN1","X",47571901,47619857,47956
"9487","ENSG00000157152","ENSG00000157152","SYN2","3",12004388,12192032,187644
"9488","ENSG00000185666","ENSG00000185666","SYN3","22",32507820,33058381,550561
"9489","ENSG00000162520","ENSG00000162520","SYNC","1",32679906,32703596,23690
"9490","ENSG00000135316","ENSG00000135316","SYNCRIP","6",85607779,85644063,36284
"9491","ENSG00000101463","ENSG00000101463","SYNDIG1","20",24469629,24666616,196987
"9492","ENSG00000131018","ENSG00000131018","SYNE1","6",152121687,152637801,516114
"9493","ENSG00000054654","ENSG00000054654","SYNE2","14",63761899,64226433,464534
"9494","ENSG00000100321","ENSG00000100321","SYNGR1","22",39349925,39385575,35650
"9495","ENSG00000108639","ENSG00000108639","SYNGR2","17",78168581,78173527,4946
"9496","ENSG00000127561","ENSG00000127561","SYNGR3","16",1989660,1994275,4615
"9497","ENSG00000105467","ENSG00000105467","SYNGR4","19",48364367,48376377,12010
"9498","ENSG00000159082","ENSG00000159082","SYNJ1","21",32628759,32728040,99281
"9499","ENSG00000078269","ENSG00000078269","SYNJ2","6",157981863,158099176,117313
"9500","ENSG00000213463","ENSG00000213463","SYNJ2BP","14",70366499,70417090,50591
"9501","ENSG00000182253","ENSG00000182253","SYNM","15",99098217,99135593,37376
"9502","ENSG00000171992","ENSG00000171992","SYNPO","5",150601080,150659207,58127
"9503","ENSG00000166317","ENSG00000166317","SYNPO2L","10",73644881,73663803,18922
"9504","ENSG00000275066","ENSG00000275066","SYNRG","17",37514807,37609472,94665
"9505","ENSG00000102003","ENSG00000102003","SYP","X",49187815,49200218,12403
"9506","ENSG00000008282","ENSG00000008282","SYPL1","7",106090505,106112589,22084
"9507","ENSG00000067715","ENSG00000067715","SYT1","12",78863993,79452008,588015
"9508","ENSG00000132718","ENSG00000132718","SYT11","1",155859567,155885199,25632
"9509","ENSG00000173227","ENSG00000173227","SYT12","11",67006778,67050863,44085
"9510","ENSG00000019505","ENSG00000019505","SYT13","11",45240302,45286341,46039
"9511","ENSG00000103528","ENSG00000103528","SYT17","16",19167971,19268332,100361
"9512","ENSG00000143858","ENSG00000143858","SYT2","1",202590596,202710454,119858
"9513","ENSG00000129990","ENSG00000129990","SYT5","19",55171196,55180289,9093
"9514","ENSG00000137501","ENSG00000137501","SYTL2","11",85694224,85811159,116935
"9515","ENSG00000055070","ENSG00000055070","SZRD1","1",16352575,16398145,45570
"9516","ENSG00000198198","ENSG00000198198","SZT2","1",43389882,43454247,64365
"9517","ENSG00000100324","ENSG00000100324","TAB1","22",39399778,39437060,37282
"9518","ENSG00000055208","ENSG00000055208","TAB2","6",149218641,149411613,192972
"9519","ENSG00000006128","ENSG00000006128","TAC1","7",97732084,97740472,8388
"9520","ENSG00000166863","ENSG00000166863","TAC3","12",57010000,57028883,18883
"9521","ENSG00000147526","ENSG00000147526","TACC1","8",38728186,38853028,124842
"9522","ENSG00000138162","ENSG00000138162","TACC2","10",121989163,122254545,265382
"9523","ENSG00000013810","ENSG00000013810","TACC3","4",1712858,1745171,32313
"9524","ENSG00000136463","ENSG00000136463","TACO1","17",63600882,63608365,7483
"9525","ENSG00000115353","ENSG00000115353","TACR1","2",75046463,75199520,153057
"9526","ENSG00000075073","ENSG00000075073","TACR2","10",69403903,69416918,13015
"9527","ENSG00000169836","ENSG00000169836","TACR3","4",103586031,103719985,133954
"9528","ENSG00000184292","ENSG00000184292","TACSTD2","1",58575433,58577252,1819
"9529","ENSG00000277104","ENSG00000277104","TADA2A","HSCHR17_7_CTG4",1646030,1718900,72870
"9530","ENSG00000171148","ENSG00000171148","TADA3","3",9779967,9793011,13044
"9531","ENSG00000147133","ENSG00000147133","TAF1","X",71366136,71532374,166238
"9532","ENSG00000166337","ENSG00000166337","TAF10","11",6606294,6612539,6245
"9533","ENSG00000064995","ENSG00000064995","TAF11","6",34877462,34889192,11730
"9534","ENSG00000120656","ENSG00000120656","TAF12","1",28587829,28648291,60462
"9535","ENSG00000197780","ENSG00000197780","TAF13","1",109062496,109076012,13516
"9536","ENSG00000276833","ENSG00000276833","TAF15","HSCHR17_7_CTG4",43987,99147,55160
"9537","ENSG00000143498","ENSG00000143498","TAF1A","1",222557902,222589933,32031
"9538","ENSG00000115750","ENSG00000115750","TAF1B","2",9843443,9934416,90973
"9539","ENSG00000103168","ENSG00000103168","TAF1C","16",84177847,84187070,9223
"9540","ENSG00000166012","ENSG00000166012","TAF1D","11",93729948,93784391,54443
"9541","ENSG00000064313","ENSG00000064313","TAF2","8",119730774,119832863,102089
"9542","ENSG00000280529","ENSG00000280529","TAF4","HSCHR20_1_CTG2",64040,118774,54734
"9543","ENSG00000141384","ENSG00000141384","TAF4B","18",26226445,26391685,165240
"9544","ENSG00000148835","ENSG00000148835","TAF5","10",103367966,103389065,21099
"9545","ENSG00000135801","ENSG00000135801","TAF5L","1",229593134,229626122,32988
"9546","ENSG00000106290","ENSG00000106290","TAF6","7",100106876,100119841,12965
"9547","ENSG00000162227","ENSG00000162227","TAF6L","11",62771357,62787342,15985
"9548","ENSG00000178913","ENSG00000178913","TAF7","5",141259884,141320784,60900
"9549","ENSG00000276463","ENSG00000276463","TAF9","HSCHR5_2_CTG1_1",147938,153209,5271
"9550","ENSG00000187325","ENSG00000187325","TAF9B","X",78129748,78139650,9902
"9551","ENSG00000149591","ENSG00000149591","TAGLN","11",117199370,117207464,8094
"9552","ENSG00000158710","ENSG00000158710","TAGLN2","1",159918107,159925507,7400
"9553","ENSG00000144834","ENSG00000144834","TAGLN3","3",111998739,112013887,15148
"9554","ENSG00000162367","ENSG00000162367","TAL1","1",47216290,47232225,15935
"9555","ENSG00000177156","ENSG00000177156","TALDO1","11",747415,765012,17597
"9556","ENSG00000170921","ENSG00000170921","TANC2","17",62966235,63427703,461468
"9557","ENSG00000136560","ENSG00000136560","TANK","2",161136908,161236230,99322
"9558","ENSG00000160551","ENSG00000160551","TAOK1","17",29390363,29551903,161540
"9559","ENSG00000149930","ENSG00000149930","TAOK2","16",29973868,29992261,18393
"9560","ENSG00000135090","ENSG00000135090","TAOK3","12",118149801,118372907,223106
"9561","ENSG00000232367","ENSG00000232367","TAP1","HSCHR6_MHC_COX_CTG1",4257408,4266177,8769
"9562","ENSG00000237599","ENSG00000237599","TAP2","HSCHR6_MHC_MCF_CTG1",4120921,4137847,16926
"9563","ENSG00000236490","ENSG00000236490","TAPBP","HSCHR6_MHC_DBB_CTG1",4543212,4557902,14690
"9564","ENSG00000139192","ENSG00000139192","TAPBPL","12",6451690,6466517,14827
"9565","ENSG00000169762","ENSG00000169762","TAPT1","4",16160505,16227410,66905
"9566","ENSG00000059588","ENSG00000059588","TARBP1","1",234391313,234479179,87866
"9567","ENSG00000139546","ENSG00000139546","TARBP2","12",53500921,53506431,5510
"9568","ENSG00000120948","ENSG00000120948","TARDBP","1",11012344,11030528,18184
"9569","ENSG00000143374","ENSG00000143374","TARS2","1",150487414,150507602,20188
"9570","ENSG00000277254","ENSG00000277254","TAS2R13","HSCHR12_3_CTG2",106632,108268,1636
"9571","ENSG00000276541","ENSG00000276541","TAS2R14","HSCHR12_3_CTG2",136111,366513,230402
"9572","ENSG00000127362","ENSG00000127362","TAS2R3","7",141764097,141765197,1100
"9573","ENSG00000127364","ENSG00000127364","TAS2R4","7",141776674,141781691,5017
"9574","ENSG00000089123","ENSG00000089123","TASP1","20",13389392,13638932,249540
"9575","ENSG00000198650","ENSG00000198650","TAT","16",71565660,71577092,11432
"9576","ENSG00000157014","ENSG00000157014","TATDN2","3",10248023,10281218,33195
"9577","ENSG00000106052","ENSG00000106052","TAX1BP1","7",27739331,27844564,105233
"9578","ENSG00000213977","ENSG00000213977","TAX1BP3","17",3662895,3668679,5784
"9579","ENSG00000065882","ENSG00000065882","TBC1D1","4",37891084,38139175,248091
"9580","ENSG00000169221","ENSG00000169221","TBC1D10B","16",30357102,30370494,13392
"9581","ENSG00000108239","ENSG00000108239","TBC1D12","10",94402541,94536332,133791
"9582","ENSG00000107021","ENSG00000107021","TBC1D13","9",128787253,128810430,23177
"9583","ENSG00000121749","ENSG00000121749","TBC1D15","12",71839707,71927248,87541
"9584","ENSG00000167291","ENSG00000167291","TBC1D16","17",79932343,80035872,103529
"9585","ENSG00000104946","ENSG00000104946","TBC1D17","19",49877666,49888750,11084
"9586","ENSG00000109680","ENSG00000109680","TBC1D19","4",26576437,26756223,179786
"9587","ENSG00000095383","ENSG00000095383","TBC1D2","9",98199011,98255649,56638
"9588","ENSG00000054611","ENSG00000054611","TBC1D22A","22",46762617,47175699,413082
"9589","ENSG00000065491","ENSG00000065491","TBC1D22B","6",37257772,37332970,75198
"9590","ENSG00000274611","ENSG00000274611","TBC1D3","17",38181659,38192555,10896
"9591","ENSG00000156787","ENSG00000156787","TBC1D31","8",123041968,123152153,110185
"9592","ENSG00000274808","ENSG00000274808","TBC1D3B","17",36165683,36176636,10953
"9593","ENSG00000278299","ENSG00000278299","TBC1D3C","17",38057693,38068634,10941
"9594","ENSG00000136111","ENSG00000136111","TBC1D4","13",75283503,75482169,198666
"9595","ENSG00000131374","ENSG00000131374","TBC1D5","3",17157162,18444817,1287655
"9596","ENSG00000133138","ENSG00000133138","TBC1D8B","X",106802673,106876150,73477
"9597","ENSG00000109436","ENSG00000109436","TBC1D9","4",140620782,140756385,135603
"9598","ENSG00000197226","ENSG00000197226","TBC1D9B","5",179862066,179907897,45831
"9599","ENSG00000171530","ENSG00000171530","TBCA","5",77691166,77868780,177614
"9600","ENSG00000105254","ENSG00000105254","TBCB","19",36114289,36125947,11658
"9601","ENSG00000124659","ENSG00000124659","TBCC","6",42744498,42746103,1605
"9602","ENSG00000113838","ENSG00000113838","TBCCD1","3",186546067,186570543,24476
"9603","ENSG00000278759","ENSG00000278759","TBCD","HSCHR17_1_CTG9",155503,177989,22486
"9604","ENSG00000183735","ENSG00000183735","TBK1","12",64452090,64502114,50024
"9605","ENSG00000198933","ENSG00000198933","TBKBP1","17",47694161,47712052,17891
"9606","ENSG00000101849","ENSG00000101849","TBL1X","X",9463320,9741037,277717
"9607","ENSG00000177565","ENSG00000177565","TBL1XR1","3",177019340,177228000,208660
"9608","ENSG00000106638","ENSG00000106638","TBL2","7",73567537,73578791,11254
"9609","ENSG00000183751","ENSG00000183751","TBL3","16",1972053,1982929,10876
"9610","ENSG00000112592","ENSG00000112592","TBP","6",170554302,170572870,18568
"9611","ENSG00000028839","ENSG00000028839","TBPL1","6",133952170,133990432,38262
"9612","ENSG00000136535","ENSG00000136535","TBR1","2",161416297,161425870,9573
"9613","ENSG00000136270","ENSG00000136270","TBRG4","7",45100100,45112047,11947
"9614","ENSG00000184058","ENSG00000184058","TBX1","22",19756703,19783593,26890
"9615","ENSG00000143178","ENSG00000143178","TBX19","1",168280877,168314426,33549
"9616","ENSG00000121068","ENSG00000121068","TBX2","17",61399843,61409466,9623
"9617","ENSG00000073861","ENSG00000073861","TBX21","17",47733236,47746122,12886
"9618","ENSG00000135111","ENSG00000135111","TBX3","12",114670255,114684175,13920
"9619","ENSG00000089225","ENSG00000089225","TBX5","12",114353911,114408442,54531
"9620","ENSG00000006638","ENSG00000006638","TBXA2R","19",3594507,3606875,12368
"9621","ENSG00000059377","ENSG00000059377","TBXAS1","7",139777051,140020325,243274
"9622","ENSG00000198420","ENSG00000198420","TCAF1","7",143851375,143902198,50823
"9623","ENSG00000173991","ENSG00000173991","TCAP","17",39665349,39666554,1205
"9624","ENSG00000187735","ENSG00000187735","TCEA1","8",53966552,54022448,55896
"9625","ENSG00000171703","ENSG00000171703","TCEA2","20",64049836,64072347,22511
"9626","ENSG00000172465","ENSG00000172465","TCEAL1","X",103628704,103630953,2249
"9627","ENSG00000133142","ENSG00000133142","TCEAL4","X",103576231,103587729,11498
"9628","ENSG00000185222","ENSG00000185222","TCEAL9","X",103356489,103358462,1973
"9629","ENSG00000116205","ENSG00000116205","TCEANC2","1",54053584,54112519,58935
"9630","ENSG00000113649","ENSG00000113649","TCERG1","5",146447311,146511961,64650
"9631","ENSG00000140262","ENSG00000140262","TCF12","15",56918623,57299281,380658
"9632","ENSG00000125878","ENSG00000125878","TCF15","20",604257,610309,6052
"9633","ENSG00000276461","ENSG00000276461","TCF20","HSCHR22_3_CTG1",82358,137787,55429
"9634","ENSG00000118526","ENSG00000118526","TCF21","6",133889113,133895553,6440
"9635","ENSG00000141002","ENSG00000141002","TCF25","16",89873570,89913627,40057
"9636","ENSG00000071564","ENSG00000071564","TCF3","19",1609291,1652615,43324
"9637","ENSG00000196628","ENSG00000196628","TCF4","18",55222185,55664787,442602
"9638","ENSG00000081059","ENSG00000081059","TCF7","5",134114681,134151865,37184
"9639","ENSG00000152284","ENSG00000152284","TCF7L1","2",85133392,85310387,176995
"9640","ENSG00000148737","ENSG00000148737","TCF7L2","10",112950247,113167678,217431
"9641","ENSG00000101190","ENSG00000101190","TCFL5","20",62841005,62861822,20817
"9642","ENSG00000159450","ENSG00000159450","TCHH","1",152106317,152115444,9127
"9643","ENSG00000110719","ENSG00000110719","TCIRG1","11",68039025,68050895,11870
"9644","ENSG00000100721","ENSG00000100721","TCL1A","14",95709947,95714196,4249
"9645","ENSG00000213231","ENSG00000213231","TCL1B","14",95686426,95692628,6202
"9646","ENSG00000134827","ENSG00000134827","TCN1","11",59852800,59866489,13689
"9647","ENSG00000185339","ENSG00000185339","TCN2","22",30607003,30627271,20268
"9648","ENSG00000070814","ENSG00000070814","TCOF1","5",150357629,150400308,42679
"9649","ENSG00000120438","ENSG00000120438","TCP1","6",159778498,159789703,11205
"9650","ENSG00000242220","ENSG00000242220","TCP10L","21",32497967,32587373,89406
"9651","ENSG00000124678","ENSG00000124678","TCP11","6",35118071,35148610,30539
"9652","ENSG00000176148","ENSG00000176148","TCP11L1","11",33039417,33105943,66526
"9653","ENSG00000145022","ENSG00000145022","TCTA","3",49412212,49416476,4264
"9654","ENSG00000168778","ENSG00000168778","TCTN2","12",123671110,123708399,37289
"9655","ENSG00000119977","ENSG00000119977","TCTN3","10",95659823,95694143,34320
"9656","ENSG00000139372","ENSG00000139372","TDG","12",103965822,103988874,23052
"9657","ENSG00000241186","ENSG00000241186","CRIPTO","3",46574534,46582457,7923
"9658","ENSG00000225366","ENSG00000225366","CRIPTO3","X",110520896,110523021,2125
"9659","ENSG00000262635","ENSG00000262635","TDO2","HSCHR4_1_CTG12",19361,85029,65668
"9660","ENSG00000042088","ENSG00000042088","TDP1","14",89954939,90044764,89825
"9661","ENSG00000111802","ENSG00000111802","TDP2","6",24649979,24666930,16951
"9662","ENSG00000083544","ENSG00000083544","TDRD3","13",60396457,60573878,177421
"9663","ENSG00000196116","ENSG00000196116","TDRD7","9",97412096,97496125,84029
"9664","ENSG00000182134","ENSG00000182134","TDRKH","1",151770107,151791416,21309
"9665","ENSG00000187079","ENSG00000187079","TEAD1","11",12674421,12944737,270316
"9666","ENSG00000007866","ENSG00000007866","TEAD3","6",35473597,35497079,23482
"9667","ENSG00000197905","ENSG00000197905","TEAD4","12",2959330,3040676,81346
"9668","ENSG00000135605","ENSG00000135605","TEC","4",48135783,48269838,134055
"9669","ENSG00000196663","ENSG00000196663","TECPR2","14",102362941,102502477,139536
"9670","ENSG00000099797","ENSG00000099797","TECR","19",14517085,14565980,48895
"9671","ENSG00000109927","ENSG00000109927","TECTA","11",121101243,121191490,90247
"9672","ENSG00000167074","ENSG00000167074","TEF","22",41367333,41399326,31993
"9673","ENSG00000172171","ENSG00000172171","TEFM","17",30897336,30906238,8902
"9674","ENSG00000120156","ENSG00000120156","TEK","9",27109141,27230174,121033
"9675","ENSG00000092850","ENSG00000092850","TEKT2","1",36084094,36088275,4181
"9676","ENSG00000100726","ENSG00000100726","TELO2","16",1493344,1510457,17113
"9677","ENSG00000009694","ENSG00000009694","TENM1","X",124375903,125204312,828409
"9678","ENSG00000149256","ENSG00000149256","TENM4","11",78652829,79441030,788201
"9679","ENSG00000129566","ENSG00000129566","TEP1","14",20365667,20413501,47834
"9680","ENSG00000147601","ENSG00000147601","TERF1","8",73008856,73048123,39267
"9681","ENSG00000132604","ENSG00000132604","TERF2","16",69355567,69408571,53004
"9682","ENSG00000166848","ENSG00000166848","TERF2IP","16",75647773,75761872,114099
"9683","ENSG00000164362","ENSG00000164362","TERT","5",1253147,1295068,41921
"9684","ENSG00000135269","ENSG00000135269","TES","7",116210506,116258783,48277
"9685","ENSG00000088992","ENSG00000088992","TESC","12",117038923,117099479,60556
"9686","ENSG00000107140","ENSG00000107140","TESK1","9",35605262,35610041,4779
"9687","ENSG00000070759","ENSG00000070759","TESK2","1",45343883,45491163,147280
"9688","ENSG00000132749","ENSG00000132749","TESMIN","11",68707440,68751520,44080
"9689","ENSG00000138336","ENSG00000138336","TET1","10",68560337,68694487,134150
"9690","ENSG00000187605","ENSG00000187605","TET3","2",73984910,74108176,123266
"9691","ENSG00000136891","ENSG00000136891","TEX10","9",100302077,100352942,50865
"9692","ENSG00000150783","ENSG00000150783","TEX12","11",112167372,112172556,5184
"9693","ENSG00000121101","ENSG00000121101","TEX14","17",58556678,58692055,135377
"9694","ENSG00000133863","ENSG00000133863","TEX15","8",30831544,30913008,81464
"9695","ENSG00000136478","ENSG00000136478","TEX2","17",64147227,64263260,116033
"9696","ENSG00000144043","ENSG00000144043","TEX261","2",70968325,70994873,26548
"9697","ENSG00000164081","ENSG00000164081","TEX264","3",51662693,51704323,41630
"9698","ENSG00000151287","ENSG00000151287","TEX30","13",102765888,102773811,7923
"9699","ENSG00000091513","ENSG00000091513","TF","3",133746040,133796641,50601
"9700","ENSG00000108064","ENSG00000108064","TFAM","10",58385345,58399220,13875
"9701","ENSG00000137203","ENSG00000137203","TFAP2A","6",10393186,10419659,26473
"9702","ENSG00000008196","ENSG00000008196","TFAP2B","6",50818723,50847619,28896
"9703","ENSG00000087510","ENSG00000087510","TFAP2C","20",56629306,56639283,9977
"9704","ENSG00000090447","ENSG00000090447","TFAP4","16",4257186,4273075,15889
"9705","ENSG00000029639","ENSG00000029639","TFB1M","6",155256134,155314493,58359
"9706","ENSG00000162851","ENSG00000162851","TFB2M","1",246540561,246566261,25700
"9707","ENSG00000135457","ENSG00000135457","TFCP2","12",51093656,51173135,79479
"9708","ENSG00000115112","ENSG00000115112","TFCP2L1","2",121216587,121285202,68615
"9709","ENSG00000198176","ENSG00000198176","TFDP1","13",113584721,113641473,56752
"9710","ENSG00000114126","ENSG00000114126","TFDP2","3",141944428,142149544,205116
"9711","ENSG00000068323","ENSG00000068323","TFE3","X",49028726,49043410,14684
"9712","ENSG00000112561","ENSG00000112561","TFEB","6",41683978,41736259,52281
"9713","ENSG00000105967","ENSG00000105967","TFEC","7",115935148,116159896,224748
"9714","ENSG00000160182","ENSG00000160182","TFF1","21",42362282,42366535,4253
"9715","ENSG00000160181","ENSG00000160181","TFF2","21",42346357,42350997,4640
"9716","ENSG00000160180","ENSG00000160180","TFF3","21",42311667,42315409,3742
"9717","ENSG00000114354","ENSG00000114354","TFG","3",100709295,100748964,39669
"9718","ENSG00000100109","ENSG00000100109","TFIP11","22",26491225,26512505,21280
"9719","ENSG00000003436","ENSG00000003436","TFPI","2",187464230,187565760,101530
"9720","ENSG00000105825","ENSG00000105825","TFPI2","7",93885396,93890753,5357
"9721","ENSG00000278161","ENSG00000278161","TFPT","HSCHR19LRC_PGF1_CTG3_1",81433,90168,8735
"9722","ENSG00000106327","ENSG00000106327","TFR2","7",100620416,100642779,22363
"9723","ENSG00000072274","ENSG00000072274","TFRC","3",196012511,196082153,69642
"9724","ENSG00000042832","ENSG00000042832","TG","8",132866958,133134903,267945
"9725","ENSG00000088451","ENSG00000088451","TGDS","13",94574054,94596242,22188
"9726","ENSG00000163235","ENSG00000163235","TGFA","2",70447284,70554193,106909
"9727","ENSG00000140682","ENSG00000140682","TGFB1I1","16",31471585,31477960,6375
"9728","ENSG00000092969","ENSG00000092969","TGFB2","1",218345336,218444619,99283
"9729","ENSG00000119699","ENSG00000119699","TGFB3","14",75958097,75983011,24914
"9730","ENSG00000120708","ENSG00000120708","TGFBI","5",136028988,136063818,34830
"9731","ENSG00000106799","ENSG00000106799","TGFBR1","9",99104038,99154192,50154
"9732","ENSG00000163513","ENSG00000163513","TGFBR2","3",30606478,30694249,87771
"9733","ENSG00000069702","ENSG00000069702","TGFBR3","1",91680343,91906335,225992
"9734","ENSG00000135966","ENSG00000135966","TGFBRAP1","2",105264391,105329735,65344
"9735","ENSG00000177426","ENSG00000177426","TGIF1","18",3411608,3459978,48370
"9736","ENSG00000118707","ENSG00000118707","TGIF2","20",36573488,36593950,20462
"9737","ENSG00000092295","ENSG00000092295","TGM1","14",24249114,24264432,15318
"9738","ENSG00000198959","ENSG00000198959","TGM2","20",38127385,38166578,39193
"9739","ENSG00000125780","ENSG00000125780","TGM3","20",2296001,2341079,45078
"9740","ENSG00000281886","ENSG00000281886","TGM4","HG2066_PATCH",399958,440340,40382
"9741","ENSG00000104055","ENSG00000104055","TGM5","15",43232590,43266928,34338
"9742","ENSG00000152291","ENSG00000152291","TGOLN2","2",85318027,85328251,10224
"9743","ENSG00000137574","ENSG00000137574","TGS1","8",55773446,55826445,52999
"9744","ENSG00000115970","ENSG00000115970","THADA","2",43230851,43596038,365187
"9745","ENSG00000131931","ENSG00000131931","THAP1","8",42836674,42843325,6651
"9746","ENSG00000129028","ENSG00000129028","THAP10","15",70881342,70892433,11091
"9747","ENSG00000168286","ENSG00000168286","THAP11","16",67842320,67844195,1875
"9748","ENSG00000137492","ENSG00000137492","THAP12","11",76349898,76381132,31234
"9749","ENSG00000041988","ENSG00000041988","THAP3","1",6624868,6635586,10718
"9750","ENSG00000176946","ENSG00000176946","THAP4","2",241584405,241637158,52753
"9751","ENSG00000184436","ENSG00000184436","THAP7","22",20999104,21002196,3092
"9752","ENSG00000168152","ENSG00000168152","THAP9","4",82900684,82919969,19285
"9753","ENSG00000178726","ENSG00000178726","THBD","20",23045633,23049672,4039
"9754","ENSG00000137801","ENSG00000137801","THBS1","15",39581079,39599466,18387
"9755","ENSG00000186340","ENSG00000186340","THBS2","6",169215780,169254050,38270
"9756","ENSG00000169231","ENSG00000169231","THBS3","1",155195588,155209051,13463
"9757","ENSG00000113296","ENSG00000113296","THBS4","5",79991311,80083287,91976
"9758","ENSG00000130193","ENSG00000130193","THEM6","8",142727223,142736927,9704
"9759","ENSG00000130775","ENSG00000130775","THEMIS2","1",27872543,27886685,14142
"9760","ENSG00000113272","ENSG00000113272","THG1L","5",157731420,157741449,10029
"9761","ENSG00000185875","ENSG00000185875","THNSL1","10",25016612,25026664,10052
"9762","ENSG00000144115","ENSG00000144115","THNSL2","2",88170295,88186636,16341
"9763","ENSG00000079134","ENSG00000079134","THOC1","18",214520,268050,53530
"9764","ENSG00000125676","ENSG00000125676","THOC2","X",123600561,123733056,132495
"9765","ENSG00000100296","ENSG00000100296","THOC5","22",29505879,29555216,49337
"9766","ENSG00000131652","ENSG00000131652","THOC6","16",3024027,3027755,3728
"9767","ENSG00000163634","ENSG00000163634","THOC7","3",63833870,63863868,29998
"9768","ENSG00000172009","ENSG00000172009","THOP1","19",2785503,2815807,30304
"9769","ENSG00000090534","ENSG00000090534","THPO","3",184371935,184381968,10033
"9770","ENSG00000126351","ENSG00000126351","THRA","17",40058290,40093867,35577
"9771","ENSG00000054118","ENSG00000054118","THRAP3","1",36224432,36305357,80925
"9772","ENSG00000151090","ENSG00000151090","THRB","3",24117153,24495756,378603
"9773","ENSG00000136114","ENSG00000136114","THSD1","13",52377167,52416373,39206
"9774","ENSG00000187720","ENSG00000187720","THSD4","15",71096952,71783383,686431
"9775","ENSG00000005108","ENSG00000005108","THSD7A","7",11370365,11832198,461833
"9776","ENSG00000259431","ENSG00000259431","THTPA","14",23555988,23560271,4283
"9777","ENSG00000066654","ENSG00000066654","THUMPD1","16",20702816,20742084,39268
"9778","ENSG00000138050","ENSG00000138050","THUMPD2","2",39736060,39779267,43207
"9779","ENSG00000154096","ENSG00000154096","THY1","11",119415476,119424985,9509
"9780","ENSG00000151500","ENSG00000151500","THYN1","11",134248279,134253370,5091
"9781","ENSG00000116001","ENSG00000116001","TIA1","2",70209444,70248660,39216
"9782","ENSG00000151923","ENSG00000151923","TIAL1","10",119571802,119597029,25227
"9783","ENSG00000156299","ENSG00000156299","TIAM1","21",31118416,31559977,441561
"9784","ENSG00000146426","ENSG00000146426","TIAM2","6",154832697,155257723,425026
"9785","ENSG00000127666","ENSG00000127666","TICAM1","19",4815932,4831712,15780
"9786","ENSG00000066056","ENSG00000066056","TIE1","1",43300982,43323108,22126
"9787","ENSG00000078237","ENSG00000078237","TIGAR","12",4307763,4360028,52265
"9788","ENSG00000164296","ENSG00000164296","TIGD6","5",149993118,150000654,7536
"9789","ENSG00000111602","ENSG00000111602","TIMELESS","12",56416363,56449426,33063
"9790","ENSG00000134809","ENSG00000134809","TIMM10","11",57528464,57530803,2339
"9791","ENSG00000132286","ENSG00000132286","TIMM10B","11",6481501,6484681,3180
"9792","ENSG00000099800","ENSG00000099800","TIMM13","19",2425625,2427586,1961
"9793","ENSG00000134375","ENSG00000134375","TIMM17A","1",201955503,201970664,15161
"9794","ENSG00000126768","ENSG00000126768","TIMM17B","X",48893447,48898143,4696
"9795","ENSG00000278501","ENSG00000278501","TIMM22","HSCHR17_3_CTG2",36364,42918,6554
"9796","ENSG00000265354","ENSG00000265354","TIMM23","10",45972489,46003742,31253
"9797","ENSG00000104980","ENSG00000104980","TIMM44","19",7926718,7943667,16949
"9798","ENSG00000105197","ENSG00000105197","TIMM50","19",39480412,39493785,13373
"9799","ENSG00000126953","ENSG00000126953","TIMM8A","X",101345661,101348742,3081
"9800","ENSG00000150779","ENSG00000150779","TIMM8B","11",112084800,112086798,1998
"9801","ENSG00000100575","ENSG00000100575","TIMM9","14",58408495,58427531,19036
"9802","ENSG00000102265","ENSG00000102265","TIMP1","X",47582408,47586789,4381
"9803","ENSG00000035862","ENSG00000035862","TIMP2","17",78852977,78925387,72410
"9804","ENSG00000100234","ENSG00000100234","TIMP3","22",32801705,32863041,61336
"9805","ENSG00000157150","ENSG00000157150","TIMP4","3",12153068,12158912,5844
"9806","ENSG00000142910","ENSG00000142910","TINAGL1","1",31576485,31587686,11201
"9807","ENSG00000092330","ENSG00000092330","TINF2","14",24238286,24242663,4377
"9808","ENSG00000163659","ENSG00000163659","TIPARP","3",156673235,156706770,33535
"9809","ENSG00000075131","ENSG00000075131","TIPIN","15",66336191,66386746,50555
"9810","ENSG00000143155","ENSG00000143155","TIPRL","1",168178962,168202109,23147
"9811","ENSG00000137221","ENSG00000137221","TJAP1","6",43477523,43506556,29033
"9812","ENSG00000277401","ENSG00000277401","TJP1","HSCHR15_4_CTG8",1984289,2106633,122344
"9813","ENSG00000119139","ENSG00000119139","TJP2","9",69121264,69274615,153351
"9814","ENSG00000105289","ENSG00000105289","TJP3","19",3708362,3750813,42451
"9815","ENSG00000167900","ENSG00000167900","TK1","17",78174091,78187233,13142
"9816","ENSG00000166548","ENSG00000166548","TK2","16",66508003,66552544,44541
"9817","ENSG00000149476","ENSG00000149476","TKFC","11",61333220,61353295,20075
"9818","ENSG00000163931","ENSG00000163931","TKT","3",53224712,53256052,31340
"9819","ENSG00000007350","ENSG00000007350","TKTL1","X",154295795,154330350,34555
"9820","ENSG00000196781","ENSG00000196781","TLE1","9",81583683,81689547,105864
"9821","ENSG00000065717","ENSG00000065717","TLE2","19",2997639,3047635,49996
"9822","ENSG00000140332","ENSG00000140332","TLE3","15",70047790,70098176,50386
"9823","ENSG00000106829","ENSG00000106829","TLE4","9",79571773,79726882,155109
"9824","ENSG00000104953","ENSG00000104953","TLE6","19",2977538,2995179,17641
"9825","ENSG00000198586","ENSG00000198586","TLK1","2",170990823,171231314,240491
"9826","ENSG00000146872","ENSG00000146872","TLK2","17",62458658,62615481,156823
"9827","ENSG00000137076","ENSG00000137076","TLN1","9",35696948,35732195,35247
"9828","ENSG00000171914","ENSG00000171914","TLN2","15",62390526,62844631,454105
"9829","ENSG00000174125","ENSG00000174125","TLR1","4",38790677,38856817,66140
"9830","ENSG00000137462","ENSG00000137462","TLR2","4",153684050,153706260,22210
"9831","ENSG00000164342","ENSG00000164342","TLR3","4",186068911,186088073,19162
"9832","ENSG00000136869","ENSG00000136869","TLR4","9",117704175,117724735,20560
"9833","ENSG00000187554","ENSG00000187554","TLR5","1",223109404,223143292,33888
"9834","ENSG00000196664","ENSG00000196664","TLR7","X",12867072,12890361,23289
"9835","ENSG00000115297","ENSG00000115297","TLX2","2",74513463,74517148,3685
"9836","ENSG00000162604","ENSG00000162604","TM2D1","1",61681046,61725423,44377
"9837","ENSG00000184277","ENSG00000184277","TM2D3","15",101621444,101652391,30947
"9838","ENSG00000169908","ENSG00000169908","TM4SF1","3",149369022,149377692,8670
"9839","ENSG00000168955","ENSG00000168955","TM4SF20","2",227362038,227381995,19957
"9840","ENSG00000169903","ENSG00000169903","TM4SF4","3",149474697,149503394,28697
"9841","ENSG00000142484","ENSG00000142484","TM4SF5","17",4771884,4783213,11329
"9842","ENSG00000136404","ENSG00000136404","TM6SF1","15",83107572,83144854,37282
"9843","ENSG00000149809","ENSG00000149809","TM7SF2","11",65111845,65116384,4539
"9844","ENSG00000064115","ENSG00000064115","TM7SF3","12",26971579,27014434,42855
"9845","ENSG00000100926","ENSG00000100926","TM9SF1","14",24189149,24195687,6538
"9846","ENSG00000125304","ENSG00000125304","TM9SF2","13",99446311,99564048,117737
"9847","ENSG00000077147","ENSG00000077147","TM9SF3","10",96518110,96587452,69342
"9848","ENSG00000101337","ENSG00000101337","TM9SF4","20",32109714,32167258,57544
"9849","ENSG00000198498","ENSG00000198498","TMA16","4",163494442,163520539,26097
"9850","ENSG00000232112","ENSG00000232112","TMA7","3",48440257,48444208,3951
"9851","ENSG00000135926","ENSG00000135926","TMBIM1","2",218274197,218292586,18389
"9852","ENSG00000155957","ENSG00000155957","TMBIM4","12",66135846,66170027,34181
"9853","ENSG00000139644","ENSG00000139644","TMBIM6","12",49707725,49764934,57209
"9854","ENSG00000103534","ENSG00000103534","TMC5","16",19410496,19499113,88617
"9855","ENSG00000141524","ENSG00000141524","TMC6","17",78107397,78132407,25010
"9856","ENSG00000170537","ENSG00000170537","TMC7","16",18983934,19063942,80008
"9857","ENSG00000133069","ENSG00000133069","TMCC2","1",205227946,205285632,57686
"9858","ENSG00000150403","ENSG00000150403","TMCO3","13",113491021,113554590,63569
"9859","ENSG00000113119","ENSG00000113119","TMCO6","5",140639435,140645408,5973
"9860","ENSG00000099203","ENSG00000099203","TMED1","19",10832067,10836318,4251
"9861","ENSG00000170348","ENSG00000170348","TMED10","14",75131469,75176612,45143
"9862","ENSG00000086598","ENSG00000086598","TMED2","12",123584533,123598582,14049
"9863","ENSG00000166557","ENSG00000166557","TMED3","15",79311112,79427432,116320
"9864","ENSG00000117500","ENSG00000117500","TMED5","1",93149742,93180516,30774
"9865","ENSG00000134970","ENSG00000134970","TMED7","5",115613210,115632992,19782
"9866","ENSG00000184840","ENSG00000184840","TMED9","5",177592203,177597242,5039
"9867","ENSG00000241697","ENSG00000241697","TMEFF1","9",100473149,100577636,104487
"9868","ENSG00000166292","ENSG00000166292","TMEM100","17",55719627,55732121,12494
"9869","ENSG00000109066","ENSG00000109066","TMEM104","17",74776499,74839753,63254
"9870","ENSG00000106460","ENSG00000106460","TMEM106B","7",12211270,12243367,32097
"9871","ENSG00000134291","ENSG00000134291","TMEM106C","12",47963569,47968878,5309
"9872","ENSG00000110108","ENSG00000110108","TMEM109","11",60914158,60923443,9285
"9873","ENSG00000178307","ENSG00000178307","TMEM11","17",21197954,21214176,16222
"9874","ENSG00000126062","ENSG00000126062","TMEM115","3",50354750,50359521,4771
"9875","ENSG00000188735","ENSG00000188735","TMEM120B","12",121712752,121783001,70249
"9876","ENSG00000184986","ENSG00000184986","TMEM121","14",105526583,105530198,3615
"9877","ENSG00000152558","ENSG00000152558","TMEM123","11",102396332,102470384,74052
"9878","ENSG00000171204","ENSG00000171204","TMEM126B","11",85628573,85636539,7966
"9879","ENSG00000135956","ENSG00000135956","TMEM127","2",96248514,96266047,17533
"9880","ENSG00000075568","ENSG00000075568","TMEM131","2",97756333,97995948,239615
"9881","ENSG00000006118","ENSG00000006118","TMEM132A","11",60924460,60937159,12699
"9882","ENSG00000172663","ENSG00000172663","TMEM134","11",67461710,67469272,7562
"9883","ENSG00000166575","ENSG00000166575","TMEM135","11",87037844,87328824,290980
"9884","ENSG00000146859","ENSG00000146859","TMEM140","7",135148072,135166215,18143
"9885","ENSG00000161558","ENSG00000161558","TMEM143","19",48332356,48364059,31703
"9886","ENSG00000164124","ENSG00000164124","TMEM144","4",158201604,158255416,53812
"9887","ENSG00000105677","ENSG00000105677","TMEM147","19",35545600,35547526,1926
"9888","ENSG00000096092","ENSG00000096092","TMEM14A","6",52671113,52686588,15475
"9889","ENSG00000137210","ENSG00000137210","TMEM14B","6",10747759,10852753,104994
"9890","ENSG00000178233","ENSG00000178233","TMEM151B","6",44270450,44307506,37056
"9891","ENSG00000121895","ENSG00000121895","TMEM156","4",38966744,39032922,66178
"9892","ENSG00000249992","ENSG00000249992","TMEM158","3",45224466,45226287,1821
"9893","ENSG00000130748","ENSG00000130748","TMEM160","19",47045909,47048624,2715
"9894","ENSG00000064545","ENSG00000064545","TMEM161A","19",19119169,19138513,19344
"9895","ENSG00000157600","ENSG00000157600","TMEM164","X",110002631,110182734,180103
"9896","ENSG00000134851","ENSG00000134851","TMEM165","4",55395957,55453397,57440
"9897","ENSG00000146802","ENSG00000146802","TMEM168","7",112762377,112790423,28046
"9898","ENSG00000002933","ENSG00000002933","TMEM176A","7",150800403,150805118,4715
"9899","ENSG00000106565","ENSG00000106565","TMEM176B","7",150791285,150801360,10075
"9900","ENSG00000144120","ENSG00000144120","TMEM177","2",119679167,119686507,7340
"9901","ENSG00000163444","ENSG00000163444","TMEM183A","1",203007374,203024848,17474
"9902","ENSG00000198792","ENSG00000198792","TMEM184B","22",38219291,38273010,53719
"9903","ENSG00000164168","ENSG00000164168","TMEM184C","4",147617386,147672044,54658
"9904","ENSG00000226479","ENSG00000226479","TMEM185B","2",120217479,120223400,5921
"9905","ENSG00000184857","ENSG00000184857","TMEM186","16",8780384,8797642,17258
"9906","ENSG00000177854","ENSG00000177854","TMEM187","X",153972754,153983194,10440
"9907","ENSG00000139291","ENSG00000139291","TMEM19","12",71686082,71705047,18965
"9908","ENSG00000131634","ENSG00000131634","TMEM204","16",1528688,1555580,26892
"9909","ENSG00000168701","ENSG00000168701","TMEM208","16",67227103,67229278,2175
"9910","ENSG00000146842","ENSG00000146842","TMEM209","7",130164713,130207770,43057
"9911","ENSG00000119777","ENSG00000119777","TMEM214","2",27032910,27041694,8784
"9912","ENSG00000186501","ENSG00000186501","TMEM222","1",27322145,27336400,14255
"9913","ENSG00000089063","ENSG00000089063","TMEM230","20",5068232,5113087,44855
"9914","ENSG00000205084","ENSG00000205084","TMEM231","16",75536741,75556289,19548
"9915","ENSG00000215712","ENSG00000215712","TMEM242","6",157289025,157323601,34576
"9916","ENSG00000135185","ENSG00000135185","TMEM243","7",87196160,87220587,24427
"9917","ENSG00000106609","ENSG00000106609","TMEM248","7",66921225,66958551,37326
"9918","ENSG00000133678","ENSG00000133678","TMEM254","10",80078646,80092557,13911
"9919","ENSG00000125355","ENSG00000125355","TMEM255A","X",120258650,120311556,52906
"9920","ENSG00000134825","ENSG00000134825","TMEM258","11",61768501,61792802,24301
"9921","ENSG00000070269","ENSG00000070269","TMEM260","14",56488354,56650606,162252
"9922","ENSG00000151881","ENSG00000151881","TMEM267","5",43444252,43483893,39641
"9923","ENSG00000112697","ENSG00000112697","TMEM30A","6",75252924,75284948,32024
"9924","ENSG00000182107","ENSG00000182107","TMEM30B","14",61277370,61281761,4391
"9925","ENSG00000109133","ENSG00000109133","TMEM33","4",41935129,41960803,25674
"9926","ENSG00000126950","ENSG00000126950","TMEM35A","X",101078879,101096367,17488
"9927","ENSG00000095209","ENSG00000095209","TMEM38B","9",105694541,105776629,82088
"9928","ENSG00000176142","ENSG00000176142","TMEM39A","3",119428949,119468830,39881
"9929","ENSG00000121775","ENSG00000121775","TMEM39B","1",32072031,32102866,30835
"9930","ENSG00000088726","ENSG00000088726","TMEM40","3",12733528,12769457,35929
"9931","ENSG00000166471","ENSG00000166471","TMEM41B","11",9280654,9314636,33982
"9932","ENSG00000170876","ENSG00000170876","TMEM43","3",14125015,14143680,18665
"9933","ENSG00000181458","ENSG00000181458","TMEM45A","3",100492619,100577444,84825
"9934","ENSG00000147027","ENSG00000147027","TMEM47","X",34627075,34657285,30210
"9935","ENSG00000183726","ENSG00000183726","TMEM50A","1",25338317,25362361,24044
"9936","ENSG00000263160","ENSG00000263160","TMEM50B","HSCHR21_4_CTG1_1",27057,84140,57083
"9937","ENSG00000171729","ENSG00000171729","TMEM51","1",15152532,15220478,67946
"9938","ENSG00000126106","ENSG00000126106","TMEM53","1",44635238,44674481,39243
"9939","ENSG00000116209","ENSG00000116209","TMEM59","1",54026681,54053504,26823
"9940","ENSG00000105696","ENSG00000105696","TMEM59L","19",18607430,18621039,13609
"9941","ENSG00000137842","ENSG00000137842","TMEM62","15",43123279,43185144,61865
"9942","ENSG00000196187","ENSG00000196187","TMEM63A","1",225845536,225882380,36844
"9943","ENSG00000175606","ENSG00000175606","TMEM70","8",73972437,73982783,10346
"9944","ENSG00000125895","ENSG00000125895","TMEM74B","20",1180561,1185415,4854
"9945","ENSG00000103978","ENSG00000103978","TMEM87A","15",42210447,42273534,63087
"9946","ENSG00000137103","ENSG00000137103","TMEM8B","9",35814451,35865518,51067
"9947","ENSG00000177728","ENSG00000177728","TMEM94","17",75441159,75500452,59293
"9948","ENSG00000109084","ENSG00000109084","TMEM97","17",28319200,28328685,9485
"9949","ENSG00000175348","ENSG00000175348","TMEM9B","11",8947202,8965011,17809
"9950","ENSG00000144747","ENSG00000144747","TMF1","3",69019827,69052339,32512
"9951","ENSG00000185973","ENSG00000185973","TMLHE","X",155489011,155719098,230087
"9952","ENSG00000136842","ENSG00000136842","TMOD1","9",97501180,97601743,100563
"9953","ENSG00000128872","ENSG00000128872","TMOD2","15",51751597,51816363,64766
"9954","ENSG00000138594","ENSG00000138594","TMOD3","15",51829628,51947295,117667
"9955","ENSG00000120802","ENSG00000120802","TMPO","12",98515579,98550351,34772
"9956","ENSG00000153802","ENSG00000153802","TMPRSS11D","4",67820876,67884002,63126
"9957","ENSG00000274058","ENSG00000274058","TMPRSS11E","HSCHR4_1_CTG9",141140,191291,50151
"9958","ENSG00000154646","ENSG00000154646","TMPRSS15","21",18269116,18485879,216763
"9959","ENSG00000184012","ENSG00000184012","TMPRSS2","21",41464300,41531116,66816
"9960","ENSG00000160183","ENSG00000160183","TMPRSS3","21",42371887,42396091,24204
"9961","ENSG00000137648","ENSG00000137648","TMPRSS4","11",118077012,118125510,48498
"9962","ENSG00000166682","ENSG00000166682","TMPRSS5","11",113687547,113706373,18826
"9963","ENSG00000187045","ENSG00000187045","TMPRSS6","22",37065436,37109713,44277
"9964","ENSG00000034510","ENSG00000034510","TMSB10","2",84905656,84906671,1015
"9965","ENSG00000158164","ENSG00000158164","TMSB15A","X",102513682,102516739,3057
"9966","ENSG00000158427","ENSG00000158427","TMSB15B","X",103918896,103966712,47816
"9967","ENSG00000205542","ENSG00000205542","TMSB4X","X",12975110,12977227,2117
"9968","ENSG00000154620","ENSG00000154620","TMSB4Y","Y",13703899,13706024,2125
"9969","ENSG00000168591","ENSG00000168591","TMUB2","17",44186970,44191929,4959
"9970","ENSG00000139921","ENSG00000139921","TMX1","14",51240162,51257655,17493
"9971","ENSG00000213593","ENSG00000213593","TMX2","11",57712580,57742987,30407
"9972","ENSG00000125827","ENSG00000125827","TMX4","20",7977346,8019805,42459
"9973","ENSG00000041982","ENSG00000041982","TNC","9",115019575,115118207,98632
"9974","ENSG00000232810","ENSG00000232810","TNF","6",31575565,31578336,2771
"9975","ENSG00000109079","ENSG00000109079","TNFAIP1","17",28335602,28347009,11407
"9976","ENSG00000185215","ENSG00000185215","TNFAIP2","14",103121476,103137439,15963
"9977","ENSG00000118503","ENSG00000118503","TNFAIP3","6",137867214,137883314,16100
"9978","ENSG00000123610","ENSG00000123610","TNFAIP6","2",151357592,151380046,22454
"9979","ENSG00000145779","ENSG00000145779","TNFAIP8","5",119268692,119399688,130996
"9980","ENSG00000185361","ENSG00000185361","TNFAIP8L1","19",4639516,4655568,16052
"9981","ENSG00000120889","ENSG00000120889","TNFRSF10B","8",23020133,23069031,48898
"9982","ENSG00000173535","ENSG00000173535","TNFRSF10C","8",23102921,23117445,14524
"9983","ENSG00000173530","ENSG00000173530","TNFRSF10D","8",23135588,23164027,28439
"9984","ENSG00000164761","ENSG00000164761","TNFRSF11B","8",118923557,118951885,28328
"9985","ENSG00000006327","ENSG00000006327","TNFRSF12A","16",3018445,3022383,3938
"9986","ENSG00000240505","ENSG00000240505","TNFRSF13B","17",16929816,16972118,42302
"9987","ENSG00000273936","ENSG00000273936","TNFRSF14","HSCHR1_1_CTG3",106829,116812,9983
"9988","ENSG00000048462","ENSG00000048462","TNFRSF17","16",11965210,11968068,2858
"9989","ENSG00000067182","ENSG00000067182","TNFRSF1A","12",6328757,6342114,13357
"9990","ENSG00000028137","ENSG00000028137","TNFRSF1B","1",12166991,12209228,42237
"9991","ENSG00000146072","ENSG00000146072","TNFRSF21","6",47231532,47309905,78373
"9992","ENSG00000215788","ENSG00000215788","TNFRSF25","1",6460786,6466175,5389
"9993","ENSG00000243509","ENSG00000243509","TNFRSF6B","20",63696652,63698684,2032
"9994","ENSG00000120949","ENSG00000120949","TNFRSF8","1",12063303,12144207,80904
"9995","ENSG00000049249","ENSG00000049249","TNFRSF9","1",7915871,7943165,27294
"9996","ENSG00000121858","ENSG00000121858","TNFSF10","3",172505508,172523475,17967
"9997","ENSG00000120659","ENSG00000120659","TNFSF11","13",42562736,42608013,45277
"9998","ENSG00000239697","ENSG00000239697","TNFSF12","17",7548508,7557890,9382
"9999","ENSG00000248871","ENSG00000248871","TNFSF12-TNFSF13","17",7549099,7561601,12502
"10000","ENSG00000161955","ENSG00000161955","TNFSF13","17",7558292,7561608,3316
"10001","ENSG00000125735","ENSG00000125735","TNFSF14","19",6661253,6670588,9335
"10002","ENSG00000117586","ENSG00000117586","TNFSF4","1",173162645,173477583,314938
"10003","ENSG00000106952","ENSG00000106952","TNFSF8","9",114893343,114930595,37252
"10004","ENSG00000125657","ENSG00000125657","TNFSF9","19",6531026,6535924,4898
"10005","ENSG00000154310","ENSG00000154310","TNIK","3",171058414,171460408,401994
"10006","ENSG00000145901","ENSG00000145901","TNIP1","5",151029945,151093577,63632
"10007","ENSG00000168884","ENSG00000168884","TNIP2","4",2741648,2756342,14694
"10008","ENSG00000050730","ENSG00000050730","TNIP3","4",121131408,121227466,96058
"10009","ENSG00000174292","ENSG00000174292","TNK1","17",7380534,7389774,9240
"10010","ENSG00000061938","ENSG00000061938","TNK2","3",195863364,195911945,48581
"10011","ENSG00000173273","ENSG00000173273","TNKS","8",9555912,9782346,226434
"10012","ENSG00000107854","ENSG00000107854","TNKS2","10",91798426,91865475,67049
"10013","ENSG00000000005","ENSG00000000005","TNMD","X",100584936,100599885,14949
"10014","ENSG00000120332","ENSG00000120332","TNN","1",175067833,175148075,80242
"10015","ENSG00000114854","ENSG00000114854","TNNC1","3",52451100,52454041,2941
"10016","ENSG00000101470","ENSG00000101470","TNNC2","20",45823214,45833745,10531
"10017","ENSG00000159173","ENSG00000159173","TNNI1","1",201403784,201429866,26082
"10018","ENSG00000130598","ENSG00000130598","TNNI2","11",1838981,1841680,2699
"10019","ENSG00000129991","ENSG00000129991","TNNI3","19",55151767,55157773,6006
"10020","ENSG00000116783","ENSG00000116783","TNNI3K","1",74235387,74544428,309041
"10021","ENSG00000105048","ENSG00000105048","TNNT1","19",55132698,55149206,16508
"10022","ENSG00000118194","ENSG00000118194","TNNT2","1",201359008,201377764,18756
"10023","ENSG00000130595","ENSG00000130595","TNNT3","11",1919703,1938706,19003
"10024","ENSG00000083312","ENSG00000083312","TNPO1","5",72816312,72916733,100421
"10025","ENSG00000105576","ENSG00000105576","TNPO2","19",12699201,12724011,24810
"10026","ENSG00000064419","ENSG00000064419","TNPO3","7",128954180,129055173,100993
"10027","ENSG00000116147","ENSG00000116147","TNR","1",175315194,175743595,428401
"10028","ENSG00000100354","ENSG00000100354","TNRC6B","22",40044817,40335808,290991
"10029","ENSG00000079308","ENSG00000079308","TNS1","2",217799588,218033982,234394
"10030","ENSG00000111077","ENSG00000111077","TNS2","12",53046969,53064379,17410
"10031","ENSG00000136205","ENSG00000136205","TNS3","7",47275154,47582558,307404
"10032","ENSG00000131746","ENSG00000131746","TNS4","17",40475828,40501623,25795
"10033","ENSG00000236236","ENSG00000236236","TNXB","HSCHR6_MHC_SSTO_CTG1",3342342,3369188,26846
"10034","ENSG00000141232","ENSG00000141232","TOB1","17",50862223,50867978,5755
"10035","ENSG00000183864","ENSG00000183864","TOB2","22",41433494,41446801,13307
"10036","ENSG00000132773","ENSG00000132773","TOE1","1",45340052,45343973,3921
"10037","ENSG00000078902","ENSG00000078902","TOLLIP","11",1274371,1309654,35283
"10038","ENSG00000100284","ENSG00000100284","TOM1","22",35299275,35347992,48717
"10039","ENSG00000141198","ENSG00000141198","TOM1L1","17",54899387,54961956,62569
"10040","ENSG00000175662","ENSG00000175662","TOM1L2","17",17843511,17972422,128911
"10041","ENSG00000173726","ENSG00000173726","TOMM20","1",235109341,235128837,19496
"10042","ENSG00000100216","ENSG00000100216","TOMM22","22",38681957,38685421,3464
"10043","ENSG00000025772","ENSG00000025772","TOMM34","20",44942130,44960397,18267
"10044","ENSG00000130204","ENSG00000130204","TOMM40","19",44890569,44903689,13120
"10045","ENSG00000196683","ENSG00000196683","TOMM7","7",22812628,22822849,10221
"10046","ENSG00000154174","ENSG00000154174","TOMM70","3",100363431,100401089,37658
"10047","ENSG00000160949","ENSG00000160949","TONSL","8",144428775,144444440,15665
"10048","ENSG00000198900","ENSG00000198900","TOP1","20",41028822,41124487,95665
"10049","ENSG00000131747","ENSG00000131747","TOP2A","17",40388525,40417896,29371
"10050","ENSG00000077097","ENSG00000077097","TOP2B","3",25597978,25664909,66931
"10051","ENSG00000177302","ENSG00000177302","TOP3A","17",18271428,18315007,43579
"10052","ENSG00000100038","ENSG00000100038","TOP3B","22",21957025,21982813,25788
"10053","ENSG00000163781","ENSG00000163781","TOPBP1","3",133598175,133662380,64205
"10054","ENSG00000197579","ENSG00000197579","TOPORS","9",32540544,32552586,12042
"10055","ENSG00000136827","ENSG00000136827","TOR1A","9",129812942,129824244,11302
"10056","ENSG00000143337","ENSG00000143337","TOR1AIP1","1",179882042,179920077,38035
"10057","ENSG00000169905","ENSG00000169905","TOR1AIP2","1",179839967,179877803,37836
"10058","ENSG00000136816","ENSG00000136816","TOR1B","9",129803157,129811281,8124
"10059","ENSG00000186283","ENSG00000186283","TOR3A","1",179082070,179098023,15953
"10060","ENSG00000198113","ENSG00000198113","TOR4A","9",137277726,137282641,4915
"10061","ENSG00000198846","ENSG00000198846","TOX","8",58805412,59119147,313735
"10062","ENSG00000103460","ENSG00000103460","TOX3","16",52436417,52547802,111385
"10063","ENSG00000092203","ENSG00000092203","TOX4","14",21476597,21499175,22578
"10064","ENSG00000141510","ENSG00000141510","TP53","17",7661779,7687546,25767
"10065","ENSG00000067369","ENSG00000067369","TP53BP1","15",43403061,43510728,107667
"10066","ENSG00000143514","ENSG00000143514","TP53BP2","1",223779893,223845954,66061
"10067","ENSG00000175274","ENSG00000175274","TP53I11","11",44885903,44951306,65403
"10068","ENSG00000115129","ENSG00000115129","TP53I3","2",24077433,24085861,8428
"10069","ENSG00000183632","ENSG00000183632","TP53TG3","16",32673528,32676165,2637
"10070","ENSG00000205456","ENSG00000205456","TP53TG3D","16",32253286,32255928,2642
"10071","ENSG00000124251","ENSG00000124251","TP53TG5","20",45372557,45407889,35332
"10072","ENSG00000073282","ENSG00000073282","TP63","3",189631389,189897276,265887
"10073","ENSG00000078900","ENSG00000078900","TP73","1",3652516,3736201,83685
"10074","ENSG00000227372","ENSG00000227372","GFOD3P","1",3738434,3746742,8308
"10075","ENSG00000146242","ENSG00000146242","TPBG","6",82363206,82367420,4214
"10076","ENSG00000186815","ENSG00000186815","TPCN1","12",113221050,113298585,77535
"10077","ENSG00000076554","ENSG00000076554","TPD52","8",80034745,80231232,196487
"10078","ENSG00000111907","ENSG00000111907","TPD52L1","6",125119049,125264407,145358
"10079","ENSG00000101150","ENSG00000101150","TPD52L2","20",63865228,63891545,26317
"10080","ENSG00000134779","ENSG00000134779","TPGS2","18",36777647,36829216,51569
"10081","ENSG00000129167","ENSG00000129167","TPH1","11",18017555,18046269,28714
"10082","ENSG00000111669","ENSG00000111669","TPI1","12",6867119,6870948,3829
"10083","ENSG00000196511","ENSG00000196511","TPK1","7",144451941,144836395,384454
"10084","ENSG00000140416","ENSG00000140416","TPM1","15",63042620,63071915,29295
"10085","ENSG00000198467","ENSG00000198467","TPM2","9",35681992,35690056,8064
"10086","ENSG00000143549","ENSG00000143549","TPM3","1",154155308,154194648,39340
"10087","ENSG00000167460","ENSG00000167460","TPM4","19",16067021,16103002,35981
"10088","ENSG00000137364","ENSG00000137364","TPMT","6",18128311,18155077,26766
"10089","ENSG00000115705","ENSG00000115705","TPO","2",1374066,1543711,169645
"10090","ENSG00000166340","ENSG00000166340","TPP1","11",6612768,6619448,6680
"10091","ENSG00000134900","ENSG00000134900","TPP2","13",102596958,102679958,83000
"10092","ENSG00000171368","ENSG00000171368","TPPP","5",659862,693352,33490
"10093","ENSG00000159713","ENSG00000159713","TPPP3","16",67389809,67393518,3709
"10094","ENSG00000047410","ENSG00000047410","TPR","1",186311652,186375693,64041
"10095","ENSG00000163870","ENSG00000163870","TPRA1","3",127571232,127598267,27035
"10096","ENSG00000144034","ENSG00000144034","TPRKB","2",73729104,73737400,8296
"10097","ENSG00000172236","ENSG00000172236","TPSAB1","16",1239266,1242554,3288
"10098","ENSG00000197253","ENSG00000197253","TPSB2","16",1227272,1232757,5485
"10099","ENSG00000116176","ENSG00000116176","TPSG1","16",1221651,1225793,4142
"10100","ENSG00000169902","ENSG00000169902","TPST1","7",66205317,66420543,215226
"10101","ENSG00000128294","ENSG00000128294","TPST2","22",26521996,26596717,74721
"10102","ENSG00000133112","ENSG00000133112","TPT1","13",45333471,45341284,7813
"10103","ENSG00000274391","ENSG00000274391","TPTE","21",10521553,10606140,84587
"10104","ENSG00000088325","ENSG00000088325","TPX2","20",31739271,31801805,62534
"10105","ENSG00000164548","ENSG00000164548","TRA2A","7",23504780,23532041,27261
"10106","ENSG00000136527","ENSG00000136527","TRA2B","3",185914558,185938103,23545
"10107","ENSG00000170638","ENSG00000170638","TRABD","22",50185913,50199598,13685
"10108","ENSG00000102871","ENSG00000102871","TRADD","16",67154185,67159909,5724
"10109","ENSG00000056558","ENSG00000056558","TRAF1","9",120902393,120929173,26780
"10110","ENSG00000127191","ENSG00000127191","TRAF2","9",136881912,136926607,44695
"10111","ENSG00000131323","ENSG00000131323","TRAF3","14",102777449,102911500,134051
"10112","ENSG00000204104","ENSG00000204104","TRAF3IP1","2",238320441,238400897,80456
"10113","ENSG00000056972","ENSG00000056972","TRAF3IP2","6",111555381,111606906,51525
"10114","ENSG00000009790","ENSG00000009790","TRAF3IP3","1",209756032,209782320,26288
"10115","ENSG00000076604","ENSG00000076604","TRAF4","17",28744011,28750956,6945
"10116","ENSG00000082512","ENSG00000082512","TRAF5","1",211326615,211374946,48331
"10117","ENSG00000175104","ENSG00000175104","TRAF6","11",36483769,36510272,26503
"10118","ENSG00000135148","ENSG00000135148","TRAFD1","12",112125538,112153604,28066
"10119","ENSG00000183763","ENSG00000183763","TRAIP","3",49828601,49856574,27973
"10120","ENSG00000182606","ENSG00000182606","TRAK1","3",42013802,42225890,212088
"10121","ENSG00000115993","ENSG00000115993","TRAK2","2",201377207,201451500,74293
"10122","ENSG00000067167","ENSG00000067167","TRAM1","8",70573218,70608416,35198
"10123","ENSG00000065308","ENSG00000065308","TRAM2","6",52497408,52577060,79652
"10124","ENSG00000168016","ENSG00000168016","TRANK1","3",36826819,36945057,118238
"10125","ENSG00000126602","ENSG00000126602","TRAP1","16",3651639,3717553,65914
"10126","ENSG00000160218","ENSG00000160218","TRAPPC10","21",44012309,44106552,94243
"10127","ENSG00000168538","ENSG00000168538","TRAPPC11","4",183659267,183713594,54327
"10128","ENSG00000274891","ENSG00000274891","TRAPPC12","HSCHR2_1_CTG1",9880,94564,84684
"10129","ENSG00000113597","ENSG00000113597","TRAPPC13","5",65625004,65666233,41229
"10130","ENSG00000196459","ENSG00000196459","TRAPPC2","X",13712244,13734635,22391
"10131","ENSG00000256060","ENSG00000256060","TRAPPC2B","19",57363551,57365405,1854
"10132","ENSG00000167515","ENSG00000167515","TRAPPC2L","16",88856220,88862686,6466
"10133","ENSG00000054116","ENSG00000054116","TRAPPC3","1",36136570,36156053,19483
"10134","ENSG00000280495","ENSG00000280495","TRAPPC4","HG2217_PATCH",40363,47054,6691
"10135","ENSG00000007255","ENSG00000007255","TRAPPC6A","19",45162928,45178237,15309
"10136","ENSG00000153339","ENSG00000153339","TRAPPC8","18",31829197,31953136,123939
"10137","ENSG00000167632","ENSG00000167632","TRAPPC9","8",139727725,140458579,730854
"10138","ENSG00000163519","ENSG00000163519","TRAT1","3",108822770,108855005,32235
"10139","ENSG00000107614","ENSG00000107614","TRDMT1","10",17137336,17202054,64718
"10140","ENSG00000186439","ENSG00000186439","TRDN","6",123216339,123637189,420850
"10141","ENSG00000118094","ENSG00000118094","TREH","11",118657316,118679690,22374
"10142","ENSG00000124731","ENSG00000124731","TREM1","6",41267926,41286682,18756
"10143","ENSG00000095970","ENSG00000095970","TREM2","6",41158506,41163186,4680
"10144","ENSG00000112195","ENSG00000112195","TREML2","6",41189749,41201149,11400
"10145","ENSG00000213689","ENSG00000213689","TREX1","3",48465811,48467645,1834
"10146","ENSG00000183479","ENSG00000183479","TREX2","X",153444473,153470587,26114
"10147","ENSG00000211689","ENSG00000211689","TRGC1","7",38257879,38265678,7799
"10148","ENSG00000072657","ENSG00000072657","TRHDE","12",72087266,72670758,583492
"10149","ENSG00000170855","ENSG00000170855","TRIAP1","12",120443964,120446384,2420
"10150","ENSG00000173334","ENSG00000173334","TRIB1","8",125430358,125438403,8045
"10151","ENSG00000071575","ENSG00000071575","TRIB2","2",12716910,12742734,25824
"10152","ENSG00000101255","ENSG00000101255","TRIB3","20",362835,397559,34724
"10153","ENSG00000255690","ENSG00000255690","TRIL","7",28953358,28958330,4972
"10154","ENSG00000204977","ENSG00000204977","TRIM13","13",49995888,50020481,24593
"10155","ENSG00000106785","ENSG00000106785","TRIM14","9",98069275,98119222,49947
"10156","ENSG00000221926","ENSG00000221926","TRIM16","17",15627960,15684311,56351
"10157","ENSG00000162931","ENSG00000162931","TRIM17","1",228407935,228416861,8926
"10158","ENSG00000109654","ENSG00000109654","TRIM2","4",153152163,153339319,187156
"10159","ENSG00000132109","ENSG00000132109","TRIM21","11",4384897,4393702,8805
"10160","ENSG00000132274","ENSG00000132274","TRIM22","11",5689610,5737089,47479
"10161","ENSG00000113595","ENSG00000113595","TRIM23","5",65589690,65625975,36285
"10162","ENSG00000122779","ENSG00000122779","TRIM24","7",138460259,138589996,129737
"10163","ENSG00000121060","ENSG00000121060","TRIM25","17",56836387,56914080,77693
"10164","ENSG00000234127","ENSG00000234127","TRIM26","6",30184455,30213427,28972
"10165","ENSG00000237071","ENSG00000237071","TRIM27","HSCHR6_MHC_COX_CTG1",393697,414688,20991
"10166","ENSG00000130726","ENSG00000130726","TRIM28","19",58544064,58550722,6658
"10167","ENSG00000137699","ENSG00000137699","TRIM29","11",120111286,120185529,74243
"10168","ENSG00000110171","ENSG00000110171","TRIM3","11",6448613,6474459,25846
"10169","ENSG00000233573","ENSG00000233573","TRIM31","HSCHR6_MHC_DBB_CTG1",1358814,1369016,10202
"10170","ENSG00000119401","ENSG00000119401","TRIM32","9",116687305,116701300,13995
"10171","ENSG00000197323","ENSG00000197323","TRIM33","1",114392790,114511203,118413
"10172","ENSG00000258659","ENSG00000258659","TRIM34","11",5619764,5644398,24634
"10173","ENSG00000152503","ENSG00000152503","TRIM36","5",115124762,115180546,55784
"10174","ENSG00000108395","ENSG00000108395","TRIM37","17",58982638,59106921,124283
"10175","ENSG00000112343","ENSG00000112343","TRIM38","6",25962802,25991231,28429
"10176","ENSG00000232839","ENSG00000232839","TRIM39","HSCHR6_MHC_DBB_CTG1",1582319,1599575,17256
"10177","ENSG00000166326","ENSG00000166326","TRIM44","11",35662775,35818007,155232
"10178","ENSG00000134253","ENSG00000134253","TRIM45","1",117111060,117122587,11527
"10179","ENSG00000163462","ENSG00000163462","TRIM46","1",155173787,155184971,11184
"10180","ENSG00000168930","ENSG00000168930","TRIM49","11",89797655,89808575,10920
"10181","ENSG00000132256","ENSG00000132256","TRIM5","11",5663195,5938619,275424
"10182","ENSG00000258588","ENSG00000258588","TRIM6-TRIM34","11",5596725,5644398,47673
"10183","ENSG00000116525","ENSG00000116525","TRIM62","1",33145399,33182059,36660
"10184","ENSG00000166436","ENSG00000166436","TRIM66","11",8612037,8682694,70657
"10185","ENSG00000167333","ENSG00000167333","TRIM68","11",4598672,4608231,9559
"10186","ENSG00000171206","ENSG00000171206","TRIM8","10",102642503,102658318,15815
"10187","ENSG00000100505","ENSG00000100505","TRIM9","14",50975262,51096061,120799
"10188","ENSG00000038382","ENSG00000038382","TRIO","5",14143342,14532128,388786
"10189","ENSG00000100106","ENSG00000100106","TRIOBP","22",37697048,37776556,79508
"10190","ENSG00000125733","ENSG00000125733","TRIP10","19",6737925,6751530,13605
"10191","ENSG00000100815","ENSG00000100815","TRIP11","14",91965991,92040896,74905
"10192","ENSG00000153827","ENSG00000153827","TRIP12","2",229763837,229923239,159402
"10193","ENSG00000071539","ENSG00000071539","TRIP13","5",892884,919357,26473
"10194","ENSG00000103671","ENSG00000103671","TRIP4","15",64387748,64455303,67555
"10195","ENSG00000087077","ENSG00000087077","TRIP6","7",100867387,100873454,6067
"10196","ENSG00000043514","ENSG00000043514","TRIT1","1",39838110,39883511,45401
"10197","ENSG00000136932","ENSG00000136932","TRMO","9",97904489,97922500,18011
"10198","ENSG00000104907","ENSG00000104907","TRMT1","19",13104902,13117567,12665
"10199","ENSG00000066651","ENSG00000066651","TRMT11","6",125986479,126203817,217338
"10200","ENSG00000173113","ENSG00000173113","TRMT112","11",64316460,64317559,1099
"10201","ENSG00000183665","ENSG00000183665","TRMT12","8",124450820,124462150,11330
"10202","ENSG00000122435","ENSG00000122435","TRMT13","1",100133150,100150496,17346
"10203","ENSG00000121486","ENSG00000121486","TRMT1L","1",185118101,185157072,38971
"10204","ENSG00000099899","ENSG00000099899","TRMT2A","22",20111875,20117392,5517
"10205","ENSG00000188917","ENSG00000188917","TRMT2B","X",101009346,101052116,42770
"10206","ENSG00000155275","ENSG00000155275","TRMT44","4",8436140,8493531,57391
"10207","ENSG00000126814","ENSG00000126814","TRMT5","14",60971441,60981170,9729
"10208","ENSG00000166166","ENSG00000166166","TRMT61A","14",103529196,103537073,7877
"10209","ENSG00000171103","ENSG00000171103","TRMT61B","2",28849821,28870309,20488
"10210","ENSG00000100416","ENSG00000100416","TRMU","22",46330875,46357340,26465
"10211","ENSG00000180098","ENSG00000180098","TRNAU1AP","1",28553085,28578545,25460
"10212","ENSG00000067445","ENSG00000067445","TRO","X",54920462,54931431,10969
"10213","ENSG00000135451","ENSG00000135451","TROAP","12",49323236,49331731,8495
"10214","ENSG00000104321","ENSG00000104321","TRPA1","8",72019917,72075584,55667
"10215","ENSG00000144935","ENSG00000144935","TRPC1","3",142724034,142807888,83854
"10216","ENSG00000133107","ENSG00000133107","TRPC4","13",37632063,37869802,237739
"10217","ENSG00000100991","ENSG00000100991","TRPC4AP","20",35002404,35092807,90403
"10218","ENSG00000137672","ENSG00000137672","TRPC6","11",101451564,101872562,420998
"10219","ENSG00000069018","ENSG00000069018","TRPC7","5",136212745,136365545,152800
"10220","ENSG00000274965","ENSG00000274965","TRPM1","HSCHR15_4_CTG8",3286821,3447037,160216
"10221","ENSG00000142185","ENSG00000142185","TRPM2","21",44350163,44443081,92918
"10222","ENSG00000083067","ENSG00000083067","TRPM3","9",70529060,71446977,917917
"10223","ENSG00000130529","ENSG00000130529","TRPM4","19",49157741,49211836,54095
"10224","ENSG00000104447","ENSG00000104447","TRPS1","8",115408496,115809673,401177
"10225","ENSG00000187688","ENSG00000187688","TRPV2","17",16415571,16437003,21432
"10226","ENSG00000111199","ENSG00000111199","TRPV4","12",109783087,109833406,50319
"10227","ENSG00000274348","ENSG00000274348","TRPV5","HSCHR7_2_CTG6",931168,956875,25707
"10228","ENSG00000276971","ENSG00000276971","TRPV6","HSCHR7_2_CTG6",894245,908802,14557
"10229","ENSG00000196367","ENSG00000196367","TRRAP","7",98877933,99050831,172898
"10230","ENSG00000165699","ENSG00000165699","TSC1","9",132891348,132946874,55526
"10231","ENSG00000103197","ENSG00000103197","TSC2","16",2047967,2089491,41524
"10232","ENSG00000102804","ENSG00000102804","TSC22D1","13",44432143,44577147,145004
"10233","ENSG00000196428","ENSG00000196428","TSC22D2","3",150408298,150466422,58124
"10234","ENSG00000157514","ENSG00000157514","TSC22D3","X",107713221,107777342,64121
"10235","ENSG00000166925","ENSG00000166925","TSC22D4","7",100463359,100479232,15873
"10236","ENSG00000154743","ENSG00000154743","TSEN2","3",12484421,12541549,57128
"10237","ENSG00000278712","ENSG00000278712","TSEN34","HSCHR19LRC_PGF2_CTG3_1",165233,169508,4275
"10238","ENSG00000123297","ENSG00000123297","TSFM","12",57782761,57808071,25310
"10239","ENSG00000074319","ENSG00000074319","TSG101","11",18468336,18526951,58615
"10240","ENSG00000135951","ENSG00000135951","TSGA10","2",98997261,99154964,157703
"10241","ENSG00000165409","ENSG00000165409","TSHR","14",80954989,81146306,191317
"10242","ENSG00000182463","ENSG00000182463","TSHZ2","20",52972358,53495330,522972
"10243","ENSG00000126467","ENSG00000126467","TSKS","19",49739753,49763306,23553
"10244","ENSG00000182704","ENSG00000182704","TSKU","11",76782251,76798153,15902
"10245","ENSG00000211460","ENSG00000211460","TSN","2",121737103,121767853,30750
"10246","ENSG00000116918","ENSG00000116918","TSNAX","1",231528541,231566524,37983
"10247","ENSG00000102904","ENSG00000102904","TSNAXIP1","16",67806765,67832148,25383
"10248","ENSG00000117472","ENSG00000117472","TSPAN1","1",46175073,46185962,10889
"10249","ENSG00000106025","ENSG00000106025","TSPAN12","7",120787320,120858402,71082
"10250","ENSG00000106537","ENSG00000106537","TSPAN13","7",16753755,16784536,30781
"10251","ENSG00000108219","ENSG00000108219","TSPAN14","10",80454265,80533124,78859
"10252","ENSG00000099282","ENSG00000099282","TSPAN15","10",69451465,69507666,56201
"10253","ENSG00000134198","ENSG00000134198","TSPAN2","1",115048011,115089503,41492
"10254","ENSG00000140391","ENSG00000140391","TSPAN3","15",77041404,77083984,42580
"10255","ENSG00000135452","ENSG00000135452","TSPAN31","12",57738013,57750219,12206
"10256","ENSG00000064201","ENSG00000064201","TSPAN32","11",2301997,2318204,16207
"10257","ENSG00000214063","ENSG00000214063","TSPAN4","11",842812,867116,24304
"10258","ENSG00000168785","ENSG00000168785","TSPAN5","4",98470367,98658611,188244
"10259","ENSG00000000003","ENSG00000000003","TSPAN6","X",100627108,100639991,12883
"10260","ENSG00000156298","ENSG00000156298","TSPAN7","X",38561542,38688920,127378
"10261","ENSG00000127324","ENSG00000127324","TSPAN8","12",71125085,71441898,316813
"10262","ENSG00000011105","ENSG00000011105","TSPAN9","12",3077355,3286564,209209
"10263","ENSG00000100300","ENSG00000100300","TSPO","22",43151547,43163242,11695
"10264","ENSG00000005379","ENSG00000005379","TSPOAP1","17",58301228,58328795,27567
"10265","ENSG00000184205","ENSG00000184205","TSPYL2","X",53082367,53088540,6173
"10266","ENSG00000187189","ENSG00000187189","TSPYL4","6",116249964,116254075,4111
"10267","ENSG00000180543","ENSG00000180543","TSPYL5","8",97273488,97277928,4440
"10268","ENSG00000167721","ENSG00000167721","TSR1","17",2322396,2336657,14261
"10269","ENSG00000158526","ENSG00000158526","TSR2","X",54440404,54448032,7628
"10270","ENSG00000007520","ENSG00000007520","TSR3","16",1349240,1351878,2638
"10271","ENSG00000184281","ENSG00000184281","TSSC4","11",2400488,2403878,3390
"10272","ENSG00000212122","ENSG00000212122","TSSK1B","5",113432553,113434989,2436
"10273","ENSG00000206203","ENSG00000206203","TSSK2","22",19131308,19132622,1314
"10274","ENSG00000136925","ENSG00000136925","TSTD2","9",97600080,97633368,33288
"10275","ENSG00000128881","ENSG00000128881","TTBK2","15",42738730,42920809,182079
"10276","ENSG00000113312","ENSG00000113312","TTC1","5",160009113,160065543,56430
"10277","ENSG00000149292","ENSG00000149292","TTC12","11",113314579,113383544,68965
"10278","ENSG00000143643","ENSG00000143643","TTC13","1",230906243,230978875,72632
"10279","ENSG00000052841","ENSG00000052841","TTC17","11",43358920,43494933,136013
"10280","ENSG00000011295","ENSG00000011295","TTC19","17",15999784,16045015,45231
"10281","ENSG00000123607","ENSG00000123607","TTC21B","2",165857475,165953851,96376
"10282","ENSG00000006555","ENSG00000006555","TTC22","1",54779712,54801323,21611
"10283","ENSG00000103852","ENSG00000103852","TTC23","15",99136323,99251223,114900
"10284","ENSG00000018699","ENSG00000018699","TTC27","2",32628032,32821051,193019
"10285","ENSG00000100154","ENSG00000100154","TTC28","22",27978014,28679840,701826
"10286","ENSG00000182670","ENSG00000182670","TTC3","21",37073226,37203112,129886
"10287","ENSG00000115282","ENSG00000115282","TTC31","2",74483073,74494559,11486
"10288","ENSG00000113638","ENSG00000113638","TTC33","5",40512333,40755963,243630
"10289","ENSG00000075234","ENSG00000075234","TTC38","22",46267961,46294008,26047
"10290","ENSG00000085831","ENSG00000085831","TTC39A","1",51287258,51345116,57858
"10291","ENSG00000243725","ENSG00000243725","TTC4","1",54715861,54742657,26796
"10292","ENSG00000133985","ENSG00000133985","TTC9","14",70641916,70675366,33450
"10293","ENSG00000125482","ENSG00000125482","TTF1","9",132375548,132406851,31303
"10294","ENSG00000116830","ENSG00000116830","TTF2","1",117060326,117107453,47127
"10295","ENSG00000101407","ENSG00000101407","TTI1","20",37983007,38033461,50454
"10296","ENSG00000129696","ENSG00000129696","TTI2","8",33473386,33513185,39799
"10297","ENSG00000112742","ENSG00000112742","TTK","6",80003887,80042527,38640
"10298","ENSG00000100271","ENSG00000100271","TTLL1","22",43039516,43089419,49903
"10299","ENSG00000100304","ENSG00000100304","TTLL12","22",43166622,43187134,20512
"10300","ENSG00000214021","ENSG00000214021","TTLL3","3",9808086,9855138,47052
"10301","ENSG00000135912","ENSG00000135912","TTLL4","2",218710835,218755416,44581
"10302","ENSG00000119685","ENSG00000119685","TTLL5","14",75633625,75955079,321454
"10303","ENSG00000137941","ENSG00000137941","TTLL7","1",83865024,83999150,134126
"10304","ENSG00000155657","ENSG00000155657","TTN","2",178525989,178830802,304813
"10305","ENSG00000137561","ENSG00000137561","TTPA","8",63048553,63086053,37500
"10306","ENSG00000124120","ENSG00000124120","TTPAL","20",44475874,44494603,18729
"10307","ENSG00000118271","ENSG00000118271","TTR","18",31557009,31598833,41824
"10308","ENSG00000276887","ENSG00000276887","TTYH1","HSCHR19LRC_PGF1_CTG3_1",319913,341588,21675
"10309","ENSG00000167553","ENSG00000167553","TUBA1C","12",49188736,49274600,85864
"10310","ENSG00000198033","ENSG00000198033","TUBA3C","13",19173772,19181824,8052
"10311","ENSG00000075886","ENSG00000075886","TUBA3D","2",131476119,131482934,6815
"10312","ENSG00000127824","ENSG00000127824","TUBA4A","2",219249710,219277902,28192
"10313","ENSG00000183785","ENSG00000183785","TUBA8","22",18110100,18146683,36583
"10314","ENSG00000178462","ENSG00000178462","TUBAL3","10",5393101,5404828,11727
"10315","ENSG00000235067","ENSG00000235067","TUBB","HSCHR6_MHC_DBB_CTG1",1976051,1981276,5225
"10316","ENSG00000101162","ENSG00000101162","TUBB1","20",59019429,59026654,7225
"10317","ENSG00000137267","ENSG00000137267","TUBB2A","6",3153497,3157544,4047
"10318","ENSG00000137285","ENSG00000137285","TUBB2B","6",3223324,3231730,8406
"10319","ENSG00000258947","ENSG00000258947","TUBB3","16",89921392,89938761,17369
"10320","ENSG00000104833","ENSG00000104833","TUBB4A","19",6494319,6502848,8529
"10321","ENSG00000188229","ENSG00000188229","TUBB4B","9",137241287,137243707,2420
"10322","ENSG00000176014","ENSG00000176014","TUBB6","18",12307669,12344320,36651
"10323","ENSG00000108423","ENSG00000108423","TUBD1","17",59859479,59892945,33466
"10324","ENSG00000131462","ENSG00000131462","TUBG1","17",42609641,42615238,5597
"10325","ENSG00000037042","ENSG00000037042","TUBG2","17",42659284,42667006,7722
"10326","ENSG00000130640","ENSG00000130640","TUBGCP2","10",133278635,133318823,40188
"10327","ENSG00000282003","ENSG00000282003","TUBGCP3","HSCHR13_1_CTG1",285979,305684,19705
"10328","ENSG00000137822","ENSG00000137822","TUBGCP4","15",43369221,43409771,40550
"10329","ENSG00000276856","ENSG00000276856","TUBGCP5","HSCHR15_1_CTG3",80186,136694,56508
"10330","ENSG00000178952","ENSG00000178952","TUFM","16",28842411,28846348,3937
"10331","ENSG00000143367","ENSG00000143367","TUFT1","1",151540305,151583583,43278
"10332","ENSG00000112041","ENSG00000112041","TULP1","6",35497874,35512896,15022
"10333","ENSG00000104804","ENSG00000104804","TULP2","19",48880965,48898744,17779
"10334","ENSG00000078246","ENSG00000078246","TULP3","12",2877223,2941138,63915
"10335","ENSG00000130338","ENSG00000130338","TULP4","6",158232236,158511828,279592
"10336","ENSG00000114383","ENSG00000114383","TUSC2","3",50320027,50328251,8224
"10337","ENSG00000104723","ENSG00000104723","TUSC3","8",15417215,15766649,349434
"10338","ENSG00000149016","ENSG00000149016","TUT1","11",62575045,62591637,16592
"10339","ENSG00000171928","ENSG00000171928","TVP23B","17",18781111,18806714,25603
"10340","ENSG00000151239","ENSG00000151239","TWF1","12",43793723,43806328,12605
"10341","ENSG00000247596","ENSG00000247596","TWF2","3",52228612,52246788,18176
"10342","ENSG00000122691","ENSG00000122691","TWIST1","7",19020991,19117636,96645
"10343","ENSG00000128791","ENSG00000128791","TWSG1","18",9334767,9402420,67653
"10344","ENSG00000074966","ENSG00000074966","TXK","4",48066393,48134250,67857
"10345","ENSG00000086712","ENSG00000086712","TXLNG","X",16786432,16844519,58087
"10346","ENSG00000136810","ENSG00000136810","TXN","9",110243810,110256507,12697
"10347","ENSG00000100348","ENSG00000100348","TXN2","22",36467046,36481640,14594
"10348","ENSG00000113621","ENSG00000113621","TXNDC15","5",134874371,134901635,27264
"10349","ENSG00000087301","ENSG00000087301","TXNDC16","14",52430596,52552522,121926
"10350","ENSG00000239264","ENSG00000239264","TXNDC5","6",7881517,7910788,29271
"10351","ENSG00000115514","ENSG00000115514","TXNDC9","2",99318982,99340702,21720
"10352","ENSG00000265972","ENSG00000265972","TXNIP","1",145992435,145996579,4144
"10353","ENSG00000091164","ENSG00000091164","TXNL1","18",56597209,56651600,54391
"10354","ENSG00000141759","ENSG00000141759","TXNL4A","18",79970813,80033949,63136
"10355","ENSG00000140830","ENSG00000140830","TXNL4B","16",72044289,72094431,50142
"10356","ENSG00000198431","ENSG00000198431","TXNRD1","12",104215779,104350307,134528
"10357","ENSG00000184470","ENSG00000184470","TXNRD2","22",19875517,19941820,66303
"10358","ENSG00000197763","ENSG00000197763","TXNRD3","3",126571779,126655124,83345
"10359","ENSG00000105397","ENSG00000105397","TYK2","19",10350533,10380608,30075
"10360","ENSG00000025708","ENSG00000025708","TYMP","22",50525752,50530032,4280
"10361","ENSG00000176890","ENSG00000176890","TYMS","18",657653,673578,15925
"10362","ENSG00000077498","ENSG00000077498","TYR","11",89177875,89295759,117884
"10363","ENSG00000092445","ENSG00000092445","TYRO3","15",41557675,41583589,25914
"10364","ENSG00000011600","ENSG00000011600","TYROBP","19",35904401,35908295,3894
"10365","ENSG00000107165","ENSG00000107165","TYRP1","9",12685439,12710285,24846
"10366","ENSG00000198874","ENSG00000198874","TYW1","7",66995173,67239514,244341
"10367","ENSG00000160201","ENSG00000160201","U2AF1","21",43092956,43107570,14614
"10368","ENSG00000063244","ENSG00000063244","U2AF2","19",55654146,55674716,20570
"10369","ENSG00000163714","ENSG00000163714","U2SURP","3",142964497,143060725,96228
"10370","ENSG00000117143","ENSG00000117143","UAP1","1",162561722,162601240,39518
"10371","ENSG00000197355","ENSG00000197355","UAP1L1","9",137077517,137084539,7022
"10372","ENSG00000130985","ENSG00000130985","UBA1","X",47190861,47215128,24267
"10373","ENSG00000126261","ENSG00000126261","UBA2","19",34428352,34471251,42899
"10374","ENSG00000144744","ENSG00000144744","UBA3","3",69054730,69080408,25678
"10375","ENSG00000081307","ENSG00000081307","UBA5","3",132654446,132679794,25348
"10376","ENSG00000221983","ENSG00000221983","UBA52","19",18571730,18577550,5820
"10377","ENSG00000033178","ENSG00000033178","UBA6","4",67612652,67701155,88503
"10378","ENSG00000182179","ENSG00000182179","UBA7","3",49805209,49813953,8744
"10379","ENSG00000130560","ENSG00000130560","UBAC1","9",135932969,135961373,28404
"10380","ENSG00000165006","ENSG00000165006","UBAP1","9",34179005,34252523,73518
"10381","ENSG00000137073","ENSG00000137073","UBAP2","9",33921693,34049388,127695
"10382","ENSG00000143569","ENSG00000143569","UBAP2L","1",154220179,154271510,51331
"10383","ENSG00000160185","ENSG00000160185","UBASH3A","21",42403447,42447684,44237
"10384","ENSG00000170315","ENSG00000170315","UBB","17",16380798,16382745,1947
"10385","ENSG00000231968","ENSG00000231968","UBD","HSCHR6_MHC_DBB_CTG1",821155,825468,4313
"10386","ENSG00000077721","ENSG00000077721","UBE2A","X",119474802,119591083,116281
"10387","ENSG00000119048","ENSG00000119048","UBE2B","5",134371184,134392108,20924
"10388","ENSG00000175063","ENSG00000175063","UBE2C","20",45812576,45816957,4381
"10389","ENSG00000072401","ENSG00000072401","UBE2D1","10",58334979,58370751,35772
"10390","ENSG00000131508","ENSG00000131508","UBE2D2","5",139526431,139628434,102003
"10391","ENSG00000109332","ENSG00000109332","UBE2D3","4",102794383,102868896,74513
"10392","ENSG00000078967","ENSG00000078967","UBE2D4","7",43926436,43956136,29700
"10393","ENSG00000170142","ENSG00000170142","UBE2E1","3",23805955,23891640,85685
"10394","ENSG00000170035","ENSG00000170035","UBE2E3","2",180967248,181076585,109337
"10395","ENSG00000132388","ENSG00000132388","UBE2G1","17",4269259,4366675,97416
"10396","ENSG00000184787","ENSG00000184787","UBE2G2","21",44768580,44801826,33246
"10397","ENSG00000186591","ENSG00000186591","UBE2H","7",129830732,129952960,122228
"10398","ENSG00000103275","ENSG00000103275","UBE2I","16",1291444,1327018,35574
"10399","ENSG00000198833","ENSG00000198833","UBE2J1","6",89326625,89352722,26097
"10400","ENSG00000078140","ENSG00000078140","UBE2K","4",39698109,39782792,84683
"10401","ENSG00000185651","ENSG00000185651","UBE2L3","22",21549447,21624034,74587
"10402","ENSG00000156587","ENSG00000156587","UBE2L6","11",57551656,57568284,16628
"10403","ENSG00000130725","ENSG00000130725","UBE2M","19",58555712,58558954,3242
"10404","ENSG00000177889","ENSG00000177889","UBE2N","12",93405673,93441947,36274
"10405","ENSG00000175931","ENSG00000175931","UBE2O","17",76389456,76453152,63696
"10406","ENSG00000160714","ENSG00000160714","UBE2Q1","1",154548577,154559028,10451
"10407","ENSG00000108106","ENSG00000108106","UBE2S","19",55399745,55407788,8043
"10408","ENSG00000244687","ENSG00000244687","UBE2V1","20",50081124,50115959,34835
"10409","ENSG00000169139","ENSG00000169139","UBE2V2","8",48008415,48064708,56293
"10410","ENSG00000104343","ENSG00000104343","UBE2W","8",73780097,73878910,98813
"10411","ENSG00000159202","ENSG00000159202","UBE2Z","17",48908407,48929056,20649
"10412","ENSG00000114062","ENSG00000114062","UBE3A","15",25333728,25439051,105323
"10413","ENSG00000151148","ENSG00000151148","UBE3B","12",109477402,109536705,59303
"10414","ENSG00000009335","ENSG00000009335","UBE3C","7",157138926,157269370,130444
"10415","ENSG00000110344","ENSG00000110344","UBE4A","11",118359600,118399211,39611
"10416","ENSG00000130939","ENSG00000130939","UBE4B","1",10032832,10181239,148407
"10417","ENSG00000103353","ENSG00000103353","UBFD1","16",23557721,23574389,16668
"10418","ENSG00000120942","ENSG00000120942","UBIAD1","1",11273198,11296049,22851
"10419","ENSG00000122042","ENSG00000122042","UBL3","13",29764371,29850617,86246
"10420","ENSG00000102178","ENSG00000102178","UBL4A","X",154483717,154486615,2898
"10421","ENSG00000198258","ENSG00000198258","UBL5","19",9827892,9830115,2223
"10422","ENSG00000118900","ENSG00000118900","UBN1","16",4846665,4882401,35736
"10423","ENSG00000185019","ENSG00000185019","UBOX5","20",3107573,3160196,52623
"10424","ENSG00000153560","ENSG00000153560","UBP1","3",33388336,33441371,53035
"10425","ENSG00000188021","ENSG00000188021","UBQLN2","X",56563627,56567868,4241
"10426","ENSG00000160803","ENSG00000160803","UBQLN4","1",156035299,156053798,18499
"10427","ENSG00000024048","ENSG00000024048","UBR2","6",42564029,42693505,129476
"10428","ENSG00000127481","ENSG00000127481","UBR4","1",19074510,19210266,135756
"10429","ENSG00000104517","ENSG00000104517","UBR5","8",102252273,102412759,160486
"10430","ENSG00000278787","ENSG00000278787","UBR7","HSCHR14_7_CTG1",321618,343777,22159
"10431","ENSG00000165886","ENSG00000165886","UBTD1","10",97498924,97571206,72282
"10432","ENSG00000108312","ENSG00000108312","UBTF","17",44205033,44221626,16593
"10433","ENSG00000162191","ENSG00000162191","UBXN1","11",62676498,62679117,2619
"10434","ENSG00000215114","ENSG00000215114","UBXN2B","8",58411359,58451501,40142
"10435","ENSG00000144224","ENSG00000144224","UBXN4","2",135741734,135785056,43322
"10436","ENSG00000167671","ENSG00000167671","UBXN6","19",4444999,4457794,12795
"10437","ENSG00000163960","ENSG00000163960","UBXN7","3",196347662,196432430,84768
"10438","ENSG00000104691","ENSG00000104691","UBXN8","8",30729131,30767006,37875
"10439","ENSG00000154277","ENSG00000154277","UCHL1","4",41256413,41268455,12042
"10440","ENSG00000118939","ENSG00000118939","UCHL3","13",75549483,75606020,56537
"10441","ENSG00000116750","ENSG00000116750","UCHL5","1",193012250,193060080,47830
"10442","ENSG00000143179","ENSG00000143179","UCK2","1",165827614,165911618,84004
"10443","ENSG00000198276","ENSG00000198276","UCKL1","20",63939829,63956416,16587
"10444","ENSG00000163794","ENSG00000163794","UCN","2",27307400,27308445,1045
"10445","ENSG00000109424","ENSG00000109424","UCP1","4",140559431,140568961,9530
"10446","ENSG00000175567","ENSG00000175567","UCP2","11",73974672,73982843,8171
"10447","ENSG00000175564","ENSG00000175564","UCP3","11",74000277,74009085,8808
"10448","ENSG00000151116","ENSG00000151116","UEVLD","11",18529609,18588747,59138
"10449","ENSG00000143222","ENSG00000143222","UFC1","1",161152776,161158856,6080
"10450","ENSG00000014123","ENSG00000014123","UFL1","6",96521595,96555276,33681
"10451","ENSG00000120686","ENSG00000120686","UFM1","13",38349849,38363619,13770
"10452","ENSG00000109775","ENSG00000109775","UFSP2","4",185399537,185425979,26442
"10453","ENSG00000148154","ENSG00000148154","UGCG","9",111896814,111935369,38555
"10454","ENSG00000109814","ENSG00000109814","UGDH","4",39498755,39528311,29556
"10455","ENSG00000136731","ENSG00000136731","UGGT1","2",128091200,128195677,104477
"10456","ENSG00000102595","ENSG00000102595","UGGT2","13",95801580,96053482,251902
"10457","ENSG00000169764","ENSG00000169764","UGP2","2",63840952,63891562,50610
"10458","ENSG00000241635","ENSG00000241635","UGT1A1","2",233760270,233773300,13030
"10459","ENSG00000242515","ENSG00000242515","UGT1A10","2",233636448,233773300,136852
"10460","ENSG00000244474","ENSG00000244474","UGT1A4","2",233718736,233773300,54564
"10461","ENSG00000167165","ENSG00000167165","UGT1A6","2",233691607,233773300,81693
"10462","ENSG00000244122","ENSG00000244122","UGT1A7","2",233681901,233773300,91399
"10463","ENSG00000242366","ENSG00000242366","UGT1A8","2",233617633,233773300,155667
"10464","ENSG00000241119","ENSG00000241119","UGT1A9","2",233671898,233773300,101402
"10465","ENSG00000173610","ENSG00000173610","UGT2A1","4",69588417,69653249,64832
"10466","ENSG00000278216","ENSG00000278216","UGT2A3","HSCHR4_1_CTG9",504482,527810,23328
"10467","ENSG00000277132","ENSG00000277132","UGT2B15","HSCHR4_1_CTG9",222964,246983,24019
"10468","ENSG00000197888","ENSG00000197888","UGT2B17","4",68537173,68576413,39240
"10469","ENSG00000156096","ENSG00000156096","UGT2B4","4",69480165,69526014,45849
"10470","ENSG00000174607","ENSG00000174607","UGT8","4",114598770,114678225,79455
"10471","ENSG00000087206","ENSG00000087206","UIMC1","5",176905005,177022633,117628
"10472","ENSG00000111981","ENSG00000111981","ULBP1","6",149963943,149973715,9772
"10473","ENSG00000131015","ENSG00000131015","ULBP2","6",149942014,149949235,7221
"10474","ENSG00000177169","ENSG00000177169","ULK1","12",131894622,131923150,28528
"10475","ENSG00000083290","ENSG00000083290","ULK2","17",19770829,19867936,97107
"10476","ENSG00000168038","ENSG00000168038","ULK4","3",41246599,41962130,715531
"10477","ENSG00000114491","ENSG00000114491","UMPS","3",124730433,124749273,18840
"10478","ENSG00000109103","ENSG00000109103","UNC119","17",28546708,28552631,5923
"10479","ENSG00000175970","ENSG00000175970","UNC119B","12",120710458,120723640,13182
"10480","ENSG00000130477","ENSG00000130477","UNC13A","19",17601336,17688365,87029
"10481","ENSG00000198722","ENSG00000198722","UNC13B","9",35161992,35405338,243346
"10482","ENSG00000140553","ENSG00000140553","UNC45A","15",90930180,90954093,23913
"10483","ENSG00000115446","ENSG00000115446","UNC50","2",98608579,98618515,9936
"10484","ENSG00000107731","ENSG00000107731","UNC5B","10",71212570,71302864,90294
"10485","ENSG00000182168","ENSG00000182168","UNC5C","4",95162504,95549206,386702
"10486","ENSG00000112494","ENSG00000112494","UNC93A","6",167271169,167316014,44845
"10487","ENSG00000110057","ENSG00000110057","UNC93B1","11",67991100,68004982,13882
"10488","ENSG00000076248","ENSG00000076248","UNG","12",109097597,109126725,29128
"10489","ENSG00000059145","ENSG00000059145","UNKL","16",1363205,1414751,51546
"10490","ENSG00000100024","ENSG00000100024","UPB1","22",24494107,24528390,34283
"10491","ENSG00000005007","ENSG00000005007","UPF1","19",18831959,18868230,36271
"10492","ENSG00000151461","ENSG00000151461","UPF2","10",11920022,12043170,123148
"10493","ENSG00000169062","ENSG00000169062","UPF3A","13",114281601,114305817,24216
"10494","ENSG00000125351","ENSG00000125351","UPF3B","X",119834022,119852998,18976
"10495","ENSG00000105668","ENSG00000105668","UPK1A","19",35666517,35678481,11964
"10496","ENSG00000114638","ENSG00000114638","UPK1B","3",119173517,119205143,31626
"10497","ENSG00000110375","ENSG00000110375","UPK2","11",118925164,118958559,33395
"10498","ENSG00000100373","ENSG00000100373","UPK3A","22",45284949,45295874,10925
"10499","ENSG00000183696","ENSG00000183696","UPP1","7",48088628,48108736,20108
"10500","ENSG00000101019","ENSG00000101019","UQCC1","20",35302566,35412031,109465
"10501","ENSG00000184076","ENSG00000184076","UQCR10","22",29767369,29770413,3044
"10502","ENSG00000127540","ENSG00000127540","UQCR11","19",1597169,1605473,8304
"10503","ENSG00000156467","ENSG00000156467","UQCRB","8",96222947,96235546,12599
"10504","ENSG00000010256","ENSG00000010256","UQCRC1","3",48599002,48610976,11974
"10505","ENSG00000140740","ENSG00000140740","UQCRC2","16",21953288,21983660,30372
"10506","ENSG00000169021","ENSG00000169021","UQCRFS1","19",29205320,29213151,7831
"10507","ENSG00000173660","ENSG00000173660","UQCRH","1",46303698,46316776,13078
"10508","ENSG00000164405","ENSG00000164405","UQCRQ","5",132866630,132868847,2217
"10509","ENSG00000142207","ENSG00000142207","URB1","21",32311018,32393012,81994
"10510","ENSG00000135763","ENSG00000135763","URB2","1",229626247,229660200,33953
"10511","ENSG00000106608","ENSG00000106608","URGCP","7",43875894,43926411,50517
"10512","ENSG00000105176","ENSG00000105176","URI1","19",29923644,30016612,92968
"10513","ENSG00000167118","ENSG00000167118","URM1","9",128371361,128392016,20655
"10514","ENSG00000126088","ENSG00000126088","UROD","1",45010950,45015575,4625
"10515","ENSG00000188690","ENSG00000188690","UROS","10",125784980,125823288,38308
"10516","ENSG00000103005","ENSG00000103005","USB1","16",57999546,58021618,22072
"10517","ENSG00000053501","ENSG00000053501","USE1","19",17215346,17219829,4483
"10518","ENSG00000105698","ENSG00000105698","USF2","19",35268962,35279821,10859
"10519","ENSG00000006611","ENSG00000006611","USH1C","11",17493895,17544416,50521
"10520","ENSG00000042781","ENSG00000042781","USH2A","1",215622891,216423448,800557
"10521","ENSG00000138768","ENSG00000138768","USO1","4",75724577,75814286,89709
"10522","ENSG00000162607","ENSG00000162607","USP1","1",62436297,62451804,15507
"10523","ENSG00000103194","ENSG00000103194","USP10","16",84699986,84779922,79936
"10524","ENSG00000102226","ENSG00000102226","USP11","X",47232866,47248328,15462
"10525","ENSG00000152484","ENSG00000152484","USP12","13",27066156,27171811,105655
"10526","ENSG00000058056","ENSG00000058056","USP13","3",179653032,179804366,151334
"10527","ENSG00000101557","ENSG00000101557","USP14","18",158383,214629,56246
"10528","ENSG00000135655","ENSG00000135655","USP15","12",62260338,62417431,157093
"10529","ENSG00000156256","ENSG00000156256","USP16","21",29024629,29054488,29859
"10530","ENSG00000184979","ENSG00000184979","USP18","22",18149843,18177397,27554
"10531","ENSG00000172046","ENSG00000172046","USP19","3",49108046,49120938,12892
"10532","ENSG00000036672","ENSG00000036672","USP2","11",119355215,119381711,26496
"10533","ENSG00000136878","ENSG00000136878","USP20","9",129834698,129881828,47130
"10534","ENSG00000143258","ENSG00000143258","USP21","1",161159450,161165723,6273
"10535","ENSG00000124422","ENSG00000124422","USP22","17",20999596,21043760,44164
"10536","ENSG00000162402","ENSG00000162402","USP24","1",55066359,55215378,149019
"10537","ENSG00000155313","ENSG00000155313","USP25","21",15729982,15880064,150082
"10538","ENSG00000131864","ENSG00000131864","USP29","19",57119138,57131926,12788
"10539","ENSG00000140455","ENSG00000140455","USP3","15",63504511,63594640,90129
"10540","ENSG00000170832","ENSG00000170832","USP32","17",60177327,60422470,245143
"10541","ENSG00000077254","ENSG00000077254","USP33","1",77695987,77759852,63865
"10542","ENSG00000168883","ENSG00000168883","USP39","2",85602856,85649283,46427
"10543","ENSG00000114316","ENSG00000114316","USP4","3",49277144,49340712,63568
"10544","ENSG00000109189","ENSG00000109189","USP46","4",52590960,52659301,68341
"10545","ENSG00000170242","ENSG00000170242","USP47","11",11841423,11961887,120464
"10546","ENSG00000090686","ENSG00000090686","USP48","1",21678298,21783606,105308
"10547","ENSG00000164663","ENSG00000164663","USP49","6",41789896,41895375,105479
"10548","ENSG00000111667","ENSG00000111667","USP5","12",6852148,6866632,14484
"10549","ENSG00000145390","ENSG00000145390","USP53","4",119212587,119295518,82931
"10550","ENSG00000148429","ENSG00000148429","USP6NL","10",11460510,11611666,151156
"10551","ENSG00000187555","ENSG00000187555","USP7","16",8892097,8975328,83231
"10552","ENSG00000138592","ENSG00000138592","USP8","15",50424380,50514421,90041
"10553","ENSG00000124486","ENSG00000124486","USP9X","X",41085445,41236579,151134
"10554","ENSG00000114374","ENSG00000114374","USP9Y","Y",12537650,12860839,323189
"10555","ENSG00000132952","ENSG00000132952","USPL1","13",30617693,30660770,43077
"10556","ENSG00000111962","ENSG00000111962","UST","6",148747030,149076990,329960
"10557","ENSG00000183520","ENSG00000183520","UTP11","1",38009258,38024820,15562
"10558","ENSG00000253797","ENSG00000253797","UTP14C","13",52024691,52033600,8909
"10559","ENSG00000011260","ENSG00000011260","UTP18","17",51260546,51297936,37390
"10560","ENSG00000120800","ENSG00000120800","UTP20","12",101280105,101386618,106513
"10561","ENSG00000132467","ENSG00000132467","UTP3","4",70688532,70690551,2019
"10562","ENSG00000108651","ENSG00000108651","UTP6","17",31860904,31901708,40804
"10563","ENSG00000152818","ENSG00000152818","UTRN","6",144285335,144853034,567699
"10564","ENSG00000049247","ENSG00000049247","UTS2","1",7843083,7853512,10429
"10565","ENSG00000183878","ENSG00000183878","UTY","Y",13234577,13480673,246096
"10566","ENSG00000198382","ENSG00000198382","UVRAG","11",75815210,76144232,329022
"10567","ENSG00000115652","ENSG00000115652","UXS1","2",106093308,106194301,100993
"10568","ENSG00000126756","ENSG00000126756","UXT","X",47651796,47659180,7384
"10569","ENSG00000103043","ENSG00000103043","VAC14","16",70687439,70801160,113721
"10570","ENSG00000139190","ENSG00000139190","VAMP1","12",6462237,6470677,8440
"10571","ENSG00000220205","ENSG00000220205","VAMP2","17",8159149,8163546,4397
"10572","ENSG00000049245","ENSG00000049245","VAMP3","1",7771296,7781432,10136
"10573","ENSG00000117533","ENSG00000117533","VAMP4","1",171700160,171742074,41914
"10574","ENSG00000168899","ENSG00000168899","VAMP5","2",85584431,85593406,8975
"10575","ENSG00000124333","ENSG00000124333","VAMP7","X",155881345,155943769,62424
"10576","ENSG00000118640","ENSG00000118640","VAMP8","2",85561562,85582031,20469
"10577","ENSG00000173218","ENSG00000173218","VANGL1","1",115641970,115698224,56254
"10578","ENSG00000101558","ENSG00000101558","VAPA","18",9914016,9960021,46005
"10579","ENSG00000124164","ENSG00000124164","VAPB","20",58389229,58451101,61872
"10580","ENSG00000071246","ENSG00000071246","VASH1","14",76761468,76783015,21547
"10581","ENSG00000143494","ENSG00000143494","VASH2","1",212950520,212992037,41517
"10582","ENSG00000125753","ENSG00000125753","VASP","19",45506579,45526989,20410
"10583","ENSG00000108828","ENSG00000108828","VAT1","17",43014607,43025123,10516
"10584","ENSG00000141968","ENSG00000141968","VAV1","19",6772708,6857366,84658
"10585","ENSG00000160293","ENSG00000160293","VAV2","9",133761894,133992604,230710
"10586","ENSG00000134215","ENSG00000134215","VAV3","1",107571161,107965180,394019
"10587","ENSG00000116035","ENSG00000116035","VAX2","2",70900576,70965373,64797
"10588","ENSG00000155959","ENSG00000155959","VBP1","X",155197007,155239841,42834
"10589","ENSG00000162692","ENSG00000162692","VCAM1","1",100719742,100739045,19303
"10590","ENSG00000038427","ENSG00000038427","VCAN","5",83471618,83582303,110685
"10591","ENSG00000035403","ENSG00000035403","VCL","10",73995193,74121363,126170
"10592","ENSG00000165280","ENSG00000165280","VCP","9",35053928,35072668,18740
"10593","ENSG00000175073","ENSG00000175073","VCPIP1","8",66628487,66667231,38744
"10594","ENSG00000100483","ENSG00000100483","VCPKMT","14",50108632,50116600,7968
"10595","ENSG00000213585","ENSG00000213585","VDAC1","5",133971871,134004975,33104
"10596","ENSG00000165637","ENSG00000165637","VDAC2","10",75210154,75231448,21294
"10597","ENSG00000078668","ENSG00000078668","VDAC3","8",42391624,42405937,14313
"10598","ENSG00000111424","ENSG00000111424","VDR","12",47841537,47943048,101511
"10599","ENSG00000112715","ENSG00000112715","VEGFA","6",43770184,43786487,16303
"10600","ENSG00000173511","ENSG00000173511","VEGFB","11",64234584,64239264,4680
"10601","ENSG00000150630","ENSG00000150630","VEGFC","4",176683538,176792922,109384
"10602","ENSG00000165197","ENSG00000165197","VEGFD","X",15345596,15384413,38817
"10603","ENSG00000151650","ENSG00000151650","VENTX","10",133237855,133241928,4073
"10604","ENSG00000136451","ENSG00000136451","VEZF1","17",57971547,57988259,16712
"10605","ENSG00000028203","ENSG00000028203","VEZT","12",95217746,95302799,85053
"10606","ENSG00000128564","ENSG00000128564","VGF","7",101162509,101165569,3060
"10607","ENSG00000102243","ENSG00000102243","VGLL1","X",136532215,136556807,24592
"10608","ENSG00000206538","ENSG00000206538","VGLL3","3",86876388,86991149,114761
"10609","ENSG00000144560","ENSG00000144560","VGLL4","3",11556069,11771350,215281
"10610","ENSG00000134086","ENSG00000134086","VHL","3",10141778,10153667,11889
"10611","ENSG00000127831","ENSG00000127831","VIL1","2",218419121,218453295,34174
"10612","ENSG00000136059","ENSG00000136059","VILL","3",37988059,38007188,19129
"10613","ENSG00000026025","ENSG00000026025","VIM","10",17228241,17237593,9352
"10614","ENSG00000146469","ENSG00000146469","VIP","6",152750797,152759765,8968
"10615","ENSG00000151445","ENSG00000151445","VIPAS39","14",77426675,77457952,31277
"10616","ENSG00000114812","ENSG00000114812","VIPR1","3",42489299,42537573,48274
"10617","ENSG00000106018","ENSG00000106018","VIPR2","7",159028175,159144867,116692
"10618","ENSG00000167397","ENSG00000167397","VKORC1","16",31090842,31095980,5138
"10619","ENSG00000147852","ENSG00000147852","VLDLR","9",2621182,2660056,38874
"10620","ENSG00000062716","ENSG00000062716","VMP1","17",59707192,59842255,135063
"10621","ENSG00000178201","ENSG00000178201","VN1R1","19",57454790,57457140,2350
"10622","ENSG00000112299","ENSG00000112299","VNN1","6",132680849,132714055,33206
"10623","ENSG00000112303","ENSG00000112303","VNN2","6",132743870,132763459,19589
"10624","ENSG00000154978","ENSG00000154978","VOPP1","7",55436056,55572988,136932
"10625","ENSG00000169575","ENSG00000169575","VPREB1","22",22244780,22245515,735
"10626","ENSG00000128218","ENSG00000128218","VPREB3","22",23752743,23754425,1682
"10627","ENSG00000160695","ENSG00000160695","VPS11","11",119067818,119081972,14154
"10628","ENSG00000197969","ENSG00000197969","VPS13A","9",77177445,77421537,244092
"10629","ENSG00000132549","ENSG00000132549","VPS13B","8",99013266,99877580,864314
"10630","ENSG00000129003","ENSG00000129003","VPS13C","15",61852389,62060473,208084
"10631","ENSG00000048707","ENSG00000048707","VPS13D","1",12230030,12512047,282017
"10632","ENSG00000215305","ENSG00000215305","VPS16","20",2840703,2866732,26029
"10633","ENSG00000122958","ENSG00000122958","VPS26A","10",69123512,69174412,50900
"10634","ENSG00000160948","ENSG00000160948","VPS28","8",144423601,144428563,4962
"10635","ENSG00000139719","ENSG00000139719","VPS33A","12",122229564,122266502,36938
"10636","ENSG00000184056","ENSG00000184056","VPS33B","15",90998673,91022603,23930
"10637","ENSG00000069329","ENSG00000069329","VPS35","16",46656132,46689518,33386
"10638","ENSG00000139722","ENSG00000139722","VPS37B","12",122865330,122896127,30797
"10639","ENSG00000167987","ENSG00000167987","VPS37C","11",61130257,61161615,31358
"10640","ENSG00000166887","ENSG00000166887","VPS39","15",42158701,42208307,49606
"10641","ENSG00000006715","ENSG00000006715","VPS41","7",38722974,38932394,209420
"10642","ENSG00000136631","ENSG00000136631","VPS45","1",150067279,150145329,78050
"10643","ENSG00000132612","ENSG00000132612","VPS4A","16",69311336,69326939,15603
"10644","ENSG00000119541","ENSG00000119541","VPS4B","18",63389190,63422483,33293
"10645","ENSG00000004766","ENSG00000004766","VPS50","7",93232340,93361123,128783
"10646","ENSG00000149823","ENSG00000149823","VPS51","11",65089324,65111862,22538
"10647","ENSG00000236014","ENSG00000236014","VPS52","HSCHR6_MHC_SSTO_CTG1",4698976,4720728,21752
"10648","ENSG00000141252","ENSG00000141252","VPS53","17",508503,721717,213214
"10649","ENSG00000143952","ENSG00000143952","VPS54","2",63892146,64019428,127282
"10650","ENSG00000163159","ENSG00000163159","VPS72","1",151176304,151195321,19017
"10651","ENSG00000156931","ENSG00000156931","VPS8","3",184812143,185052614,240471
"10652","ENSG00000075399","ENSG00000075399","VPS9D1","16",89707134,89720898,13764
"10653","ENSG00000100749","ENSG00000100749","VRK1","14",96797304,96954846,157542
"10654","ENSG00000028116","ENSG00000028116","VRK2","2",57907629,58159920,252291
"10655","ENSG00000105053","ENSG00000105053","VRK3","19",49976468,50025946,49478
"10656","ENSG00000133980","ENSG00000133980","VRTN","14",74303069,74360008,56939
"10657","ENSG00000176834","ENSG00000176834","VSIG10","12",118063593,118136026,72433
"10658","ENSG00000155659","ENSG00000155659","VSIG4","X",66021738,66040125,18387
"10659","ENSG00000163032","ENSG00000163032","VSNL1","2",17539126,17657018,117892
"10660","ENSG00000165633","ENSG00000165633","VSTM4","10",49014236,49115522,101286
"10661","ENSG00000100987","ENSG00000100987","VSX1","20",25070885,25082141,11256
"10662","ENSG00000134258","ENSG00000134258","VTCN1","1",117143587,117210960,67373
"10663","ENSG00000100568","ENSG00000100568","VTI1B","14",67647085,67674820,27735
"10664","ENSG00000109072","ENSG00000109072","VTN","17",28367284,28373091,5807
"10665","ENSG00000179403","ENSG00000179403","VWA1","1",1434861,1442882,8021
"10666","ENSG00000110002","ENSG00000110002","VWA5A","11",124115404,124147721,32317
"10667","ENSG00000238203","ENSG00000238203","VWA7","HSCHR6_MHC_APD_CTG1",3098202,3109905,11703
"10668","ENSG00000102763","ENSG00000102763","VWA8","13",41566835,41961120,394285
"10669","ENSG00000110799","ENSG00000110799","VWF","12",5948877,6124770,175893
"10670","ENSG00000095787","ENSG00000095787","WAC","10",28532493,28623112,90619
"10671","ENSG00000062650","ENSG00000062650","WAPL","10",86435256,86521792,86536
"10672","ENSG00000116874","ENSG00000116874","WARS2","1",119031216,119140654,109438
"10673","ENSG00000015285","ENSG00000015285","WAS","X",48676596,48691431,14835
"10674","ENSG00000112290","ENSG00000112290","WASF1","6",110099819,110180004,80185
"10675","ENSG00000158195","ENSG00000158195","WASF2","1",27404230,27490167,85937
"10676","ENSG00000132970","ENSG00000132970","WASF3","13",26557683,26688948,131265
"10677","ENSG00000106299","ENSG00000106299","WASL","7",123681943,123749003,67060
"10678","ENSG00000084463","ENSG00000084463","WBP11","12",14784582,14803486,18904
"10679","ENSG00000166272","ENSG00000166272","WBP1L","10",102743948,102834516,90568
"10680","ENSG00000132471","ENSG00000132471","WBP2","17",75845699,75856507,10808
"10681","ENSG00000120688","ENSG00000120688","WBP4","13",41061509,41084006,22497
"10682","ENSG00000163026","ENSG00000163026","WDCP","2",24029347,24049575,20228
"10683","ENSG00000163625","ENSG00000163625","WDFY3","4",84668765,84966690,297925
"10684","ENSG00000198554","ENSG00000198554","WDHD1","14",54938949,55027105,88156
"10685","ENSG00000071127","ENSG00000071127","WDR1","4",10068089,10116972,48883
"10686","ENSG00000120008","ENSG00000120008","WDR11","10",120851305,120909524,58219
"10687","ENSG00000138442","ENSG00000138442","WDR12","2",202874261,203014798,140537
"10688","ENSG00000101940","ENSG00000101940","WDR13","X",48590042,48608869,18827
"10689","ENSG00000065268","ENSG00000065268","WDR18","19",984332,998438,14106
"10690","ENSG00000157796","ENSG00000157796","WDR19","4",39182504,39285810,103306
"10691","ENSG00000176473","ENSG00000176473","WDR25","14",100376418,100530303,153885
"10692","ENSG00000162923","ENSG00000162923","WDR26","1",224385146,224437033,51887
"10693","ENSG00000065183","ENSG00000065183","WDR3","1",117929720,117966543,36823
"10694","ENSG00000136709","ENSG00000136709","WDR33","2",127701027,127811187,110160
"10695","ENSG00000047056","ENSG00000047056","WDR37","10",1049538,1160991,111453
"10696","ENSG00000160193","ENSG00000160193","WDR4","21",42843094,42879568,36474
"10697","ENSG00000164253","ENSG00000164253","WDR41","5",77425970,77620611,194641
"10698","ENSG00000131725","ENSG00000131725","WDR44","X",118346073,118449961,103888
"10699","ENSG00000196998","ENSG00000196998","WDR45","X",49074433,49101170,26737
"10700","ENSG00000141580","ENSG00000141580","WDR45B","17",82614562,82648553,33991
"10701","ENSG00000236222","ENSG00000236222","WDR46","HSCHR6_MHC_MCF_CTG1",4715074,4725463,10389
"10702","ENSG00000085433","ENSG00000085433","WDR47","1",108970214,109042113,71899
"10703","ENSG00000114742","ENSG00000114742","WDR48","3",39052013,39096671,44658
"10704","ENSG00000120314","ENSG00000120314","WDR55","5",140664868,140674124,9256
"10705","ENSG00000103091","ENSG00000103091","WDR59","16",74871362,75000173,128811
"10706","ENSG00000196981","ENSG00000196981","WDR5B","3",122411846,122416062,4216
"10707","ENSG00000178252","ENSG00000178252","WDR6","3",49007062,49015953,8891
"10708","ENSG00000075702","ENSG00000075702","WDR62","19",36054649,36105108,50459
"10709","ENSG00000091157","ENSG00000091157","WDR7","18",56651343,57029811,378468
"10710","ENSG00000082068","ENSG00000082068","WDR70","5",37379285,37753435,374150
"10711","ENSG00000177082","ENSG00000177082","WDR73","15",84639285,84654343,15058
"10712","ENSG00000133316","ENSG00000133316","WDR74","11",62832342,62841809,9467
"10713","ENSG00000092470","ENSG00000092470","WDR76","15",43826980,43868412,41432
"10714","ENSG00000116455","ENSG00000116455","WDR77","1",111439890,111449256,9366
"10715","ENSG00000164091","ENSG00000164091","WDR82","3",52254434,52288020,33586
"10716","ENSG00000105583","ENSG00000105583","WDR83OS","19",12668073,12669415,1342
"10717","ENSG00000105875","ENSG00000105875","WDR91","7",135183839,135211555,27716
"10718","ENSG00000142784","ENSG00000142784","WDTC1","1",27234632,27308636,74004
"10719","ENSG00000166483","ENSG00000166483","WEE1","11",9573670,9593457,19787
"10720","ENSG00000103175","ENSG00000103175","WFDC1","16",84294846,84329844,34998
"10721","ENSG00000101443","ENSG00000101443","WFDC2","20",45469753,45481532,11779
"10722","ENSG00000109501","ENSG00000109501","WFS1","4",6269849,6303265,33416
"10723","ENSG00000095397","ENSG00000095397","WHRN","9",114402080,114505473,103393
"10724","ENSG00000156076","ENSG00000156076","WIF1","12",65050626,65121305,70679
"10725","ENSG00000115935","ENSG00000115935","WIPF1","2",174559572,174682916,123344
"10726","ENSG00000171475","ENSG00000171475","WIPF2","17",40219304,40284136,64832
"10727","ENSG00000070540","ENSG00000070540","WIPI1","17",68420948,68457513,36565
"10728","ENSG00000157954","ENSG00000157954","WIPI2","7",5190196,5233840,43644
"10729","ENSG00000011451","ENSG00000011451","WIZ","19",15419978,15449956,29978
"10730","ENSG00000116729","ENSG00000116729","WLS","1",68098473,68233120,134647
"10731","ENSG00000060237","ENSG00000060237","WNK1","12",752579,911452,158873
"10732","ENSG00000125084","ENSG00000125084","WNT1","12",48978322,48982620,4298
"10733","ENSG00000169884","ENSG00000169884","WNT10B","12",48965340,48971735,6395
"10734","ENSG00000085741","ENSG00000085741","WNT11","11",76186325,76210736,24411
"10735","ENSG00000105989","ENSG00000105989","WNT2","7",117275451,117323152,47701
"10736","ENSG00000134245","ENSG00000134245","WNT2B","1",112466541,112530165,63624
"10737","ENSG00000277641","ENSG00000277641","WNT3","HSCHR17_2_CTG5",1281918,1352577,70659
"10738","ENSG00000162552","ENSG00000162552","WNT4","1",22117313,22143969,26656
"10739","ENSG00000114251","ENSG00000114251","WNT5A","3",55465715,55490539,24824
"10740","ENSG00000111186","ENSG00000111186","WNT5B","12",1529891,1647212,117321
"10741","ENSG00000115596","ENSG00000115596","WNT6","2",218859805,218874233,14428
"10742","ENSG00000154764","ENSG00000154764","WNT7A","3",13816258,13880071,63813
"10743","ENSG00000075290","ENSG00000075290","WNT8B","10",100463009,100483744,20735
"10744","ENSG00000141499","ENSG00000141499","WRAP53","17",7686071,7703502,17431
"10745","ENSG00000116213","ENSG00000116213","WRAP73","1",3630767,3652761,21994
"10746","ENSG00000165392","ENSG00000165392","WRN","8",31033788,31176138,142350
"10747","ENSG00000109046","ENSG00000109046","WSB1","17",27294076,27315926,21850
"10748","ENSG00000176871","ENSG00000176871","WSB2","12",118032687,118062430,29743
"10749","ENSG00000179314","ENSG00000179314","WSCD1","17",6057807,6124427,66620
"10750","ENSG00000075035","ENSG00000075035","WSCD2","12",108129288,108250537,121249
"10751","ENSG00000184937","ENSG00000184937","WT1","11",32387775,32435564,47789
"10752","ENSG00000146457","ENSG00000146457","WTAP","6",159725585,159756319,30734
"10753","ENSG00000113645","ENSG00000113645","WWC1","5",168291645,168472303,180658
"10754","ENSG00000151718","ENSG00000151718","WWC2","4",183099257,183320777,221520
"10755","ENSG00000047644","ENSG00000047644","WWC3","X",10015254,10144474,129220
"10756","ENSG00000186153","ENSG00000186153","WWOX","16",78099400,79212667,1113267
"10757","ENSG00000123124","ENSG00000123124","WWP1","8",86342547,86478420,135873
"10758","ENSG00000198373","ENSG00000198373","WWP2","16",69762328,69941741,179413
"10759","ENSG00000018408","ENSG00000018408","WWTR1","3",149517235,149736714,219479
"10760","ENSG00000076924","ENSG00000076924","XAB2","19",7619525,7629545,10020
"10761","ENSG00000132530","ENSG00000132530","XAF1","17",6755447,6775647,20200
"10762","ENSG00000204382","ENSG00000204382","XAGE1B","X",52512077,52520803,8726
"10763","ENSG00000100219","ENSG00000100219","XBP1","22",28794555,28800597,6042
"10764","ENSG00000143184","ENSG00000143184","XCL1","1",168576605,168582069,5464
"10765","ENSG00000143185","ENSG00000143185","XCL2","1",168540768,168543997,3229
"10766","ENSG00000173578","ENSG00000173578","XCR1","3",46016990,46085825,68835
"10767","ENSG00000158125","ENSG00000158125","XDH","2",31334321,31414742,80421
"10768","ENSG00000047597","ENSG00000047597","XK","X",37685791,37732130,46339
"10769","ENSG00000158156","ENSG00000158156","XKR8","1",27959588,27968093,8505
"10770","ENSG00000136936","ENSG00000136936","XPA","9",97674909,97697340,22431
"10771","ENSG00000154767","ENSG00000154767","XPC","3",14145147,14178621,33474
"10772","ENSG00000108039","ENSG00000108039","XPNPEP1","10",109864766,109923553,58787
"10773","ENSG00000122121","ENSG00000122121","XPNPEP2","X",129738949,129769536,30587
"10774","ENSG00000196236","ENSG00000196236","XPNPEP3","22",40857077,40932815,75738
"10775","ENSG00000082898","ENSG00000082898","XPO1","2",61476032,61538741,62709
"10776","ENSG00000132953","ENSG00000132953","XPO4","13",20777329,20903048,125719
"10777","ENSG00000169180","ENSG00000169180","XPO6","16",28097976,28211965,113989
"10778","ENSG00000130227","ENSG00000130227","XPO7","8",21919662,22006585,86923
"10779","ENSG00000184575","ENSG00000184575","XPOT","12",64404392,64451125,46733
"10780","ENSG00000073050","ENSG00000073050","XRCC1","19",43543311,43580473,37162
"10781","ENSG00000196584","ENSG00000196584","XRCC2","7",152644776,152676193,31417
"10782","ENSG00000126215","ENSG00000126215","XRCC3","14",103697609,103715504,17895
"10783","ENSG00000152422","ENSG00000152422","XRCC4","5",83077498,83353787,276289
"10784","ENSG00000079246","ENSG00000079246","XRCC5","2",216107464,216206303,98839
"10785","ENSG00000196419","ENSG00000196419","XRCC6","22",41621163,41664048,42885
"10786","ENSG00000093217","ENSG00000093217","XYLB","3",38346760,38421348,74588
"10787","ENSG00000103489","ENSG00000103489","XYLT1","16",17101769,17470960,369191
"10788","ENSG00000015532","ENSG00000015532","XYLT2","17",50346126,50363138,17012
"10789","ENSG00000015153","ENSG00000015153","YAF2","12",42157104,42238349,81245
"10790","ENSG00000137693","ENSG00000137693","YAP1","11",102110447,102233424,122977
"10791","ENSG00000139131","ENSG00000139131","YARS2","12",32727490,32755897,28407
"10792","ENSG00000065978","ENSG00000065978","YBX1","1",42682418,42703805,21387
"10793","ENSG00000006047","ENSG00000006047","YBX2","17",7288263,7294639,6376
"10794","ENSG00000060138","ENSG00000060138","YBX3","12",10699089,10723323,24234
"10795","ENSG00000163872","ENSG00000163872","YEATS2","3",183697797,183812624,114827
"10796","ENSG00000127337","ENSG00000127337","YEATS4","12",69359710,69390870,31160
"10797","ENSG00000176105","ENSG00000176105","YES1","18",721588,812546,90958
"10798","ENSG00000174851","ENSG00000174851","YIF1A","11",66284572,66289184,4612
"10799","ENSG00000167645","ENSG00000167645","YIF1B","19",38303558,38317273,13715
"10800","ENSG00000058799","ENSG00000058799","YIPF1","1",53851719,53889798,38079
"10801","ENSG00000130733","ENSG00000130733","YIPF2","19",10922185,10928681,6496
"10802","ENSG00000137207","ENSG00000137207","YIPF3","6",43511832,43516985,5153
"10803","ENSG00000119820","ENSG00000119820","YIPF4","2",32277904,32316594,38690
"10804","ENSG00000145817","ENSG00000145817","YIPF5","5",144158162,144170714,12552
"10805","ENSG00000181704","ENSG00000181704","YIPF6","X",68498562,68537282,38720
"10806","ENSG00000106636","ENSG00000106636","YKT6","7",44200959,44214294,13335
"10807","ENSG00000119596","ENSG00000119596","YLPM1","14",74763316,74859435,96119
"10808","ENSG00000136758","ENSG00000136758","YME1L1","10",27110111,27155266,45155
"10809","ENSG00000180667","ENSG00000180667","YOD1","1",207043849,207052980,9131
"10810","ENSG00000100027","ENSG00000100027","YPEL1","22",21697536,21735794,38258
"10811","ENSG00000119801","ENSG00000119801","YPEL5","2",30146941,30160533,13592
"10812","ENSG00000196449","ENSG00000196449","YRDC","1",37802945,37808208,5263
"10813","ENSG00000275272","ENSG00000275272","YTHDC1","HSCHR4_1_CTG9",4029,43731,39702
"10814","ENSG00000047188","ENSG00000047188","YTHDC2","5",113513694,113595285,81591
"10815","ENSG00000149658","ENSG00000149658","YTHDF1","20",63195429,63216139,20710
"10816","ENSG00000198492","ENSG00000198492","YTHDF2","1",28736621,28769775,33154
"10817","ENSG00000185728","ENSG00000185728","YTHDF3","8",63168553,63212786,44233
"10818","ENSG00000166913","ENSG00000166913","YWHAB","20",44885702,44908532,22830
"10819","ENSG00000274474","ENSG00000274474","YWHAE","HSCHR17_2_CTG2",286301,342404,56103
"10820","ENSG00000128245","ENSG00000128245","YWHAH","22",31944522,31957603,13081
"10821","ENSG00000134308","ENSG00000134308","YWHAQ","2",9583967,9630997,47030
"10822","ENSG00000164924","ENSG00000164924","YWHAZ","8",100916523,100953388,36865
"10823","ENSG00000100811","ENSG00000100811","YY1","14",100238298,100282788,44490
"10824","ENSG00000163374","ENSG00000163374","YY1AP1","1",155659446,155689334,29888
"10825","ENSG00000115085","ENSG00000115085","ZAP70","2",97713576,97739862,26286
"10826","ENSG00000169064","ENSG00000169064","ZBBX","3",167239843,167407874,168031
"10827","ENSG00000214717","ENSG00000214717","ZBED1","X",2486414,2500976,14562
"10828","ENSG00000177494","ENSG00000177494","ZBED2","3",111592900,111595346,2446
"10829","ENSG00000100426","ENSG00000100426","ZBED4","22",49853844,49890080,36236
"10830","ENSG00000236287","ENSG00000236287","ZBED5","11",10812074,10858796,46722
"10831","ENSG00000126804","ENSG00000126804","ZBTB1","14",64503712,64533690,29978
"10832","ENSG00000205189","ENSG00000205189","ZBTB10","8",80485619,80526265,40646
"10833","ENSG00000066422","ENSG00000066422","ZBTB11","3",101648889,101677135,28246
"10834","ENSG00000198081","ENSG00000198081","ZBTB14","18",5289019,5297053,8034
"10835","ENSG00000109906","ENSG00000109906","ZBTB16","11",114059041,114256765,197724
"10836","ENSG00000116809","ENSG00000116809","ZBTB17","1",15941869,15976132,34263
"10837","ENSG00000179456","ENSG00000179456","ZBTB18","1",244048547,244057476,8929
"10838","ENSG00000181722","ENSG00000181722","ZBTB20","3",114314500,115147292,832792
"10839","ENSG00000237056","ENSG00000237056","ZBTB22","HSCHR6_MHC_MCF_CTG1",4750352,4753876,3524
"10840","ENSG00000112365","ENSG00000112365","ZBTB24","6",109460632,109483239,22607
"10841","ENSG00000089775","ENSG00000089775","ZBTB25","14",64449106,64505213,56107
"10842","ENSG00000011590","ENSG00000011590","ZBTB32","19",35704558,35717038,12480
"10843","ENSG00000177485","ENSG00000177485","ZBTB33","X",120250752,120258398,7646
"10844","ENSG00000177311","ENSG00000177311","ZBTB38","3",141324213,141449792,125579
"10845","ENSG00000166860","ENSG00000166860","ZBTB39","12",56998836,57006546,7710
"10846","ENSG00000184677","ENSG00000184677","ZBTB40","1",22428838,22531157,102319
"10847","ENSG00000169155","ENSG00000169155","ZBTB43","9",126805006,126838210,33204
"10848","ENSG00000196323","ENSG00000196323","ZBTB44","11",130226677,130314917,88240
"10849","ENSG00000204859","ENSG00000204859","ZBTB48","1",6579994,6589280,9286
"10850","ENSG00000168795","ENSG00000168795","ZBTB5","9",37438102,37465450,27348
"10851","ENSG00000186130","ENSG00000186130","ZBTB6","9",122908056,122913323,5267
"10852","ENSG00000178951","ENSG00000178951","ZBTB7A","19",4043303,4066899,23596
"10853","ENSG00000184828","ENSG00000184828","ZBTB7C","18",48026672,48410752,384080
"10854","ENSG00000104427","ENSG00000104427","ZC2HC1A","8",78666050,78719765,53715
"10855","ENSG00000119703","ENSG00000119703","ZC2HC1C","14",75064109,75119502,55393
"10856","ENSG00000058673","ENSG00000058673","ZC3H11A","1",203795623,203854999,59376
"10857","ENSG00000163874","ENSG00000163874","ZC3H12A","1",37474580,37484377,9797
"10858","ENSG00000123200","ENSG00000123200","ZC3H13","13",45954465,46052759,98294
"10859","ENSG00000100722","ENSG00000100722","ZC3H14","14",88562970,88627596,64626
"10860","ENSG00000065548","ENSG00000065548","ZC3H15","2",186486253,186509361,23108
"10861","ENSG00000014164","ENSG00000014164","ZC3H3","8",143437659,143541447,103788
"10862","ENSG00000130749","ENSG00000130749","ZC3H4","19",47064187,47113776,49589
"10863","ENSG00000122299","ENSG00000122299","ZC3H7A","16",11750586,11797258,46672
"10864","ENSG00000100403","ENSG00000100403","ZC3H7B","22",41301525,41360147,58622
"10865","ENSG00000105939","ENSG00000105939","ZC3HAV1","7",139043515,139132122,88607
"10866","ENSG00000126970","ENSG00000126970","ZC4H2","X",64915802,65034713,118911
"10867","ENSG00000155329","ENSG00000155329","ZCCHC10","5",132996985,133026604,29619
"10868","ENSG00000140948","ENSG00000140948","ZCCHC14","16",87406246,87493024,86778
"10869","ENSG00000141664","ENSG00000141664","ZCCHC2","18",62523025,62587709,64684
"10870","ENSG00000165424","ENSG00000165424","ZCCHC24","10",79382325,79445624,63299
"10871","ENSG00000168228","ENSG00000168228","ZCCHC4","4",25312774,25370383,57609
"10872","ENSG00000033030","ENSG00000033030","ZCCHC8","12",122471600,122500932,29332
"10873","ENSG00000078487","ENSG00000078487","ZCWPW1","7",100400826,100428992,28166
"10874","ENSG00000188818","ENSG00000188818","ZDHHC11","5",795605,858973,63368
"10875","ENSG00000177054","ENSG00000177054","ZDHHC13","11",19117099,19176422,59323
"10876","ENSG00000175048","ENSG00000175048","ZDHHC14","6",157381133,157678157,297024
"10877","ENSG00000186908","ENSG00000186908","ZDHHC17","12",76764103,76853696,89593
"10878","ENSG00000204160","ENSG00000204160","ZDHHC18","1",26826688,26857604,30916
"10879","ENSG00000174165","ENSG00000174165","ZDHHC24","11",66520637,66546235,25598
"10880","ENSG00000163812","ENSG00000163812","ZDHHC3","3",44915257,44976185,60928
"10881","ENSG00000136247","ENSG00000136247","ZDHHC4","7",6577434,6589374,11940
"10882","ENSG00000023041","ENSG00000023041","ZDHHC6","10",112424428,112447572,23144
"10883","ENSG00000153786","ENSG00000153786","ZDHHC7","16",84974175,85011535,37360
"10884","ENSG00000169554","ENSG00000169554","ZEB2","2",144364364,144521057,156693
"10885","ENSG00000160445","ENSG00000160445","ZER1","9",128729786,128772414,42628
"10886","ENSG00000104231","ENSG00000104231","ZFAND1","8",81701334,81732903,31569
"10887","ENSG00000156639","ENSG00000156639","ZFAND3","6",37819727,38154624,334897
"10888","ENSG00000107372","ENSG00000107372","ZFAND5","9",72351413,72365235,13822
"10889","ENSG00000086666","ENSG00000086666","ZFAND6","15",80059568,80138393,78825
"10890","ENSG00000133858","ENSG00000133858","ZFC3H1","12",71609599,71667725,58126
"10891","ENSG00000140836","ENSG00000140836","ZFHX3","16",72782885,73891871,1108986
"10892","ENSG00000091656","ENSG00000091656","ZFHX4","8",76681239,76867281,186042
"10893","ENSG00000198939","ENSG00000198939","ZFP2","5",178895898,178933212,37314
"10894","ENSG00000120784","ENSG00000120784","ZFP30","19",37613749,37692337,78588
"10895","ENSG00000128016","ENSG00000128016","ZFP36","19",39406847,39409407,2560
"10896","ENSG00000185650","ENSG00000185650","ZFP36L1","14",68787660,68796253,8593
"10897","ENSG00000152518","ENSG00000152518","ZFP36L2","2",43222402,43226606,4204
"10898","ENSG00000136866","ENSG00000136866","ZFP37","9",113038377,113056759,18382
"10899","ENSG00000020256","ENSG00000020256","ZFP64","20",52051663,52204308,152645
"10900","ENSG00000187801","ENSG00000187801","ZFP69B","1",40450102,40463718,13616
"10901","ENSG00000162300","ENSG00000162300","ZFPL1","11",65084210,65088398,4188
"10902","ENSG00000169946","ENSG00000169946","ZFPM2","8",104590733,105804539,1213806
"10903","ENSG00000056097","ENSG00000056097","ZFR","5",32354350,32444740,90390
"10904","ENSG00000105278","ENSG00000105278","ZFR2","19",3804024,3869038,65014
"10905","ENSG00000005889","ENSG00000005889","ZFX","X",24149173,24216255,67082
"10906","ENSG00000039319","ENSG00000039319","ZFYVE16","5",80408013,80483379,75366
"10907","ENSG00000100711","ENSG00000100711","ZFYVE21","14",103715730,103733668,17938
"10908","ENSG00000072121","ENSG00000072121","ZFYVE26","14",67727374,67816590,89216
"10909","ENSG00000157077","ENSG00000157077","ZFYVE9","1",52142089,52348671,206582
"10910","ENSG00000174992","ENSG00000174992","ZG16","16",29778256,29782973,4717
"10911","ENSG00000197114","ENSG00000197114","ZGPAT","20",63707465,63736142,28677
"10912","ENSG00000178764","ENSG00000178764","ZHX2","8",122781655,122974510,192855
"10913","ENSG00000174306","ENSG00000174306","ZHX3","20",41178448,41317731,139283
"10914","ENSG00000156925","ENSG00000156925","ZIC3","X",137566127,137577691,11564
"10915","ENSG00000269699","ENSG00000269699","ZIM2","19",56774547,56840731,66184
"10916","ENSG00000106261","ENSG00000106261","ZKSCAN1","7",100015572,100041689,26117
"10917","ENSG00000189298","ENSG00000189298","ZKSCAN3","6",28349947,28369172,19225
"10918","ENSG00000187626","ENSG00000187626","ZKSCAN4","6",28241697,28252269,10572
"10919","ENSG00000196652","ENSG00000196652","ZKSCAN5","7",99504662,99534700,30038
"10920","ENSG00000281894","ENSG00000281894","ZKSCAN7","HG2066_PATCH",80547,119527,38980
"10921","ENSG00000198315","ENSG00000198315","ZKSCAN8","6",28141883,28159460,17577
"10922","ENSG00000172667","ENSG00000172667","ZMAT3","3",178960121,179072215,112094
"10923","ENSG00000165061","ENSG00000165061","ZMAT4","8",40530590,40897833,367243
"10924","ENSG00000100319","ENSG00000100319","ZMAT5","22",29730956,29767011,36055
"10925","ENSG00000108175","ENSG00000108175","ZMIZ1","10",79068966,79316519,247553
"10926","ENSG00000122515","ENSG00000122515","ZMIZ2","7",44748581,44769881,21300
"10927","ENSG00000084073","ENSG00000084073","ZMPSTE24","1",40258041,40294180,36139
"10928","ENSG00000197056","ENSG00000197056","ZMYM1","1",35032172,35115859,83687
"10929","ENSG00000121741","ENSG00000121741","ZMYM2","13",19958677,20091829,133152
"10930","ENSG00000147130","ENSG00000147130","ZMYM3","X",71239624,71255146,15522
"10931","ENSG00000146463","ENSG00000146463","ZMYM4","1",35268709,35422058,153349
"10932","ENSG00000132950","ENSG00000132950","ZMYM5","13",19823482,19863649,40167
"10933","ENSG00000163867","ENSG00000163867","ZMYM6","1",34986165,35031945,45780
"10934","ENSG00000004838","ENSG00000004838","ZMYND10","3",50341110,50345732,4622
"10935","ENSG00000015171","ENSG00000015171","ZMYND11","10",130088,254637,124549
"10936","ENSG00000101040","ENSG00000101040","ZMYND8","20",47209214,47356889,147675
"10937","ENSG00000256223","ENSG00000256223","ZNF10","12",133130575,133159465,28890
"10938","ENSG00000103994","ENSG00000103994","ZNF106","15",42412823,42491141,78318
"10939","ENSG00000196247","ENSG00000196247","ZNF107","7",64666099,64711577,45478
"10940","ENSG00000062370","ENSG00000062370","ZNF112","19",44326555,44367217,40662
"10941","ENSG00000152926","ENSG00000152926","ZNF117","7",64970663,65006687,36024
"10942","ENSG00000164631","ENSG00000164631","ZNF12","7",6688433,6706947,18514
"10943","ENSG00000196418","ENSG00000196418","ZNF124","1",247121975,247172020,50045
"10944","ENSG00000172262","ENSG00000172262","ZNF131","5",43065176,43192021,126845
"10945","ENSG00000131849","ENSG00000131849","ZNF132","19",58432814,58440153,7339
"10946","ENSG00000125846","ENSG00000125846","ZNF133","20",18288283,18316996,28713
"10947","ENSG00000213762","ENSG00000213762","ZNF134","19",57614233,57624724,10491
"10948","ENSG00000176293","ENSG00000176293","ZNF135","19",58059239,58086310,27071
"10949","ENSG00000196646","ENSG00000196646","ZNF136","19",12163064,12189871,26807
"10950","ENSG00000105708","ENSG00000105708","ZNF14","19",19710472,19733112,22640
"10951","ENSG00000196387","ENSG00000196387","ZNF140","12",133080474,133107526,27052
"10952","ENSG00000115568","ENSG00000115568","ZNF142","2",218633329,218659655,26326
"10953","ENSG00000166478","ENSG00000166478","ZNF143","11",9460319,9528524,68205
"10954","ENSG00000167635","ENSG00000167635","ZNF146","19",36214602,36238771,24169
"10955","ENSG00000163848","ENSG00000163848","ZNF148","3",125225669,125375325,149656
"10956","ENSG00000204920","ENSG00000204920","ZNF155","19",43967862,43998326,30464
"10957","ENSG00000147117","ENSG00000147117","ZNF157","X",47370578,47414498,43920
"10958","ENSG00000170631","ENSG00000170631","ZNF16","8",144930358,144950888,20530
"10959","ENSG00000170949","ENSG00000170949","ZNF160","19",53066606,53103434,36828
"10960","ENSG00000197279","ENSG00000197279","ZNF165","6",28080568,28089563,8995
"10961","ENSG00000103343","ENSG00000103343","ZNF174","16",3401215,3409364,8149
"10962","ENSG00000105497","ENSG00000105497","ZNF175","19",51571283,51592510,21227
"10963","ENSG00000188629","ENSG00000188629","ZNF177","19",9363013,9382617,19604
"10964","ENSG00000167384","ENSG00000167384","ZNF180","19",44474428,44500524,26096
"10965","ENSG00000096654","ENSG00000096654","ZNF184","6",27450743,27473118,22375
"10966","ENSG00000147394","ENSG00000147394","ZNF185","X",152898067,152973481,75414
"10967","ENSG00000136870","ENSG00000136870","ZNF189","9",101398851,101410660,11809
"10968","ENSG00000005801","ENSG00000005801","ZNF195","11",3339261,3379222,39961
"10969","ENSG00000281709","ENSG00000281709","ZNF197","HG2066_PATCH",110242,173825,63583
"10970","ENSG00000132010","ENSG00000132010","ZNF20","19",12092843,12140355,47512
"10971","ENSG00000010539","ENSG00000010539","ZNF200","16",3222325,3236221,13896
"10972","ENSG00000166261","ENSG00000166261","ZNF202","11",123723914,123741675,17761
"10973","ENSG00000122386","ENSG00000122386","ZNF205","16",3112560,3120517,7957
"10974","ENSG00000010244","ENSG00000010244","ZNF207","17",32350132,32381885,31753
"10975","ENSG00000121417","ENSG00000121417","ZNF211","19",57630395,57644041,13646
"10976","ENSG00000170260","ENSG00000170260","ZNF212","7",149239651,149255606,15955
"10977","ENSG00000149050","ENSG00000149050","ZNF214","11",6997085,7020346,23261
"10978","ENSG00000149054","ENSG00000149054","ZNF215","11",6926404,7001004,74600
"10979","ENSG00000171940","ENSG00000171940","ZNF217","20",53567071,53609907,42836
"10980","ENSG00000165804","ENSG00000165804","ZNF219","14",21090077,21104722,14645
"10981","ENSG00000165512","ENSG00000165512","ZNF22","10",45000923,45005326,4403
"10982","ENSG00000159885","ENSG00000159885","ZNF222","19",44025342,44033110,7768
"10983","ENSG00000178386","ENSG00000178386","ZNF223","19",44051367,44067999,16632
"10984","ENSG00000267680","ENSG00000267680","ZNF224","19",44094361,44109886,15525
"10985","ENSG00000256294","ENSG00000256294","ZNF225","19",44112181,44134822,22641
"10986","ENSG00000167380","ENSG00000167380","ZNF226","19",44165073,44178381,13308
"10987","ENSG00000131115","ENSG00000131115","ZNF227","19",44207547,44237268,29721
"10988","ENSG00000167377","ENSG00000167377","ZNF23","16",71447597,71463095,15498
"10989","ENSG00000159882","ENSG00000159882","ZNF230","19",44002957,44013924,10967
"10990","ENSG00000167840","ENSG00000167840","ZNF232","17",5105269,5123162,17893
"10991","ENSG00000159917","ENSG00000159917","ZNF235","19",44228729,44305046,76317
"10992","ENSG00000130856","ENSG00000130856","ZNF236","18",76822557,76972901,150344
"10993","ENSG00000196793","ENSG00000196793","ZNF239","10",43556344,43574618,18274
"10994","ENSG00000172466","ENSG00000172466","ZNF24","18",35332227,35345482,13255
"10995","ENSG00000198105","ENSG00000198105","ZNF248","10",37776526,37858106,81580
"10996","ENSG00000196150","ENSG00000196150","ZNF250","8",144876497,144902168,25671
"10997","ENSG00000256771","ENSG00000256771","ZNF253","19",19865882,19894674,28792
"10998","ENSG00000213096","ENSG00000213096","ZNF254","19",24033405,24129968,96563
"10999","ENSG00000197134","ENSG00000197134","ZNF257","19",22052430,22091480,39050
"11000","ENSG00000198393","ENSG00000198393","ZNF26","12",132986365,133032952,46587
"11001","ENSG00000006194","ENSG00000006194","ZNF263","16",3283283,3301401,18118
"11002","ENSG00000083844","ENSG00000083844","ZNF264","19",57191500,57222846,31346
"11003","ENSG00000174652","ENSG00000174652","ZNF266","19",9412429,9435573,23144
"11004","ENSG00000185947","ENSG00000185947","ZNF267","16",31873807,31917357,43550
"11005","ENSG00000090612","ENSG00000090612","ZNF268","12",133181409,133214832,33423
"11006","ENSG00000257267","ENSG00000257267","ZNF271P","18",35291184,35307896,16712
"11007","ENSG00000171606","ENSG00000171606","ZNF274","19",58183029,58213562,30533
"11008","ENSG00000158805","ENSG00000158805","ZNF276","16",89720400,89740925,20525
"11009","ENSG00000198839","ENSG00000198839","ZNF277","7",112206695,112343934,137239
"11010","ENSG00000277421","ENSG00000277421","ZNF280B","HSCHR22_1_CTG3",120078,144811,24733
"11011","ENSG00000137871","ENSG00000137871","ZNF280D","15",56630176,56734086,103910
"11012","ENSG00000162702","ENSG00000162702","ZNF281","1",200404940,200410056,5116
"11013","ENSG00000170265","ENSG00000170265","ZNF282","7",149195546,149226238,30692
"11014","ENSG00000187607","ENSG00000187607","ZNF286A","17",15699577,15720787,21210
"11015","ENSG00000141040","ENSG00000141040","ZNF287","17",16546954,16569204,22250
"11016","ENSG00000188994","ENSG00000188994","ZNF292","6",87151803,87265943,114140
"11017","ENSG00000166526","ENSG00000166526","ZNF3","7",100064033,100082548,18515
"11018","ENSG00000089335","ENSG00000089335","ZNF302","19",34677639,34686397,8758
"11019","ENSG00000131845","ENSG00000131845","ZNF304","19",57351271,57359898,8627
"11020","ENSG00000171467","ENSG00000171467","ZNF318","6",43307134,43369647,62513
"11021","ENSG00000169740","ENSG00000169740","ZNF32","10",43643860,43648881,5021
"11022","ENSG00000181315","ENSG00000181315","ZNF322","6",26634383,26659752,25369
"11023","ENSG00000083812","ENSG00000083812","ZNF324","19",58467056,58475436,8380
"11024","ENSG00000249471","ENSG00000249471","ZNF324B","19",58451611,58457833,6222
"11025","ENSG00000181894","ENSG00000181894","ZNF329","19",58126248,58155110,28862
"11026","ENSG00000109445","ENSG00000109445","ZNF330","4",141220887,141234697,13810
"11027","ENSG00000130844","ENSG00000130844","ZNF331","19",53519527,53580269,60742
"11028","ENSG00000198185","ENSG00000198185","ZNF334","20",46499630,46513559,13929
"11029","ENSG00000198026","ENSG00000198026","ZNF335","20",45948660,45972203,23543
"11030","ENSG00000130684","ENSG00000130684","ZNF337","20",25673195,25696853,23658
"11031","ENSG00000196693","ENSG00000196693","ZNF33B","10",42574185,42638570,64385
"11032","ENSG00000196378","ENSG00000196378","ZNF34","8",144772224,144787348,15124
"11033","ENSG00000088876","ENSG00000088876","ZNF343","20",2481817,2524702,42885
"11034","ENSG00000251247","ENSG00000251247","ZNF345","19",36850361,36913029,62668
"11035","ENSG00000281306","ENSG00000281306","ZNF35","HG2066_PATCH",174086,186145,12059
"11036","ENSG00000256683","ENSG00000256683","ZNF350","19",51964340,51986856,22516
"11037","ENSG00000169131","ENSG00000169131","ZNF354A","5",178711512,178730659,19147
"11038","ENSG00000198816","ENSG00000198816","ZNF358","19",7515292,7521025,5733
"11039","ENSG00000160094","ENSG00000160094","ZNF362","1",33256492,33300719,44227
"11040","ENSG00000138311","ENSG00000138311","ZNF365","10",62374192,62480288,106096
"11041","ENSG00000075407","ENSG00000075407","ZNF37A","10",38094334,38150293,55959
"11042","ENSG00000151789","ENSG00000151789","ZNF385D","3",21412218,22373321,961103
"11043","ENSG00000124613","ENSG00000124613","ZNF391","6",27374615,27403908,29293
"11044","ENSG00000160908","ENSG00000160908","ZNF394","7",99473877,99504857,30980
"11045","ENSG00000186918","ENSG00000186918","ZNF395","8",28345590,28402701,57111
"11046","ENSG00000215421","ENSG00000215421","ZNF407","18",74597870,75065671,467801
"11047","ENSG00000175213","ENSG00000175213","ZNF408","11",46701030,46705912,4882
"11048","ENSG00000119725","ENSG00000119725","ZNF410","14",73886617,73932521,45904
"11049","ENSG00000170954","ENSG00000170954","ZNF415","19",53107879,53133077,25198
"11050","ENSG00000105136","ENSG00000105136","ZNF419","19",57487711,57496098,8387
"11051","ENSG00000102935","ENSG00000102935","ZNF423","16",49487524,49857919,370395
"11052","ENSG00000130818","ENSG00000130818","ZNF426","19",9523223,9538645,15422
"11053","ENSG00000279566","ENSG00000279566","ZNF43","HSCHR19_2_CTG2",166140,170222,4082
"11054","ENSG00000118620","ENSG00000118620","ZNF430","19",21020634,21060050,39416
"11055","ENSG00000256087","ENSG00000256087","ZNF432","19",52031378,52095738,64360
"11056","ENSG00000197857","ENSG00000197857","ZNF44","19",12224686,12294883,70197
"11057","ENSG00000198342","ENSG00000198342","ZNF442","19",12345944,12365905,19961
"11058","ENSG00000180855","ENSG00000180855","ZNF443","19",12429706,12441021,11315
"11059","ENSG00000167685","ENSG00000167685","ZNF444","19",56132599,56160893,28294
"11060","ENSG00000083838","ENSG00000083838","ZNF446","19",58474017,58481230,7213
"11061","ENSG00000124459","ENSG00000124459","ZNF45","19",43912624,43935282,22658
"11062","ENSG00000112200","ENSG00000112200","ZNF451","6",57086844,57170305,83461
"11063","ENSG00000196263","ENSG00000196263","ZNF471","19",56507850,56530221,22371
"11064","ENSG00000142528","ENSG00000142528","ZNF473","19",50025714,50053414,27700
"11065","ENSG00000198464","ENSG00000198464","ZNF480","19",52297169,52325922,28753
"11066","ENSG00000103199","ENSG00000103199","ZNF500","16",4748239,4767624,19385
"11067","ENSG00000081665","ENSG00000081665","ZNF506","19",19785839,19821751,35912
"11068","ENSG00000168813","ENSG00000168813","ZNF507","19",32345594,32387667,42073
"11069","ENSG00000081386","ENSG00000081386","ZNF510","9",96754553,96778129,23576
"11070","ENSG00000196700","ENSG00000196700","ZNF512B","20",63956704,63969930,13226
"11071","ENSG00000144026","ENSG00000144026","ZNF514","2",95122087,95165668,43581
"11072","ENSG00000101493","ENSG00000101493","ZNF516","18",76357682,76495242,137560
"11073","ENSG00000177853","ENSG00000177853","ZNF518A","10",96129715,96205288,75573
"11074","ENSG00000186020","ENSG00000186020","ZNF529","19",36534774,36605276,70502
"11075","ENSG00000074657","ENSG00000074657","ZNF532","18",58862600,58986480,123880
"11076","ENSG00000198597","ENSG00000198597","ZNF536","19",30224891,30713586,488695
"11077","ENSG00000198131","ENSG00000198131","ZNF544","19",58228594,58277495,48901
"11078","ENSG00000204519","ENSG00000204519","ZNF551","19",57681969,57717301,35332
"11079","ENSG00000178935","ENSG00000178935","ZNF552","19",57803841,57814913,11072
"11080","ENSG00000172000","ENSG00000172000","ZNF556","19",2867335,2883445,16110
"11081","ENSG00000130544","ENSG00000130544","ZNF557","19",7069703,7087968,18265
"11082","ENSG00000171466","ENSG00000171466","ZNF562","19",9641807,9675100,33293
"11083","ENSG00000180479","ENSG00000180479","ZNF571","19",37554782,37594792,40010
"11084","ENSG00000124444","ENSG00000124444","ZNF576","19",43596392,43601157,4765
"11085","ENSG00000213015","ENSG00000213015","ZNF580","19",55635016,55643470,8454
"11086","ENSG00000083828","ENSG00000083828","ZNF586","19",57769655,57819939,50284
"11087","ENSG00000198466","ENSG00000198466","ZNF587","19",57849859,57865117,15258
"11088","ENSG00000164048","ENSG00000164048","ZNF589","3",48241100,48299253,58153
"11089","ENSG00000166716","ENSG00000166716","ZNF592","15",84748592,84806445,57853
"11090","ENSG00000142684","ENSG00000142684","ZNF593","1",26169908,26170873,965
"11091","ENSG00000166704","ENSG00000166704","ZNF606","19",57977076,58003349,26273
"11092","ENSG00000180357","ENSG00000180357","ZNF609","15",64460578,64686068,225490
"11093","ENSG00000213020","ENSG00000213020","ZNF611","19",52702813,52735073,32260
"11094","ENSG00000176024","ENSG00000176024","ZNF613","19",51927147,51948759,21612
"11095","ENSG00000142556","ENSG00000142556","ZNF614","19",52012765,52030240,17475
"11096","ENSG00000276340","ENSG00000276340","ZNF623","HSCHR8_3_CTG7",111843,131885,20042
"11097","ENSG00000102870","ENSG00000102870","ZNF629","16",30778456,30787205,8749
"11098","ENSG00000075292","ENSG00000075292","ZNF638","2",71276561,71435069,158508
"11099","ENSG00000121864","ENSG00000121864","ZNF639","3",179323031,179338583,15552
"11100","ENSG00000167395","ENSG00000167395","ZNF646","16",31074422,31084196,9774
"11101","ENSG00000175105","ENSG00000175105","ZNF654","3",88059255,88144660,85405
"11102","ENSG00000197497","ENSG00000197497","ZNF665","19",53159213,53193386,34173
"11103","ENSG00000198046","ENSG00000198046","ZNF667","19",56439325,56478065,38740
"11104","ENSG00000167394","ENSG00000167394","ZNF668","16",31060843,31074240,13397
"11105","ENSG00000188295","ENSG00000188295","ZNF669","1",247099962,247104372,4410
"11106","ENSG00000083814","ENSG00000083814","ZNF671","19",57719751,57727624,7873
"11107","ENSG00000171161","ENSG00000171161","ZNF672","1",248838210,248849517,11307
"11108","ENSG00000197124","ENSG00000197124","ZNF682","19",19997058,20039505,42447
"11109","ENSG00000229809","ENSG00000229809","ZNF688","16",30569672,30572734,3062
"11110","ENSG00000171163","ENSG00000171163","ZNF692","1",248850006,248859144,9138
"11111","ENSG00000197472","ENSG00000197472","ZNF695","1",246945547,247008093,62546
"11112","ENSG00000185730","ENSG00000185730","ZNF696","8",143289676,143299952,10276
"11113","ENSG00000147789","ENSG00000147789","ZNF7","8",144827518,144847509,19991
"11114","ENSG00000167562","ENSG00000167562","ZNF701","19",52555822,52587174,31352
"11115","ENSG00000120963","ENSG00000120963","ZNF706","8",101177878,101206193,28315
"11116","ENSG00000140548","ENSG00000140548","ZNF710","15",90001324,90082206,80882
"11117","ENSG00000147180","ENSG00000147180","ZNF711","X",85243991,85273362,29371
"11118","ENSG00000182903","ENSG00000182903","ZNF721","4",425815,499156,73341
"11119","ENSG00000185252","ENSG00000185252","ZNF74","22",20394115,20408461,14346
"11120","ENSG00000169955","ENSG00000169955","ZNF747","16",30530367,30535347,4980
"11121","ENSG00000141579","ENSG00000141579","ZNF750","17",82829434,82840022,10588
"11122","ENSG00000065029","ENSG00000065029","ZNF76","6",35258909,35295985,37076
"11123","ENSG00000169951","ENSG00000169951","ZNF764","16",30553764,30558374,4610
"11124","ENSG00000169957","ENSG00000169957","ZNF768","16",30524004,30526821,2817
"11125","ENSG00000198146","ENSG00000198146","ZNF770","15",34978341,34988287,9946
"11126","ENSG00000142409","ENSG00000142409","ZNF787","19",56087366,56121295,33929
"11127","ENSG00000196152","ENSG00000196152","ZNF79","9",127424374,127445372,20998
"11128","ENSG00000278129","ENSG00000278129","ZNF8","19",58278955,58302791,23836
"11129","ENSG00000170396","ENSG00000170396","ZNF804A","2",184598529,184939492,340963
"11130","ENSG00000198346","ENSG00000198346","ZNF813","19",53467733,53496255,28522
"11131","ENSG00000102984","ENSG00000102984","ZNF821","16",71859680,71895336,35656
"11132","ENSG00000167766","ENSG00000167766","ZNF83","19",52594060,52690559,96499
"11133","ENSG00000022976","ENSG00000022976","ZNF839","14",102317377,102342702,25325
"11134","ENSG00000198040","ENSG00000198040","ZNF84","12",133037292,133063304,26012
"11135","ENSG00000106479","ENSG00000106479","ZNF862","7",149838375,149867479,29104
"11136","ENSG00000167232","ENSG00000167232","ZNF91","19",23304991,23395471,90480
"11137","ENSG00000184635","ENSG00000184635","ZNF93","19",19900913,19963464,62551
"11138","ENSG00000106400","ENSG00000106400","ZNHIT1","7",101218165,101224190,6025
"11139","ENSG00000174276","ENSG00000174276","ZNHIT2","11",65116403,65117701,1298
"11140","ENSG00000117174","ENSG00000117174","ZNHIT6","1",85649417,85708433,59016
"11141","ENSG00000103310","ENSG00000103310","ZP2","16",21197450,21214510,17060
"11142","ENSG00000188372","ENSG00000188372","ZP3","7",76397518,76442071,44553
"11143","ENSG00000042813","ENSG00000042813","ZPBP","7",49850421,50121329,270908
"11144","ENSG00000109917","ENSG00000109917","ZPR1","11",116773799,116788039,14240
"11145","ENSG00000169249","ENSG00000169249","ZRSR2","X",15790156,15830694,40538
"11146","ENSG00000158691","ENSG00000158691","ZSCAN12","6",28378955,28399747,20792
"11147","ENSG00000196812","ENSG00000196812","ZSCAN16","6",28107689,28130082,22393
"11148","ENSG00000121413","ENSG00000121413","ZSCAN18","19",58083838,58118427,34589
"11149","ENSG00000176371","ENSG00000176371","ZSCAN2","15",84600986,84627796,26810
"11150","ENSG00000197062","ENSG00000197062","ZSCAN26","6",28267058,28278224,11166
"11151","ENSG00000235109","ENSG00000235109","ZSCAN31","6",28324693,28356271,31578
"11152","ENSG00000140987","ENSG00000140987","ZSCAN32","16",3382081,3401065,18984
"11153","ENSG00000131848","ENSG00000131848","ZSCAN5A","19",56219670,56368383,148713
"11154","ENSG00000137185","ENSG00000137185","ZSCAN9","6",28224886,28233487,8601
"11155","ENSG00000168612","ENSG00000168612","ZSWIM1","20",45881227,45885266,4039
"11156","ENSG00000214655","ENSG00000214655","ZSWIM8","10",73785606,73801797,16191
"11157","ENSG00000086827","ENSG00000086827","ZW10","11",113733187,113773735,40548
"11158","ENSG00000174442","ENSG00000174442","ZWILCH","15",66504959,66550130,45171
"11159","ENSG00000122952","ENSG00000122952","ZWINT","10",56357227,56361273,4046
"11160","ENSG00000198205","ENSG00000198205","ZXDA","X",57905430,57910458,5028
"11161","ENSG00000198455","ENSG00000198455","ZXDB","X",57592011,57597477,5466
"11162","ENSG00000070476","ENSG00000070476","ZXDC","3",126437601,126475891,38290
"11163","ENSG00000159840","ENSG00000159840","ZYX","7",143381295,143391111,9816
"11164","ENSG00000074755","ENSG00000074755","ZZEF1","17",4004445,4143030,138585
"11165","ENSG00000036549","ENSG00000036549","ZZZ3","1",77562416,77683419,121003
